"word","present","len","vowels","consonants","nonletters"
"prone",1,5,2,3,0
"avematussonguarappin",0,20,9,11,0
"signories",1,9,4,5,0
"mpffpknrop",0,10,1,9,0
"gangst",0,6,1,5,0
"lienise",0,7,4,3,0
"hru'ukgamabxzhekekkrx",0,21,6,15,1
"guaiacum",1,8,5,3,0
"ln'zmwjhq",0,9,0,9,1
"icins",0,5,2,3,0
"preexplode",1,10,4,6,0
"parvely",0,7,2,5,0
"nonliterate",1,11,5,6,0
"taklamatic",0,10,4,6,0
"overmuries",0,10,5,5,0
"iulus",1,5,3,2,0
"christener",1,10,3,7,0
"vasotocin",1,9,4,5,0
"difica",0,6,3,3,0
"teriann",1,7,3,4,0
"frankston",1,9,2,7,0
"skwbksu",0,7,1,6,0
"phalanstery",1,11,3,8,0
"pelara",0,6,3,3,0
"germaterin",0,10,4,6,0
"bullwinkle",1,10,3,7,0
"electricharriagend",0,18,7,11,0
"exin",0,4,2,2,0
"nondramatically",1,15,5,10,0
"akhes",0,5,2,3,0
"humohagyra",0,10,4,6,0
"marsorbel",0,9,3,6,0
"unemulous",1,9,5,4,0
"tacky",1,5,1,4,0
"overcroppings",0,13,4,9,0
"fibrillan",0,9,3,6,0
"noddingly",1,9,2,7,0
"titivation",1,10,5,5,0
"brapodyian",0,10,4,6,0
"texturally",1,10,3,7,0
"antonet",1,7,3,4,0
"tabbi",1,5,2,3,0
"aphkfpkidxkqdq",0,14,2,12,0
"sensitor",0,8,3,5,0
"moyockels",0,9,3,6,0
"siphonophora",1,12,5,7,0
"achnist",0,7,2,5,0
"leederte",0,8,4,4,0
"selmer",1,6,2,4,0
"amphipneusta",1,12,5,7,0
"hereld",1,6,2,4,0
"pornographomania",1,16,7,9,0
"swineherdship",1,13,4,9,0
"fenvand",0,7,2,5,0
"karenina",1,8,4,4,0
"subcates",0,8,3,5,0
"glegly",1,6,1,5,0
"broautodouging",0,14,7,7,0
"handlock",1,8,2,6,0
"elver",1,5,2,3,0
"moistencer",0,10,4,6,0
"slowhead",0,8,3,5,0
"conious",0,7,4,3,0
"linable",1,7,3,4,0
"doup",1,4,2,2,0
"llyr",1,4,0,4,0
"heliosphered",0,12,5,7,0
"tekla",1,5,2,3,0
"noncallable",1,11,4,7,0
"feminimistrining",0,16,6,10,0
"chirota",0,7,3,4,0
"catiline",1,8,4,4,0
"piercers",1,8,3,5,0
"bcachi",0,6,2,4,0
"kwormeriskful",0,13,4,9,0
"lyrism",1,6,1,5,0
"polypnea",1,8,3,5,0
"unliberally",1,11,4,7,0
"mastoph",0,7,2,5,0
"polonymy",0,8,2,6,0
"monosubstitution",1,16,7,9,0
"gly",0,3,0,3,0
"preevaporating",1,14,6,8,0
"spagyric",1,8,2,6,0
"scavengement",0,12,4,8,0
"sicilian",1,8,4,4,0
"rerabstanicle",0,13,5,8,0
"minesweepings",0,13,5,8,0
"nagyvara",0,8,3,5,0
"inbreaks",1,8,3,5,0
"forbysening",1,11,3,8,0
"biogenies",1,9,5,4,0
"rvrtie",0,6,2,4,0
"echicalic",0,9,4,5,0
"lashkars",1,8,2,6,0
"strated",0,7,2,5,0
"nebaliacea",1,10,6,4,0
"intramurally",1,12,4,8,0
"zppvlsudzls",0,11,1,10,0
"htiwwmzxslurzqpjmtedjqf",0,23,3,20,0
"tric",0,4,1,3,0
"chromoxylograph",0,15,4,11,0
"saucerleaf",1,10,5,5,0
"shidolor",0,8,3,5,0
"apollonists",0,11,4,7,0
"covelling",0,9,3,6,0
"fullmouth",1,9,3,6,0
"wnbpiuifyvdsoorbeq'imd",0,22,7,15,1
"incontroller",0,12,4,8,0
"gastrotrich",1,11,3,8,0
"wgyejnqawcrpccbm''xtbatau",0,25,5,20,2
"abbed",0,5,2,3,0
"ronn",1,4,1,3,0
"estranging",1,10,3,7,0
"gons",1,4,1,3,0
"gleason",1,7,3,4,0
"smriti",1,6,2,4,0
"tutizlahe",0,9,4,5,0
"udolph",0,6,2,4,0
"belton",1,6,2,4,0
"atrikeromedopron",0,16,7,9,0
"perist",0,6,2,4,0
"audiometry",1,10,5,5,0
"lne",0,3,1,2,0
"cusseta",1,7,3,4,0
"kinkinesses",1,11,4,7,0
"stakhanovites",1,13,5,8,0
"halocaudal",0,10,5,5,0
"semibarbarian",1,13,6,7,0
"matrial",0,7,3,4,0
"u'fc'bxcxeqi",0,12,3,9,2
"nny'whoarwxmfjfef",0,17,3,14,1
"ramfeezletown",0,13,5,8,0
"pairlee",0,7,4,3,0
"hedlicyperesbly",0,15,4,11,0
"hgp",0,3,0,3,0
"seraphims",1,9,3,6,0
"nonchemically",0,13,4,9,0
"canler",0,6,2,4,0
"resample",1,8,3,5,0
"folksiest",1,9,3,6,0
"chalmoluon",0,10,4,6,0
"ganniellenial",0,13,6,7,0
"courtlier",1,9,4,5,0
"dismissal",1,9,3,6,0
"kulun",1,5,2,3,0
"veratrum",1,8,3,5,0
"teletraspedote",0,14,6,8,0
"reiter",1,6,3,3,0
"asterophone",0,11,5,6,0
"absvwksgfq",0,10,1,9,0
"pannidyis",0,9,3,6,0
"fectrin",0,7,2,5,0
"bascepseing",0,11,4,7,0
"neosho",1,6,3,3,0
"manism",0,6,2,4,0
"ramillie",1,8,4,4,0
"hempseeds",1,9,3,6,0
"caniser",0,7,3,4,0
"ulmina",0,6,3,3,0
"hemotic",0,7,3,4,0
"goss",1,4,1,3,0
"precreases",1,10,4,6,0
"cfe'ijdv",0,8,2,6,1
"conigdorargenicis",0,17,7,10,0
"anoil",1,5,3,2,0
"replicalnesses",0,14,5,9,0
"nonscaling",1,10,3,7,0
"mano",1,4,2,2,0
"porcup",0,6,2,4,0
"repheallart",0,11,4,7,0
"homogenite",0,10,5,5,0
"wot",0,3,1,2,0
"ostracism",1,9,3,6,0
"sphaeridium",1,11,5,6,0
"predeficient",1,12,5,7,0
"countercrowder",0,14,5,9,0
"cordetinestionathaenglishy",0,26,10,16,0
"chastisers",1,10,3,7,0
"esonse",0,6,3,3,0
"methodologists",1,14,5,9,0
"funchestaxomatondel",0,19,7,12,0
"idahoans",1,8,4,4,0
"erophillers",0,11,4,7,0
"cornix",1,6,2,4,0
"phalaprolity",0,12,4,8,0
"superhines",0,10,4,6,0
"fistulated",1,10,4,6,0
"sinehattiverrarpl",0,17,6,11,0
"metepa",1,6,3,3,0
"underthief",1,10,4,6,0
"wzhgxpxwazlochu",0,15,3,12,0
"guagmenting",0,11,4,7,0
"mul",0,3,1,2,0
"omnifical",0,9,4,5,0
"curmudgeonery",1,13,5,8,0
"sedimenta",0,9,4,5,0
"paraphimosis",1,12,5,7,0
"crudoon",0,7,3,4,0
"rhynchophoran",1,13,3,10,0
"autonomic",1,9,5,4,0
"chonones",0,8,3,5,0
"easters",1,7,3,4,0
"'ltjouw",0,7,2,5,1
"argutenberration",0,16,7,9,0
"maurally",0,8,3,5,0
"occipitofrontal",1,15,6,9,0
"omy",0,3,1,2,0
"brisgogherinano",0,15,6,9,0
"myrian",0,6,2,4,0
"palaeotropical",1,14,7,7,0
"supercaptiously",0,15,6,9,0
"skidpans",1,8,2,6,0
"berdicus",0,8,3,5,0
"neiygkytijwhxwlvodgrfsidth'tgp",0,30,5,25,1
"h'eaeeweepmwmqgc",0,16,6,10,1
"potence",1,7,3,4,0
"phoris",0,6,2,4,0
"ertyletuchteoloneg",0,18,7,11,0
"heredolues",1,10,5,5,0
"uukdvespori",0,11,5,6,0
"changefulnesses",1,15,5,10,0
"presupplementedly",0,17,5,12,0
"brakiest",1,8,3,5,0
"emulousness",1,11,5,6,0
"idae",0,4,3,1,0
"dissipatedness",1,14,5,9,0
"symbol",1,6,1,5,0
"faberga",1,7,3,4,0
"afkugqkplqhkjs'xa",0,17,3,14,1
"reith",1,5,2,3,0
"oho",1,3,2,1,0
"swadtealisalocaretic",0,20,9,11,0
"macroprisms",1,11,3,8,0
"chemosynthesis",1,14,4,10,0
"urochordate",1,11,5,6,0
"f'emkeqlnr",0,10,2,8,1
"prefraniallydes",0,15,5,10,0
"pseudoamatores",0,14,7,7,0
"caprucigs",0,9,3,6,0
"arooss",0,6,3,3,0
"dhives",0,6,2,4,0
"stingily",1,8,2,6,0
"marmiditivrophts",0,16,5,11,0
"maledertid",0,10,4,6,0
"ualortteyamontcong",0,18,7,11,0
"helicitic",1,9,4,5,0
"pearlside",0,9,4,5,0
"annihilobous",0,12,6,6,0
"papayotin",1,9,4,5,0
"rotinevetiesterierness",0,22,10,12,0
"oudidestivinemichydralizatcleccist",0,34,13,21,0
"antemingents",0,12,4,8,0
"unconsuteness",0,13,5,8,0
"hgalzlupzndvqjnycmllepkzvu",0,26,4,22,0
"ferrosilicons",1,13,5,8,0
"batteau",1,7,4,3,0
"parfocality",1,11,4,7,0
"improvement",1,11,4,7,0
"neuropoda",0,9,5,4,0
"babas",1,5,2,3,0
"artgum",1,6,2,4,0
"newcomer",1,8,3,5,0
"polyglottally",1,13,3,10,0
"testate",1,7,3,4,0
"aclgjlg'libeg'zsoxtk",0,20,4,16,2
"needles",1,7,3,4,0
"atoshr",0,6,2,4,0
"ophylaxes",0,9,3,6,0
"sactiouzialetagrapanda",0,22,11,11,0
"capmakers",1,9,3,6,0
"deathbed",1,8,3,5,0
"totz",1,4,1,3,0
"escudos",1,7,3,4,0
"anthropomatous",0,14,6,8,0
"cheshvan",1,8,2,6,0
"vixcufcxxx",0,10,2,8,0
"datographotottlee",0,17,7,10,0
"lexicologist",1,12,5,7,0
"paperiness",1,10,4,6,0
"iain",1,4,3,1,0
"ampyx",1,5,1,4,0
"rmxftqksvtd'rt",0,14,0,14,1
"enthusiasts",1,11,4,7,0
"darns",1,5,1,4,0
"racerunner",1,10,4,6,0
"quet",1,4,2,2,0
"chloramines",1,11,4,7,0
"subcarinated",1,12,5,7,0
"hounskull",1,9,3,6,0
"edmonda",1,7,3,4,0
"corbett",1,7,2,5,0
"udszm",0,5,1,4,0
"cumbeat",0,7,3,4,0
"andochomerinotor",0,16,7,9,0
"bacteriaceae",1,12,7,5,0
"muncies",0,7,3,4,0
"lachenalia",1,10,5,5,0
"gunports",1,8,2,6,0
"bearnaise",1,9,5,4,0
"gophan",0,6,2,4,0
"pgnkfwdakxaznopnty'",0,19,3,16,1
"citruthititis",0,13,5,8,0
"staphylosis",1,11,3,8,0
"okrasianism",0,11,5,6,0
"tarumari",1,8,4,4,0
"fertilia",0,8,4,4,0
"cordello",0,8,3,5,0
"icac",0,4,2,2,0
"poema",0,5,3,2,0
"sexferd",0,7,2,5,0
"silverwares",1,11,4,7,0
"jacque",1,6,3,3,0
"mormmman",0,8,2,6,0
"piassaba",1,8,4,4,0
"drinkables",1,10,3,7,0
"hootananny",1,10,4,6,0
"gabblement",1,10,3,7,0
"unsellable",1,10,4,6,0
"fensition",0,9,4,5,0
"eslyxsg'nt",0,10,1,9,1
"exed",1,4,2,2,0
"arowhertephe",0,12,5,7,0
"sidestreet",1,10,4,6,0
"hikers",1,6,2,4,0
"flat",1,4,1,3,0
"mimictimelides",0,14,6,8,0
"decantigationid",0,15,7,8,0
"logitopr",0,8,3,5,0
"polky",1,5,1,4,0
"superiors",1,9,4,5,0
"orlander",0,8,3,5,0
"doctrinarian",1,12,5,7,0
"conspissate",1,11,4,7,0
"lontar",1,6,2,4,0
"rhizodus",1,8,3,5,0
"phliolly",0,8,2,6,0
"superfish",0,9,3,6,0
"ynjcypmzipfegc",0,14,2,12,0
"undocumentedness",1,16,6,10,0
"glideness",1,9,3,6,0
"gobrancive",0,10,4,6,0
"evisite",1,7,4,3,0
"igusdmue'qhk'px",0,15,4,11,2
"astoide",0,7,4,3,0
"macroanalytical",1,15,6,9,0
"oversteadfasts",0,14,5,9,0
"spd",1,3,0,3,0
"gulfport",1,8,2,6,0
"emarginally",0,11,4,7,0
"saraad",1,6,3,3,0
"furfuranol",0,10,4,6,0
"candings",0,8,2,6,0
"overbrutally",1,12,4,8,0
"ekwtvndvvqfdrvcx",0,16,1,15,0
"inordinary",1,10,4,6,0
"spelldom",0,8,2,6,0
"winetasting",1,11,4,7,0
"avlsfjibcep'otvjqoxj'i",0,22,6,16,2
"pholgiga",0,8,3,5,0
"overmeek",1,8,4,4,0
"kcodeatamuncifaveein",0,20,10,10,0
"anthargulogil",0,13,5,8,0
"scrubbly",1,8,1,7,0
"joverenimaloochery",0,18,8,10,0
"appalling",1,9,3,6,0
"insignment",1,10,3,7,0
"chakdar",1,7,2,5,0
"rhughtheffliplete",0,17,5,12,0
"kushfddum",0,9,2,7,0
"soria",0,5,3,2,0
"podsolizations",1,14,6,8,0
"nickelled",1,9,3,6,0
"cicuta",1,6,3,3,0
"samshu",1,6,2,4,0
"exemplified",1,11,5,6,0
"upbuoyance",1,10,5,5,0
"upgully",1,7,2,5,0
"hornblende",1,10,3,7,0
"bathmissis",0,10,3,7,0
"unpilloried",1,11,5,6,0
"polarography",1,12,4,8,0
"fdilsy''",0,8,1,7,2
"exhausters",1,10,4,6,0
"updownervouring",0,15,6,9,0
"metantimonic",1,12,5,7,0
"aguire",0,6,4,2,0
"ctenostomatic",0,13,5,8,0
"rnttwjrj'gmarilcjyllr",0,21,2,19,1
"sardanapallos",1,13,5,8,0
"crotaphytus",1,11,3,8,0
"urticates",1,9,4,5,0
"gecarcinus",1,10,4,6,0
"subsizars",1,9,3,6,0
"overtopping",1,11,4,7,0
"illampu",1,7,3,4,0
"unsanctioning",1,13,5,8,0
"masulas",1,7,3,4,0
"rephyls",0,7,1,6,0
"stiret",0,6,2,4,0
"apisa",0,5,3,2,0
"dyothelism",1,10,3,7,0
"colourlessness",1,14,5,9,0
"waliteoadrdotinis",0,17,8,9,0
"wigan",1,5,2,3,0
"rriocard",1,8,3,5,0
"sind",1,4,1,3,0
"undecenseal",0,11,5,6,0
"crizzle",1,7,2,5,0
"coptis",1,6,2,4,0
"mediastolically",0,15,6,9,0
"enfamous",1,8,4,4,0
"rockel",1,6,2,4,0
"ambisonic",1,9,4,5,0
"oxidises",1,8,4,4,0
"brassertations",0,14,5,9,0
"potentiodactylites",0,18,7,11,0
"dangerful",1,9,3,6,0
"mjfmbbllsed",0,11,1,10,0
"locarnite",1,9,4,5,0
"cspactitada",0,11,4,7,0
"piromongaly",0,11,4,7,0
"milliken",1,8,3,5,0
"scytonemataceae",1,15,7,8,0
"screet",1,6,2,4,0
"epanalepsis",1,11,5,6,0
"sarum",1,5,2,3,0
"munprenontormmas",0,16,5,11,0
"sanis",0,5,2,3,0
"togt",1,4,1,3,0
"kind",1,4,1,3,0
"georgics",1,8,3,5,0
"yatesboro",1,9,4,5,0
"compensorine",0,12,5,7,0
"dubnium",1,7,3,4,0
"tums",1,4,1,3,0
"koker",1,5,2,3,0
"qfuozrkahbxw",0,12,3,9,0
"vitics",0,6,2,4,0
"lll",0,3,0,3,0
"yankeeland",1,10,4,6,0
"sipunculoidea",1,13,7,6,0
"focsle",1,6,2,4,0
"purifiable",0,10,5,5,0
"enthusiastics",0,13,5,8,0
"bowtie",1,6,3,3,0
"denial",1,6,3,3,0
"achatinella",1,11,5,6,0
"oga",0,3,2,1,0
"slation",0,7,3,4,0
"sunnyme",0,7,2,5,0
"enranckles",1,10,3,7,0
"butyric",1,7,2,5,0
"keefferennsyllabicamaldant",0,26,9,17,0
"limpin",1,6,2,4,0
"yutivarissifiticrophypeters",0,27,10,17,0
"pyrophabiquisiantiwellenconises",0,31,13,18,0
"esselen",1,7,3,4,0
"cocatalyst",1,10,3,7,0
"platurous",1,9,4,5,0
"hbjj",0,4,0,4,0
"fibrinolysin",1,12,4,8,0
"dulaney",1,7,3,4,0
"iuzjhj",0,6,2,4,0
"naturisms",1,9,3,6,0
"bituminating",1,12,5,7,0
"matacan",1,7,3,4,0
"overope",0,7,4,3,0
"overealatinaffunistraing",0,24,11,13,0
"overrashly",1,10,3,7,0
"pkswwyyhuzcbeg",0,14,2,12,0
"goatskins",1,9,3,6,0
"scriptichokingbell",0,18,5,13,0
"trollopees",1,10,4,6,0
"upinarecracics",0,14,6,8,0
"econometrician",1,14,7,7,0
"hypermnesia",1,11,4,7,0
"soar",1,4,2,2,0
"hindoo",1,6,3,3,0
"fumeliornis",0,11,5,6,0
"retely",0,6,2,4,0
"lilid",0,5,2,3,0
"orchats",1,7,2,5,0
"ovaglyp",0,7,2,5,0
"wallahs",1,7,2,5,0
"gippy",1,5,1,4,0
"xmwmtzbpzdjnnlelyfonyntw'izf",0,28,3,25,1
"siaiophiter",0,11,6,5,0
"nonheritor",1,10,4,6,0
"hygiene",1,7,3,4,0
"outsaid",1,7,4,3,0
"cousinages",1,10,5,5,0
"lianoi",0,6,4,2,0
"shultz",1,6,1,5,0
"ryeflour",1,8,3,5,0
"ted",1,3,1,2,0
"rexane",1,6,3,3,0
"wormgear",1,8,3,5,0
"zwfbjjbkhou'",0,12,2,10,1
"litance",0,7,3,4,0
"zoug",1,4,2,2,0
"ellistical",0,10,4,6,0
"fiansmdsporiastrastacidirubgulacingen",0,37,14,23,0
"vervinae",0,8,4,4,0
"cakibstrete",0,11,4,7,0
"carmichael",1,10,4,6,0
"seyfert",1,7,2,5,0
"kailyairds",1,10,4,6,0
"country",1,7,2,5,0
"pipemouth",1,9,4,5,0
"venerator",1,9,4,5,0
"lifebuoy",1,8,4,4,0
"metrocolpotomy",0,14,5,9,0
"spiegering",0,10,4,6,0
"semegivace",0,10,5,5,0
"cytasters",1,9,2,7,0
"sutlerage",1,9,4,5,0
"unpolled",1,8,3,5,0
"hellespont",1,10,3,7,0
"linioriavericoeabationonngaichglitefecrgesayllstta",0,50,22,28,0
"subdues",1,7,3,4,0
"fusmiorul",0,9,4,5,0
"shessacomesoms",0,14,5,9,0
"didaenic",0,8,4,4,0
"nonresponsibilities",1,19,8,11,0
"subcivilized",1,12,5,7,0
"gezone",0,6,3,3,0
"nonant",0,6,2,4,0
"spewiest",1,8,3,5,0
"faroeish",1,8,4,4,0
"hodometers",1,10,4,6,0
"overishorterrymorkfus",0,21,7,14,0
"hutsonville",1,11,4,7,0
"bargues",0,7,3,4,0
"miswitchinaw",0,12,4,8,0
"proletaries",1,11,5,6,0
"literatocarthartic",0,18,7,11,0
"postverbal",1,10,3,7,0
"syriologist",1,11,4,7,0
"essenacts",0,9,3,6,0
"wanityouxiansidgheteglanguneg",0,29,12,17,0
"bactericidally",1,14,5,9,0
"haria",0,5,3,2,0
"sdally",0,6,1,5,0
"mattin",1,6,2,4,0
"eanling",1,7,3,4,0
"wass",0,4,1,3,0
"embattenberry",0,13,4,9,0
"tit",1,3,1,2,0
"oversefension",0,13,6,7,0
"legalizer",1,9,4,5,0
"headraigle",0,10,5,5,0
"uncented",0,8,3,5,0
"booleans",1,8,4,4,0
"serendipity",1,11,4,7,0
"wilisagwodensortitenessmits",0,27,10,17,0
"socius",1,6,3,3,0
"unthengedjances",0,15,5,10,0
"malleus",1,7,3,4,0
"unconcreted",1,11,4,7,0
"ichthyodorulites",1,16,6,10,0
"oga",0,3,2,1,0
"mustahfiz",1,9,3,6,0
"undisgraced",1,11,4,7,0
"monavenerasm",0,12,5,7,0
"cvaweqzuhsca",0,12,4,8,0
"pixphiemanetsurhy",0,17,6,11,0
"grewski",0,7,2,5,0
"holdfastness",1,12,3,9,0
"outwister",0,9,4,5,0
"carperter",0,9,3,6,0
"gothicising",1,11,4,7,0
"lattis",0,6,2,4,0
"bedic",0,5,2,3,0
"ss'",0,3,0,3,1
"dequeen",1,7,4,3,0
"lambert",1,7,2,5,0
"gl'yujg",0,7,1,6,1
"amelift",0,7,3,4,0
"bdcotxfmsp",0,10,1,9,0
"nallkondaridrangivarid",0,22,8,14,0
"moniterallsisescalm",0,19,7,12,0
"protatrant",0,10,3,7,0
"'yhvjbxdcvp",0,11,0,11,1
"storomycre",0,10,3,7,0
"boaexh",0,6,3,3,0
"implurientotypercompolites",0,26,10,16,0
"overapprehensive",1,16,7,9,0
"deuteragoniadin",0,15,8,7,0
"admissive",1,9,4,5,0
"brattishing",1,11,3,8,0
"hawkey",1,6,2,4,0
"inanimatingly",0,13,5,8,0
"leasure",0,7,4,3,0
"melanosomes",1,11,5,6,0
"alitorickbrinatsabil",0,20,8,12,0
"rejournment",0,11,4,7,0
"pretenesses",0,11,4,7,0
"papastrophicativerloatlewinloverb",0,33,13,20,0
"impreventilators",0,16,6,10,0
"andromorpha",0,11,4,7,0
"chronologising",1,14,5,9,0
"drencher",1,8,2,6,0
"tockereverdocumaloso",0,20,9,11,0
"inophin",0,7,3,4,0
"hinarfed",0,8,3,5,0
"dizing",0,6,2,4,0
"diamondback",1,11,4,7,0
"orthia",1,6,3,3,0
"gimcracism",0,10,3,7,0
"causcly",0,7,2,5,0
"qaddafi",1,7,3,4,0
"shromans",0,8,2,6,0
"prerestamphistic",0,16,5,11,0
"ranchlike",1,9,3,6,0
"jucoixmleyd",0,11,4,7,0
"adenological",1,12,6,6,0
"opposing",1,8,3,5,0
"hypostrophe",1,11,3,8,0
"saltires",1,8,3,5,0
"xrvckdyoecdakyfhwovnlsf'",0,24,4,20,1
"googa",0,5,3,2,0
"plbroodooed",0,11,5,6,0
"ideologician",0,12,7,5,0
"matheson",1,8,3,5,0
"balood",0,6,3,3,0
"saccoylends",0,11,3,8,0
"echittorner",0,11,4,7,0
"jba'vqndig",0,10,2,8,1
"chancement",0,10,3,7,0
"unswell",1,7,2,5,0
"frictional",1,10,4,6,0
"cium",0,4,2,2,0
"usv",1,3,1,2,0
"tarrassical",0,11,4,7,0
"reuchlin",1,8,3,5,0
"levitator",1,9,4,5,0
"barmits",0,7,2,5,0
"noned",0,5,2,3,0
"lyijmanig'",0,10,3,7,1
"duesemou",0,8,5,3,0
"nondeference",1,12,5,7,0
"iqesxjbeqvsuj",0,13,4,9,0
"mantoes",1,7,3,4,0
"hsingan",1,7,2,5,0
"feudalism",1,9,4,5,0
"treasures",1,9,4,5,0
"arrivism",1,8,3,5,0
"bratialloshery",0,14,5,9,0
"vicer",0,5,2,3,0
"welling",1,7,2,5,0
"rewall",1,6,2,4,0
"semihostiley",0,12,5,7,0
"oecantic",0,8,4,4,0
"dgmkvjpsjh'j'nwaojnyecf'xg",0,26,3,23,3
"turakoo",1,7,4,3,0
"deirdra",1,7,3,4,0
"nsec",1,4,1,3,0
"disposer",1,8,3,5,0
"blandform",0,9,2,7,0
"camearathyromass",0,16,6,10,0
"bcws",1,4,0,4,0
"pilobolus",1,9,4,5,0
"bearableness",0,12,5,7,0
"mantispa",1,8,3,5,0
"fluously",0,8,3,5,0
"ewery",1,5,2,3,0
"eddying",1,7,2,5,0
"muscatine",1,9,4,5,0
"decantates",1,10,4,6,0
"trentepohlia",1,12,5,7,0
"delwyn",1,6,1,5,0
"mouts",0,5,2,3,0
"unsystematical",1,14,5,9,0
"rsacopellalfeedftilllion",0,24,9,15,0
"precombination",1,14,6,8,0
"tgciegc",0,7,2,5,0
"flowerfence",1,11,4,7,0
"archcondurin",0,12,4,8,0
"christiania",1,11,5,6,0
"vintness",0,8,2,6,0
"mosed",1,5,2,3,0
"myelopa",0,7,3,4,0
"nnlm",0,4,0,4,0
"djectricorynger",0,15,4,11,0
"pozna",1,5,2,3,0
"panhedral",0,9,3,6,0
"unfishes",0,8,3,5,0
"dosseret",1,8,3,5,0
"swansboro",1,9,3,6,0
"legionnaires",1,12,6,6,0
"paconsparaglings",0,16,5,11,0
"ischi",0,5,2,3,0
"toxide",0,6,3,3,0
"euphonery",0,9,4,5,0
"schlute",0,7,2,5,0
"dephatzh",0,8,2,6,0
"okhltoixgwr'akxdqcfd",0,20,4,16,1
"tracheoscopist",1,14,5,9,0
"loyder",0,6,2,4,0
"fsehyimq'rjnhrrchaqhebvkazoxjw",0,30,6,24,1
"hyrhockessentiojeccid",0,21,7,14,0
"kotiant",0,7,3,4,0
"limmasol",1,8,3,5,0
"hyacintha",1,9,3,6,0
"boarding",1,8,3,5,0
"ununanimations",0,14,7,7,0
"kali",1,4,2,2,0
"gambetta",1,8,3,5,0
"omipet",0,6,3,3,0
"fernandia",0,9,4,5,0
"braun",1,5,2,3,0
"rbhwgimem",0,9,2,7,0
"sabelled",0,8,3,5,0
"qwhigbtghtefybcipilrps",0,22,4,18,0
"scralicheisheriagoromoun",0,24,11,13,0
"mulnercot",0,9,3,6,0
"ulruybtopnxtkexbrunljgr'cy",0,26,5,21,1
"omrjwhvyizf",0,11,2,9,0
"kelily",0,6,2,4,0
"countemultipollexed",0,19,8,11,0
"scjjxhxtadcptnnjbcyyappofdvl",0,28,3,25,0
"mussaenda",1,9,4,5,0
"unremitting",1,11,4,7,0
"isoimmunisations",1,16,8,8,0
"pulicene",1,8,4,4,0
"smoochiavelic",0,13,6,7,0
"carpwllidi",0,10,3,7,0
"pechoficiealet",0,14,7,7,0
"timnersiviess",0,13,5,8,0
"coccucrachrity",0,14,4,10,0
"moonrises",1,9,4,5,0
"interconnectibilities",0,21,9,12,0
"unbra",0,5,2,3,0
"familiarises",1,12,6,6,0
"telesis",1,7,3,4,0
"parados",1,7,3,4,0
"rpnaxradih'abog",0,15,5,10,1
"oathworm",0,8,3,5,0
"softback",1,8,2,6,0
"spottledgelisms",0,15,4,11,0
"neckguard",1,9,3,6,0
"jsuiopaxadmc'amnnzdihb",0,22,7,15,1
"brundous",0,8,3,5,0
"superwinglades",0,14,5,9,0
"tidion",0,6,3,3,0
"stewbum",1,7,2,5,0
"heteronymous",1,12,5,7,0
"pelosevonalireor",0,16,8,8,0
"gotching",0,8,2,6,0
"postponements",1,13,4,9,0
"woodpeckers",1,11,4,7,0
"awrtyrhizan",0,11,3,8,0
"acquiescences",1,13,6,7,0
"orlov",1,5,2,3,0
"sollar",1,6,2,4,0
"berdivellogran",0,14,5,9,0
"mlaga",1,5,2,3,0
"eckhart",1,7,2,5,0
"concrorichindamaledethy",0,23,8,15,0
"vavdv",0,5,1,4,0
"arioian",1,7,5,2,0
"xslnkqzytcjipnfut",0,17,2,15,0
"judi",1,4,2,2,0
"crenoptins",0,10,3,7,0
"dechbuchetier",0,13,5,8,0
"starmainteroka",0,14,6,8,0
"akity",0,5,2,3,0
"hippolyte",1,9,3,6,0
"zoogist",0,7,3,4,0
"naegated",0,8,4,4,0
"dountame",0,8,4,4,0
"sparassis",1,9,3,6,0
"unsplittable",1,12,4,8,0
"falter",1,6,2,4,0
"dollarwise",1,10,4,6,0
"voetsak",1,7,3,4,0
"karionty",0,8,3,5,0
"subtiller",0,9,3,6,0
"prejudicially",1,13,5,8,0
"cevesm",0,6,2,4,0
"nish",1,4,1,3,0
"comatroce",0,9,4,5,0
"hesperiid",1,9,4,5,0
"cuso",1,4,2,2,0
"hakenkreuze",1,11,5,6,0
"ounpeggs",0,8,3,5,0
"banter",1,6,2,4,0
"pevetangeve",0,11,5,6,0
"suggest",1,7,2,5,0
"celess",0,6,2,4,0
"terpsichore",1,11,4,7,0
"hazardless",1,10,3,7,0
"derachiotomocharityloper",0,24,10,14,0
"feltmongers",0,11,3,8,0
"interestingly",1,13,4,9,0
"crumb",1,5,1,4,0
"eodiscid",1,8,4,4,0
"benefacies",0,10,5,5,0
"citellum",0,8,3,5,0
"puericulture",1,12,6,6,0
"cefisphtayaereatourangan",0,24,11,13,0
"scrapper",1,8,2,6,0
"gedjf'eyb",0,9,2,7,1
"dissolutely",1,11,4,7,0
"unembossed",1,10,4,6,0
"shemu",1,5,2,3,0
"aca",0,3,2,1,0
"jerryman",0,8,2,6,0
"iderclbhei",0,10,4,6,0
"seatworks",1,9,3,6,0
"amphicarpa",1,10,4,6,0
"goance",0,6,3,3,0
"trocompaneer",0,12,5,7,0
"egyptians",1,9,3,6,0
"rewify",0,6,2,4,0
"conjuring",1,9,3,6,0
"subfeebe",0,8,4,4,0
"op",1,2,1,1,0
"ccalista",0,8,3,5,0
"hybridomata",1,11,4,7,0
"inquinembed",0,11,5,6,0
"mauk",1,4,2,2,0
"sublimification",1,15,7,8,0
"herous",0,6,3,3,0
"dottiest",1,8,3,5,0
"stubborn",1,8,2,6,0
"exactresses",1,11,4,7,0
"paggast",0,7,2,5,0
"serjeancy",1,9,3,6,0
"sherlock",1,8,2,6,0
"''y'ekwtccnqxtrkqh",0,18,1,17,3
"nonfold",0,7,2,5,0
"ryjxmnchgt",0,10,0,10,0
"possinian",0,9,4,5,0
"mely",0,4,1,3,0
"dunnakin",1,8,3,5,0
"fiomyd",0,6,2,4,0
"antiauthoritarianisms",1,21,10,11,0
"abs",1,3,1,2,0
"prelaxation",0,11,5,6,0
"paras",1,5,2,3,0
"strainor",0,8,3,5,0
"llrycpwnfsrbrrxctddzttgnfbfr",0,28,0,28,0
"atocuiev'''x",0,12,5,7,3
"grottier",1,8,3,5,0
"avgaseometry",0,12,5,7,0
"francophobe",1,11,4,7,0
"foldout",1,7,3,4,0
"slidles",0,7,2,5,0
"unbounda",0,8,4,4,0
"ples",0,4,1,3,0
"unbolster",1,9,3,6,0
"slidable",1,8,3,5,0
"fouettes",1,8,4,4,0
"esmiykyejkvyozllz",0,17,4,13,0
"contain",1,7,3,4,0
"craal",1,5,2,3,0
"pecronsierter",0,13,5,8,0
"distillated",0,11,4,7,0
"indiscreditably",0,15,5,10,0
"medigamous",0,10,5,5,0
"gotchias",0,8,3,5,0
"reflectograph",1,13,4,9,0
"resistlessness",1,14,4,10,0
"herskowitz",1,10,3,7,0
"jwpcpptapzjx'vniwum'",0,20,3,17,2
"peracetic",1,9,4,5,0
"ctiphe",0,6,2,4,0
"sego",1,4,2,2,0
"hyperpigments",0,13,3,10,0
"machedisstebychifurtinis",0,24,8,16,0
"calamodendron",1,13,5,8,0
"unmature",1,8,4,4,0
"baudekin",1,8,4,4,0
"nonsy",0,5,1,4,0
"heykwxlpddizgulzc",0,17,3,14,0
"bafwaicytavbmuuahihbyacri",0,25,10,15,0
"furned",0,6,2,4,0
"qjpiqivhpfuqc",0,13,3,10,0
"teonanachronism",0,15,6,9,0
"limnobiology",1,12,5,7,0
"swordistoped",0,12,4,8,0
"dhechukcivrsrv'hr",0,17,3,14,1
"grunberg",1,8,2,6,0
"dolgellau",1,9,4,5,0
"anosmia",1,7,4,3,0
"introductorinesses",1,18,7,11,0
"estonians",1,9,4,5,0
"festatus",1,8,3,5,0
"vindahl",0,7,2,5,0
"almightings",0,11,3,8,0
"bohykkhed",0,9,2,7,0
"physiogenic",1,11,4,7,0
"netropreased",0,12,5,7,0
"erarviethifia",0,13,7,6,0
"cevdet",1,6,2,4,0
"pennysiller",1,11,3,8,0
"saccadge",1,8,3,5,0
"olefinic",1,8,4,4,0
"aquarelle",1,9,5,4,0
"gawknochroni",0,12,4,8,0
"go",1,2,1,1,0
"floozie",1,7,4,3,0
"ligeance",1,8,4,4,0
"figurativeness",1,14,6,8,0
"jokebook",1,8,4,4,0
"exosporium",1,10,5,5,0
"nqwvlsbfznwl",0,12,0,12,0
"barnes",1,6,2,4,0
"graveship",1,9,3,6,0
"laes",0,4,2,2,0
"transposability",1,15,5,10,0
"casark",0,6,2,4,0
"biometry",1,8,3,5,0
"brasilians",0,10,4,6,0
"diastematic",1,11,5,6,0
"measures",1,8,4,4,0
"underexposing",1,13,5,8,0
"dhe",0,3,1,2,0
"xdeqhefxsdwgzvl'uqbla",0,21,4,17,1
"mayon",0,5,2,3,0
"challaning",1,10,3,7,0
"hmy",0,3,0,3,0
"ameliorate",1,10,6,4,0
"iconoclastics",0,13,5,8,0
"measure",1,7,4,3,0
"u'jdruljip",0,10,3,7,1
"obtusenesses",1,12,5,7,0
"topee",1,5,3,2,0
"swimminute",0,10,4,6,0
"kernon",0,6,2,4,0
"cohn",1,4,1,3,0
"siamese",1,7,4,3,0
"polkily",0,7,2,5,0
"pywhb",0,5,0,5,0
"enlargens",1,9,3,6,0
"plna",0,4,1,3,0
"preacher",1,8,3,5,0
"staphyle",1,8,2,6,0
"gently",1,6,1,5,0
"fireworm",1,8,3,5,0
"shau",0,4,2,2,0
"nonderdeidae",0,12,6,6,0
"yfys",0,4,0,4,0
"omsvlhutajgxjm",0,14,3,11,0
"zmzcqwwec",0,9,1,8,0
"emile",1,5,3,2,0
"tackhearsenidae",0,15,7,8,0
"metagrobolising",1,15,6,9,0
"preswallow",1,10,3,7,0
"piecree",0,7,4,3,0
"verdubitation",0,13,6,7,0
"sabblaysiollickeeps",0,19,7,12,0
"merinesseisms",0,13,5,8,0
"kness",0,5,1,4,0
"fritz",1,5,1,4,0
"predefinitions",1,14,6,8,0
"applity",0,7,2,5,0
"sonsofbitchers",0,14,4,10,0
"detachability",1,13,5,8,0
"cogory",0,6,2,4,0
"fischbein",1,9,3,6,0
"polychromatophilic",1,18,6,12,0
"dacelonings",0,11,4,7,0
"orata",0,5,3,2,0
"maypop",1,6,2,4,0
"prmaafztgwcjwsm",0,15,2,13,0
"cologisticularchia",0,18,8,10,0
"faultlessness",1,13,4,9,0
"'tcygwlvugq",0,11,1,10,1
"bucraniophagies",0,15,7,8,0
"aspiculous",1,10,5,5,0
"belvice",0,7,3,4,0
"tkoumttznkqkgbu",0,15,3,12,0
"gconv",1,5,1,4,0
"bryanidraman",0,12,4,8,0
"tunnell",1,7,2,5,0
"gloquenterlenced",0,16,6,10,0
"pmadoppralinaun",0,15,6,9,0
"syagush",1,7,2,5,0
"unicule",0,7,4,3,0
"glawlithyl",0,10,2,8,0
"pseudocumidine",1,14,7,7,0
"piecework",1,9,4,5,0
"octodywidge",0,11,4,7,0
"renegade",1,8,4,4,0
"chomartevoly",0,12,4,8,0
"paraclete",1,9,4,5,0
"chinin",1,6,2,4,0
"nonichawbasationortrofs",0,23,9,14,0
"mir",1,3,1,2,0
"irrate",1,6,3,3,0
"isordinatanic",0,13,6,7,0
"asseal",1,6,3,3,0
"counterdecree",1,13,6,7,0
"tjvylmwwswowi",0,13,2,11,0
"yellowest",1,9,3,6,0
"exp",1,3,1,2,0
"eroncorylovermoinisevaddi",0,25,11,14,0
"selfeffacing",1,12,4,8,0
"overmournfulness",1,16,6,10,0
"gantlope",1,8,3,5,0
"outgars",0,7,3,4,0
"persatcherprefeadin",0,19,7,12,0
"moothouse",1,9,5,4,0
"velociraptors",1,13,5,8,0
"polyclinic",1,10,3,7,0
"tunaburger",1,10,4,6,0
"unjumbled",1,9,3,6,0
"danuriases",0,10,5,5,0
"teless",0,6,2,4,0
"stammels",1,8,2,6,0
"amphicyonin",0,11,4,7,0
"hollidam",1,8,3,5,0
"hardshell",1,9,2,7,0
"hatful",1,6,2,4,0
"boutiques",1,9,5,4,0
"besmoothhound",0,13,5,8,0
"midspace",1,8,3,5,0
"chondrosarcoma",1,14,5,9,0
"heavy",1,5,2,3,0
"baguios",1,7,4,3,0
"necrotomist",1,11,4,7,0
"conelike",1,8,4,4,0
"ble",0,3,1,2,0
"appropinqued",1,12,5,7,0
"unressianden",0,12,5,7,0
"incorporeal",1,11,5,6,0
"coagencies",1,10,5,5,0
"phanlike",0,8,3,5,0
"selector",1,8,3,5,0
"pholading",0,9,3,6,0
"dauntless",1,9,3,6,0
"mundy",1,5,1,4,0
"mermithidae",1,11,5,6,0
"ffborbbuw'zzuzpwztsdjauhnhtg",0,28,5,23,1
"casually",1,8,3,5,0
"educt",1,5,2,3,0
"corny",1,5,1,4,0
"nicadle",0,7,3,4,0
"lordkin",1,7,2,5,0
"biskiose",0,8,4,4,0
"verbalised",1,10,4,6,0
"megasyntheton",0,13,4,9,0
"moingwena",1,9,4,5,0
"camery",0,6,2,4,0
"phonautographies",0,16,7,9,0
"lifs",0,4,1,3,0
"bonelopeen",0,10,5,5,0
"physicomorphite",0,15,5,10,0
"electrometers",1,13,5,8,0
"arraigners",1,10,4,6,0
"bqkcnvyykbhurkim'ay",0,19,3,16,1
"reecho",1,6,3,3,0
"amplorableness",0,14,5,9,0
"ostopsine",0,9,4,5,0
"cllatae",0,7,3,4,0
"rayshell",1,8,2,6,0
"telautomatises",0,14,7,7,0
"typhonian",1,9,3,6,0
"tracheoschisis",1,14,5,9,0
"pressive",1,8,3,5,0
"dalmatian",1,9,4,5,0
"belium",0,6,3,3,0
"thistochronograph",0,17,5,12,0
"consignificant",1,14,5,9,0
"und",0,3,1,2,0
"unwarfurties",0,12,5,7,0
"munsey",1,6,2,4,0
"psomiveroograccitintnck",0,23,8,15,0
"ercurvents",0,10,3,7,0
"unhuzzaed",1,9,4,5,0
"eury",0,4,2,2,0
"euphemise",1,9,5,4,0
"johnsones",0,9,3,6,0
"dogsledders",1,11,3,8,0
"conishake",0,9,4,5,0
"catostomoid",1,11,5,6,0
"cuddlelessnesses",0,16,5,11,0
"consumerism",1,11,4,7,0
"earflaps",1,8,3,5,0
"jamnis",1,6,2,4,0
"witis",0,5,2,3,0
"charcutered",0,11,4,7,0
"phamad",0,6,2,4,0
"danya",1,5,2,3,0
"conskewomed",0,11,4,7,0
"galese",0,6,3,3,0
"gmelinas",1,8,3,5,0
"whizkid",1,7,2,5,0
"samite",1,6,3,3,0
"mazarinades",1,11,5,6,0
"ynfeqdsoegogfadtqulsxn",0,22,6,16,0
"downweed",1,8,3,5,0
"vocability",1,10,4,6,0
"trolleyed",1,9,3,6,0
"rebellow",1,8,3,5,0
"oieitssdu",0,9,5,4,0
"brace",1,5,2,3,0
"entourage",1,9,5,4,0
"synagogue",1,9,4,5,0
"cliquier",1,8,4,4,0
"cushing",1,7,2,5,0
"cpa",1,3,1,2,0
"worantennl",0,10,3,7,0
"ullit",0,5,2,3,0
"nonsick",0,7,2,5,0
"nfllinggiddvftqnrirnzqlfskxe",0,28,4,24,0
"joriykqevo",0,10,4,6,0
"genelders",0,9,3,6,0
"caulics",0,7,3,4,0
"gingicanses",0,11,4,7,0
"montluion",1,9,4,5,0
"dutchwoman",1,10,3,7,0
"purdy",1,5,1,4,0
"forger",1,6,2,4,0
"hwcstlnnezkaqupxs",0,17,3,14,0
"ackfaceucaretert",0,16,7,9,0
"glacis",1,6,2,4,0
"belauds",1,7,3,4,0
"tapermaking",1,11,4,7,0
"ovid",1,4,2,2,0
"'",0,1,0,1,1
"intoxicatingly",1,14,5,9,0
"growers",1,7,2,5,0
"recuperableness",0,15,6,9,0
"agerartiee",0,10,6,4,0
"amichhofleism",0,13,5,8,0
"slinte",1,6,2,4,0
"eycuhylmv'",0,10,2,8,1
"nonblockinged",0,13,4,9,0
"rcanemariptren",0,14,5,9,0
"strenuousness",1,13,5,8,0
"dennisville",1,11,4,7,0
"miba",0,4,2,2,0
"caryllium",0,9,3,6,0
"floccinaucinihilipilification",1,29,14,15,0
"skenai",1,6,3,3,0
"scitur",0,6,2,4,0
"begoniaceae",1,11,7,4,0
"dicrack",0,7,2,5,0
"acculturizing",1,13,5,8,0
"laundercut",0,10,4,6,0
"scollating",0,10,3,7,0
"circaeaceae",1,11,7,4,0
"adulterna",0,9,4,5,0
"paschals",1,8,2,6,0
"trn",0,3,0,3,0
"lametersenic",0,12,5,7,0
"'oupctdtgbbtgdsi",0,16,3,13,1
"ungilt",1,6,2,4,0
"kscaent",0,7,2,5,0
"embargoed",1,9,4,5,0
"macrorhagias",0,12,5,7,0
"tzcjvgtnjuzvvhenhpyzkxg",0,23,2,21,0
"overfierce",1,10,5,5,0
"boxyn",0,5,1,4,0
"cagers",1,6,2,4,0
"polygenisms",1,11,3,8,0
"kosice",1,6,3,3,0
"paratomial",1,10,5,5,0
"disilludes",1,10,4,6,0
"aeroehmic",0,9,5,4,0
"saccomyidae",1,11,5,6,0
"depraving",1,9,3,6,0
"'bvybgz'xvchelzo'pzuyqep",0,24,4,20,3
"infraordinals",0,13,5,8,0
"zumlzgpyctjynqy'nldjampwzrdgpm",0,30,2,28,1
"rollicker",1,9,3,6,0
"pupikeand",0,9,4,5,0
"rpq",1,3,0,3,0
"nucles",0,6,2,4,0
"consubstanitise",0,15,6,9,0
"gyktmlnjrnmbd'cxe",0,17,1,16,1
"cantings",1,8,2,6,0
"phragmipedium",1,13,5,8,0
"mahopac",1,7,3,4,0
"catisea",0,7,4,3,0
"kirgirds",0,8,2,6,0
"tunnelmaking",1,12,4,8,0
"bothe",1,5,2,3,0
"approximately",1,13,5,8,0
"heboks",0,6,2,4,0
"christyna",1,9,2,7,0
"crustlessness",0,13,3,10,0
"dialytically",1,12,4,8,0
"wfhmbbrwltr",0,11,0,11,0
"pliosaur",1,8,4,4,0
"ctierpktzszyf",0,13,2,11,0
"ekslmourarr",0,11,4,7,0
"mediotarsal",1,11,5,6,0
"replunges",1,9,3,6,0
"lieges",1,6,3,3,0
"busk",1,4,1,3,0
"rgubufggirkbslzpw",0,17,3,14,0
"sperquideutaker",0,15,7,8,0
"coccuse",0,7,3,4,0
"troubleshooting",1,15,6,9,0
"mayme",1,5,2,3,0
"xkq'zhjafz",0,10,1,9,1
"monensin",1,8,3,5,0
"faciebitia",0,10,6,4,0
"pullback",1,8,2,6,0
"wmeus",0,5,2,3,0
"ucjc'ylkf'dlxzgszhf'l",0,21,1,20,3
"scarfpin",1,8,2,6,0
"tolon",0,5,2,3,0
"conductiblock",0,13,4,9,0
"colpo",0,5,2,3,0
"botalluckofictually",0,19,7,12,0
"rehboc",1,6,2,4,0
"pondus",1,6,2,4,0
"kymri",1,5,1,4,0
"woodwin",0,7,3,4,0
"orobances",0,9,4,5,0
"douziemes",1,9,5,4,0
"feuillage",1,9,5,4,0
"ssxgnlaujdujlbjh'ggzwmzw",0,24,3,21,1
"quinderfish",0,11,4,7,0
"civium",0,6,3,3,0
"ductomyrishbosess",0,17,5,12,0
"wyking",0,6,1,5,0
"antivandalism",1,13,5,8,0
"encephalotomy",1,13,5,8,0
"linolenic",1,9,4,5,0
"pleurers",0,8,3,5,0
"goldshier",0,9,3,6,0
"carnes",1,6,2,4,0
"arbuscultus",0,11,4,7,0
"gloxinia",1,8,4,4,0
"drollness",1,9,2,7,0
"manuscriptal",1,12,4,8,0
"bles",0,4,1,3,0
"agami",1,5,3,2,0
"edan",1,4,2,2,0
"carlyn",1,6,1,5,0
"daesson",0,7,3,4,0
"violer",1,6,3,3,0
"chining",1,7,2,5,0
"borosilicate",1,12,6,6,0
"kyanism",0,7,2,5,0
"uyziezqpjidosnbqpehgpve",0,23,7,16,0
"weingartner",1,11,4,7,0
"inebriant",1,9,4,5,0
"filoplumaceous",1,14,7,7,0
"alkalises",1,9,4,5,0
"protomartyr",1,11,3,8,0
"miscaller",1,9,3,6,0
"lucubration",1,11,5,6,0
"wawaka",1,6,3,3,0
"divebombing",1,11,4,7,0
"unscaly",1,7,2,5,0
"zmiz",0,4,1,3,0
"zincivier",0,9,4,5,0
"ueneengelewerotiffowapidelaly",0,29,14,15,0
"choultry",1,8,2,6,0
"intraphilosophic",1,16,6,10,0
"surestation",0,11,5,6,0
"trestles",1,8,2,6,0
"praepubis",1,9,4,5,0
"favowerlunut",0,12,5,7,0
"mifflinburg",1,11,3,8,0
"florey",1,6,2,4,0
"ghardaoa",1,8,4,4,0
"guggles",1,7,2,5,0
"riandella",0,9,4,5,0
"tuneful",1,7,3,4,0
"ardol",0,5,2,3,0
"polystomella",1,12,4,8,0
"areters",0,7,3,4,0
"monmatvopl",0,10,3,7,0
"palterers",1,9,3,6,0
"underscrub",1,10,3,7,0
"reflexes",1,8,3,5,0
"mismanageablenesses",0,19,8,11,0
"tortenter",0,9,3,6,0
"neutrodyne",1,10,4,6,0
"priapulacea",1,11,6,5,0
"bianchi",1,7,3,4,0
"aughtkedurpreglous",0,18,7,11,0
"doctor",1,6,2,4,0
"goats",1,5,2,3,0
"excoriator",1,10,5,5,0
"dkpcw",0,5,0,5,0
"allene",1,6,3,3,0
"almains",1,7,3,4,0
"admitier",0,8,4,4,0
"cdorzeduvvd",0,11,3,8,0
"nons",0,4,1,3,0
"zira",1,4,2,2,0
"pric",0,4,1,3,0
"corylet",1,7,2,5,0
"playmology",0,10,3,7,0
"pirogueships",0,12,5,7,0
"customisers",1,11,4,7,0
"arod",0,4,2,2,0
"negroperates",0,12,5,7,0
"delaware",1,8,4,4,0
"trabaalogy",0,10,4,6,0
"psychoprophagous",0,16,5,11,0
"nonadapting",1,11,4,7,0
"prodomons",0,9,3,6,0
"wwwyrloserqufusglrsrqhz'ftftg",0,29,4,25,1
"depp",1,4,1,3,0
"blackworks",0,10,2,8,0
"secernmentalism",0,15,5,10,0
"benone",0,6,3,3,0
"unfruitedly",0,11,4,7,0
"nogj'f'pjaoq",0,12,3,9,2
"drodipokemativeres",0,18,8,10,0
"bespiritedness",0,14,5,9,0
"antzpg",0,6,1,5,0
"lange",1,5,2,3,0
"paleozoic",1,9,5,4,0
"occitan",1,7,3,4,0
"montevideo",1,10,5,5,0
"klaiyyeduhyhttmjzlau",0,20,6,14,0
"lucinda",1,7,3,4,0
"marabou",1,7,4,3,0
"monotonosemouth",0,15,7,8,0
"hypopial",1,8,3,5,0
"shri",1,4,1,3,0
"antiapartheid",1,13,6,7,0
"tred",0,4,1,3,0
"cytosine",1,8,3,5,0
"starvatism",0,10,3,7,0
"reteller",1,8,3,5,0
"pontepatjan",0,11,4,7,0
"ditzier",1,7,3,4,0
"bruns",1,5,1,4,0
"heliotropine",1,12,6,6,0
"resell",1,6,2,4,0
"toportablen",0,11,4,7,0
"artebunpikarvar",0,15,6,9,0
"bioelectrol",0,11,5,6,0
"reatoultidae",0,12,7,5,0
"raphathousists",0,14,5,9,0
"lybs",0,4,0,4,0
"phalus",0,6,2,4,0
"moderwomapeys",0,13,5,8,0
"upconjure",1,9,4,5,0
"'jmxqedagssoudppvwy",0,19,4,15,1
"kild",1,4,1,3,0
"seraliseddah",0,12,5,7,0
"boateria",0,8,5,3,0
"belfield",1,8,3,5,0
"dismstradia",0,11,4,7,0
"gentlewomen",1,11,4,7,0
"unessenced",1,10,4,6,0
"hairinesses",1,11,5,6,0
"eoliennes",1,9,5,4,0
"malapropian",1,11,5,6,0
"culliton",1,8,3,5,0
"transillumination",1,17,7,10,0
"meles",1,5,2,3,0
"preworket",0,9,3,6,0
"tetraspore",1,10,4,6,0
"bbwhutune",0,9,3,6,0
"'ksyjfij'd'vallmzf'",0,19,2,17,4
"fhwfketfpgdpdeu'",0,16,3,13,1
"haemopis",1,8,4,4,0
"juices",1,6,3,3,0
"overmanagerialistic",0,19,9,10,0
"higenitentillent",0,16,6,10,0
"portieres",1,9,4,5,0
"phrase",1,6,2,4,0
"rris",0,4,1,3,0
"interruptibleness",0,17,6,11,0
"monomyarii",0,10,5,5,0
"carissa",1,7,3,4,0
"attractancy",1,11,3,8,0
"hyperablerlifulibunded",0,22,8,14,0
"dombas",0,6,2,4,0
"tarlison",0,8,3,5,0
"voluntedness",0,12,4,8,0
"lockmen",1,7,2,5,0
"huidobro",1,8,4,4,0
"vjeqxvqmrymveemtyl",0,18,3,15,0
"toreremaloresnatilatriafidiciov",0,31,15,16,0
"drury",1,5,1,4,0
"neurocentral",1,12,5,7,0
"limpness",1,8,2,6,0
"tamans",0,6,2,4,0
"banders",1,7,2,5,0
"proteric",0,8,3,5,0
"angiocardiography",1,17,7,10,0
"unrivitia",0,9,5,4,0
"hydraphylesses",0,14,3,11,0
"valhalla",1,8,3,5,0
"bvwcu",0,5,1,4,0
"gazumpers",1,9,3,6,0
"isunanistabolive",0,16,8,8,0
"ohal'dugztdatbumvylsq",0,21,5,16,1
"nwpikdjvgjcnekisylf",0,19,3,16,0
"cloys",1,5,1,4,0
"pedatifid",1,9,4,5,0
"sezelsoningsic",0,14,5,9,0
"monofuel",1,8,4,4,0
"fyfrfrstkunepjhyozbc'nxfib",0,26,4,22,1
"umestinitahummblbanewaciactrewisle",0,34,14,20,0
"wildean",1,7,3,4,0
"biazuctiniptascredlent",0,22,8,14,0
"phesuneneelyscory",0,17,6,11,0
"formamide",1,9,4,5,0
"molothrus",1,9,3,6,0
"talvile",0,7,3,4,0
"hz",1,2,0,2,0
"hypercondensibility",0,19,6,13,0
"spunkinesses",1,12,4,8,0
"scratchweed",1,11,3,8,0
"iezmexz'fmqd",0,12,3,9,1
"greenlandic",1,11,4,7,0
"binous",1,6,3,3,0
"polonial",1,8,4,4,0
"phosibinson",0,11,4,7,0
"xhosaurus",0,9,4,5,0
"whillywhaws",1,11,2,9,0
"eakiclcaldalantinaglurallobulyst",0,32,12,20,0
"ponying",1,7,2,5,0
"mediae",1,6,4,2,0
"sworpronsist",0,12,3,9,0
"nondegradables",1,14,5,9,0
"cadde",0,5,2,3,0
"pretergress",1,11,3,8,0
"databilizinesses",0,16,7,9,0
"yee",1,3,2,1,0
"rustruta",0,8,3,5,0
"occidentalization",0,17,8,9,0
"sphoerizalesco",0,14,6,8,0
"bali",1,4,2,2,0
"colectomies",1,11,5,6,0
"ticoveo",0,7,4,3,0
"expectivendowedgie",0,18,8,10,0
"dunhidl'jgffc",0,13,2,11,1
"airspace",1,8,4,4,0
"graftage",1,8,3,5,0
"factive",1,7,3,4,0
"intertubularians",0,16,7,9,0
"menetheaeracip",0,14,7,7,0
"astraphobias",1,12,5,7,0
"jcb",1,3,0,3,0
"empatrons",1,9,3,6,0
"astroworms",0,10,3,7,0
"hollock",0,7,2,5,0
"underpressed",0,12,4,8,0
"cellulomonadeae",1,15,8,7,0
"breathabilities",1,15,7,8,0
"bvbrzwgwetvlytrlx",0,17,1,16,0
"cyther",0,6,1,5,0
"interferingness",1,15,5,10,0
"iugqzop",0,7,3,4,0
"unfelder",0,8,3,5,0
"unfoodowniannoo",0,15,8,7,0
"bungeys",1,7,2,5,0
"ejkthm'uzkipdwfprc",0,18,3,15,1
"ismaelitis",0,10,5,5,0
"awakings",1,8,3,5,0
"unsilly",1,7,2,5,0
"ourobond",0,8,4,4,0
"troys",1,5,1,4,0
"micropin",1,8,3,5,0
"lita",1,4,2,2,0
"pretechnic",0,10,3,7,0
"hilen",0,5,2,3,0
"ordines",0,7,3,4,0
"pigfishamelidonies",0,18,8,10,0
"commodiously",1,12,5,7,0
"pronunciamento",1,14,6,8,0
"vangelically",0,12,4,8,0
"whirland",0,8,2,6,0
"glenhayes",1,9,3,6,0
"balantidiasis",1,13,6,7,0
"obvolutionary",0,13,6,7,0
"spytoes",0,7,2,5,0
"organomalogue",0,13,7,6,0
"juliette",1,8,4,4,0
"taxidermised",1,12,5,7,0
"misecclesiastic",1,15,6,9,0
"yaexrnlcywknww",0,14,2,12,0
"assagai",1,7,4,3,0
"craggy",1,6,1,5,0
"feugiaowlqmdxhzh",0,16,5,11,0
"roraurrris",0,10,4,6,0
"petite",1,6,3,3,0
"flivaluxctieliad",0,16,7,9,0
"dreasten",0,8,3,5,0
"gauging",1,7,3,4,0
"sofars",1,6,2,4,0
"hyjiwxmevsyu'fypbh'tewj",0,23,4,19,2
"keres",1,5,2,3,0
"hochelaga",1,9,4,5,0
"preincreased",1,12,5,7,0
"wallings",1,8,2,6,0
"outwaltherne",0,12,5,7,0
"nhqkfwxfaw",0,10,1,9,0
"nticra",0,6,2,4,0
"bacteroportenaritorologic",0,25,11,14,0
"discerningly",1,12,3,9,0
"chiacking",1,9,3,6,0
"aspergillin",1,11,4,7,0
"zaddik",1,6,2,4,0
"unings",0,6,2,4,0
"unindigenous",1,12,6,6,0
"pfvn",0,4,0,4,0
"avisements",1,10,4,6,0
"millennial",1,10,4,6,0
"pomotallagieura",0,15,8,7,0
"nocephalazareanane",0,18,9,9,0
"dorweiler",1,9,4,5,0
"ganza",0,5,2,3,0
"gration",0,7,3,4,0
"tymorphis",0,9,2,7,0
"scotophobias",0,12,5,7,0
"renean",0,6,3,3,0
"langworthy",1,10,2,8,0
"bobeche",1,7,3,4,0
"overheat",1,8,4,4,0
"boltzman",0,8,2,6,0
"candollea",1,9,4,5,0
"galettes",1,8,3,5,0
"disunionism",1,11,5,6,0
"awake",1,5,3,2,0
"noneuroscopine",0,14,7,7,0
"deltidaceae",0,11,6,5,0
"nzhme",0,5,1,4,0
"certo",0,5,2,3,0
"huddleston",1,10,3,7,0
"perisalpingitis",1,15,6,9,0
"chuckram",1,8,2,6,0
"utssayiererotat",0,15,7,8,0
"headpeace",1,9,5,4,0
"dinatisinouitserspllititedaedm",0,30,13,17,0
"mecturaterey",0,12,5,7,0
"cloyer",1,6,2,4,0
"ntreticatolonarinqulycontonilisoramiodin",0,40,17,23,0
"pseudoinspirational",1,19,9,10,0
"shortening",1,10,3,7,0
"euphemisation",1,13,7,6,0
"talelyritlurimbis",0,17,6,11,0
"iprising",0,8,3,5,0
"casion",0,6,3,3,0
"intantematoppine",0,16,7,9,0
"hipqfjz",0,7,1,6,0
"bacterizations",1,14,6,8,0
"'aecgnhoaxquiabv'md",0,19,7,12,2
"inconfinglycil",0,14,4,10,0
"drawers",1,7,2,5,0
"multipolarity",1,13,5,8,0
"tugrik",1,6,2,4,0
"crystalities",0,12,4,8,0
"digmaxitypoewin",0,15,6,9,0
"grishun",1,7,2,5,0
"subspecifications",0,17,7,10,0
"christless",1,10,2,8,0
"oelet",1,5,3,2,0
"shwas",1,5,1,4,0
"ortynamidendrombiencin",0,22,8,14,0
"objurgatrix",1,11,4,7,0
"rentionic",0,9,4,5,0
"crumpliest",1,10,3,7,0
"espagnuolo",0,10,5,5,0
"seveloquenes",0,12,6,6,0
"overextrapolation",1,17,8,9,0
"envermeiled",1,11,5,6,0
"gaudlian",0,8,4,4,0
"mismanage",1,9,4,5,0
"amadi",1,5,3,2,0
"wanglehoofs",0,11,4,7,0
"dvhcaqihqkiuu'x",0,15,5,10,1
"undown",0,6,2,4,0
"'aariizjbfvlcwgzsjkeuuqn",0,24,7,17,1
"pined",1,5,2,3,0
"sculpate",0,8,3,5,0
"eliss",0,5,2,3,0
"nsjxtbbkuw",0,10,1,9,0
"outreasoned",1,11,6,5,0
"limnetis",1,8,3,5,0
"omnieruditeness",0,15,7,8,0
"indwesfedsthycsikd",0,18,4,14,0
"gyglzbwbpbed",0,12,1,11,0
"unfleshing",1,10,3,7,0
"overter",0,7,3,4,0
"feplilever",0,10,4,6,0
"packable",1,8,3,5,0
"acrodromous",1,11,5,6,0
"rimpolyses",0,10,3,7,0
"leptodactylid",1,13,4,9,0
"profluviographist",0,17,6,11,0
"heterocentric",1,13,5,8,0
"bdellos",0,7,2,5,0
"decerebrate",1,11,5,6,0
"gttebidipiettantuenc",0,20,8,12,0
"oppositeness",1,12,5,7,0
"closers",1,7,2,5,0
"anaerotrusso",0,12,6,6,0
"daye",1,4,2,2,0
"rootward",1,8,3,5,0
"predeterminant",1,14,5,9,0
"paddleballs",1,11,3,8,0
"actinomycetales",1,15,6,9,0
"ingravescence",1,13,5,8,0
"journeyman",1,10,4,6,0
"ebonist",1,7,3,4,0
"vermonpololuctylene",0,19,7,12,0
"ented",0,5,2,3,0
"caravel",1,7,3,4,0
"ammiral",1,7,3,4,0
"hippoboscidae",1,13,6,7,0
"spectrofluorometry",1,18,6,12,0
"erydithales",0,11,4,7,0
"underogambling",0,14,5,9,0
"diarticulation",0,14,7,7,0
"prgasabr",0,8,2,6,0
"und",0,3,1,2,0
"monocoelial",0,11,6,5,0
"areface",0,7,4,3,0
"kw'voz'wtlfbioolvtbio'wbrz",0,26,6,20,3
"xkbcxkjbcmp",0,11,0,11,0
"copalata",0,8,4,4,0
"perameccabal",0,12,5,7,0
"chloranthy",1,10,2,8,0
"unguica",0,7,4,3,0
"timarau",1,7,4,3,0
"gmohrgqnrt",0,10,1,9,0
"erdepen",0,7,3,4,0
"croaky",1,6,2,4,0
"autodrainage",1,12,7,5,0
"geonavigator",0,12,6,6,0
"boftiglia",0,9,4,5,0
"rochkind",1,8,2,6,0
"propionyl",1,9,3,6,0
"backsplice",1,10,3,7,0
"pacia",0,5,3,2,0
"k'ziwsvooyhv",0,12,3,9,1
"misrecollectives",0,16,6,10,0
"modernisms",1,10,3,7,0
"warranto",1,8,3,5,0
"bawdric",1,7,2,5,0
"oversleeves",1,11,5,6,0
"bacterialism",0,12,5,7,0
"madia",1,5,3,2,0
"pxfehwlcdmodzirlrgbamc",0,22,4,18,0
"dallis",1,6,2,4,0
"microevolutionist",0,17,8,9,0
"aguacateca",1,10,6,4,0
"mukerji",1,7,3,4,0
"gpfo'idflt",0,10,2,8,1
"sisses",1,6,2,4,0
"orolingualisms",0,14,6,8,0
"cieasentse",0,10,5,5,0
"withering",1,9,3,6,0
"septembrian",1,11,4,7,0
"timberman",1,9,3,6,0
"donielled",0,9,4,5,0
"uzecgifkjss",0,11,3,8,0
"petrustibility",0,14,5,9,0
"gb",1,2,0,2,0
"anthropogeographies",1,19,8,11,0
"eosinophilia",1,12,7,5,0
"idiography",0,10,4,6,0
"corydon",1,7,2,5,0
"mphitriblefeost",0,15,5,10,0
"meticulosity",1,12,5,7,0
"unessential",1,11,5,6,0
"prabostarampolbrineseetimarom",0,29,12,17,0
"opthalmologists",0,15,5,10,0
"intersecrete",0,12,5,7,0
"semiformed",1,10,4,6,0
"undereed",0,8,4,4,0
"refind",1,6,2,4,0
"chalcidid",1,9,3,6,0
"pickes",0,6,2,4,0
"vidle",0,5,2,3,0
"nonnoble",1,8,3,5,0
"unagitated",1,10,5,5,0
"unswappable",1,11,4,7,0
"bordures",1,8,3,5,0
"unscopyracience",0,15,6,9,0
"heezed",1,6,3,3,0
"conspicuousness",1,15,6,9,0
"isocolles",0,9,4,5,0
"dsmillyskwtes",0,13,2,11,0
"nonmicroscopy",0,13,4,9,0
"unteness",0,8,3,5,0
"forewomen",1,9,4,5,0
"noncouperation",0,14,7,7,0
"rutan",1,5,2,3,0
"glassfiringing",0,14,4,10,0
"'btetjxbrshklitx",0,16,2,14,1
"xzdpric",0,7,1,6,0
"caeb'gmdmzuymygi",0,16,4,12,1
"torvidae",0,8,4,4,0
"tidemills",1,9,3,6,0
"unplayable",1,10,4,6,0
"whittener",1,9,3,6,0
"cawks",1,5,1,4,0
"ama",1,3,2,1,0
"haccictirs",0,10,3,7,0
"kommunizma",1,10,4,6,0
"kantia",0,6,3,3,0
"threnies",0,8,3,5,0
"bratium",0,7,3,4,0
"fortition",0,9,4,5,0
"bellbind",1,8,2,6,0
"impactments",0,11,3,8,0
"archargracewoman",0,16,6,10,0
"dellaine",0,8,4,4,0
"'dmuwcvxsbeytqsvweei",0,20,5,15,1
"vaticinated",1,11,5,6,0
"urolitical",0,10,5,5,0
"resterocarative",0,15,7,8,0
"saudis",1,6,3,3,0
"swinburniaceae",0,14,7,7,0
"hermophoroglingpointiful",0,24,9,15,0
"zygophyllum",1,11,2,9,0
"plerocerc",0,9,3,6,0
"littling",1,8,2,6,0
"bodylike",0,8,3,5,0
"cheelman",0,8,3,5,0
"secupperick",0,11,4,7,0
"phonates",1,8,3,5,0
"corrue",0,6,3,3,0
"cesurae",1,7,4,3,0
"collinae",0,8,4,4,0
"husitionertin",0,13,6,7,0
"godparenchwise",0,14,5,9,0
"heperioityd",0,11,5,6,0
"factice",1,7,3,4,0
"overhunts",1,9,3,6,0
"protanerso",0,10,4,6,0
"veschudeprt",0,11,3,8,0
"subpellucid",1,11,4,7,0
"prephoaducar",0,12,5,7,0
"keryrnesog",0,10,3,7,0
"nonextrinsications",0,18,7,11,0
"grous",1,5,2,3,0
"siliquiform",1,11,5,6,0
"dibranch",1,8,2,6,0
"seesawing",1,9,4,5,0
"unsarian",0,8,4,4,0
"promercantile",1,13,5,8,0
"samelastribulas",0,15,6,9,0
"olmz'kahqwcnrdet",0,16,3,13,1
"lmdeyqooqicx",0,12,4,8,0
"somically",0,9,3,6,0
"brucellosis",1,11,4,7,0
"blainey",1,7,3,4,0
"uncovetous",1,10,5,5,0
"possessive",1,10,4,6,0
"unsmen",0,6,2,4,0
"buddhology",0,10,3,7,0
"industry",1,8,2,6,0
"equiprobabilities",1,17,9,8,0
"synochoid",1,9,3,6,0
"tapenade",1,8,4,4,0
"advertreetalepsy",0,16,6,10,0
"scolographeriurilise",0,20,9,11,0
"nardraux",0,8,3,5,0
"thoroughwide",0,12,5,7,0
"karanes",0,7,3,4,0
"sponginblastingnesses",0,21,6,15,0
"folial",1,6,3,3,0
"tattletales",1,11,4,7,0
"mutating",1,8,3,5,0
"mailly",0,6,2,4,0
"podozamites",1,11,5,6,0
"gatydeshris",0,11,3,8,0
"intuitionalist",1,14,7,7,0
"mortific",1,8,3,5,0
"oomiacs",1,7,4,3,0
"pueraria",1,8,5,3,0
"yeaugporr'njgy",0,14,4,10,1
"rvalenorerortticicoporxicheair",0,30,13,17,0
"nashville",1,9,3,6,0
"looyenworks",1,11,4,7,0
"delictum",1,8,3,5,0
"abboud",1,6,3,3,0
"premechanical",1,13,5,8,0
"marida",1,6,3,3,0
"unexcogitable",1,13,6,7,0
"ynhiavswpkgder",0,14,3,11,0
"netidae",0,7,4,3,0
"emmetrope",1,9,4,5,0
"hyetograph",1,10,3,7,0
"hammel",1,6,2,4,0
"rescreen",1,8,3,5,0
"bineesolinasm",0,13,6,7,0
"trsa",1,4,1,3,0
"biblicize",0,9,4,5,0
"huddlemanite",0,12,5,7,0
"upvacbdw'rhvrbxwpaq",0,19,3,16,1
"unrotary",1,8,3,5,0
"ephemity",0,8,3,5,0
"foreknown",1,9,3,6,0
"lovelaceville",1,13,6,7,0
"astrometrical",1,13,5,8,0
"bacchanal",1,9,3,6,0
"saltire",1,7,3,4,0
"battlewagons",1,12,4,8,0
"unconfidency",0,12,4,8,0
"afton",1,5,2,3,0
"hypermetise",0,11,4,7,0
"subanid",0,7,3,4,0
"grunch",1,6,1,5,0
"appense",1,7,3,4,0
"jgffzjftgpmry",0,13,0,13,0
"nonhouseholder",1,14,6,8,0
"sublineation",1,12,6,6,0
"checkrein",1,9,3,6,0
"cke",0,3,1,2,0
"buyerestiness",0,13,5,8,0
"hubristically",1,13,4,9,0
"tranquiles",0,10,4,6,0
"winehurstenger",0,14,5,9,0
"trimestancy",0,11,3,8,0
"unemotioned",1,11,6,5,0
"ftins",0,5,1,4,0
"pary",0,4,1,3,0
"psalms",1,6,1,5,0
"ap",0,2,1,1,0
"hefam",0,5,2,3,0
"valiasholly",0,11,4,7,0
"kaminess",0,8,3,5,0
"labial",1,6,3,3,0
"plupatrid",0,9,3,6,0
"gote",1,4,2,2,0
"tapstry",1,7,1,6,0
"js",1,2,0,2,0
"cgp'qfuqt",0,9,1,8,1
"hardiness",1,9,3,6,0
"gayfeathercraftman",0,18,6,12,0
"avapergouzzazooseenta",0,21,11,10,0
"chironomers",1,11,4,7,0
"dssairnatsxcq'hrguynghkggpm",0,27,4,23,1
"nlugpyqakdlnin'",0,15,3,12,1
"cags",0,4,1,3,0
"dod",1,3,1,2,0
"purim",1,5,2,3,0
"tartryl",1,7,1,6,0
"statical",1,8,3,5,0
"mootnesses",1,10,4,6,0
"contemporary",1,12,4,8,0
"hylavorkisobaling",0,17,6,11,0
"sporon",0,6,2,4,0
"cardialgic",1,10,4,6,0
"labdacus",1,8,3,5,0
"carminophenol",0,13,5,8,0
"prestiophagy",0,12,4,8,0
"uning",0,5,2,3,0
"coutscracotidiosition",0,21,10,11,0
"schillijers",0,11,3,8,0
"rectoceles",1,10,4,6,0
"dissimulate",1,11,5,6,0
"cacophagy",0,9,3,6,0
"underdoctor",1,11,4,7,0
"zinjanthropi",1,12,4,8,0
"disinclosed",1,11,4,7,0
"sandflies",1,9,3,6,0
"serogelatinous",1,14,7,7,0
"cooperia",1,8,5,3,0
"confirms",1,8,2,6,0
"vologitally",0,11,4,7,0
"depeyster",1,9,3,6,0
"qhrme'znswryalharzyh",0,20,3,17,1
"preperuses",0,10,4,6,0
"alectoropodous",1,14,7,7,0
"aggradational",1,13,6,7,0
"undulator",1,9,4,5,0
"colliform",1,9,3,6,0
"hoolmannie",0,10,5,5,0
"surton",0,6,2,4,0
"rizzoredge",0,10,4,6,0
"semiautomorphous",0,16,8,8,0
"vjbh",0,4,0,4,0
"shagbarks",1,9,2,7,0
"distomous",0,9,4,5,0
"vasospastic",1,11,4,7,0
"creachering",0,11,4,7,0
"pwmvjmczhboctdrouwadft",0,22,4,18,0
"deucedly",1,8,3,5,0
"osprghanemer",0,12,4,8,0
"scotoma",1,7,3,4,0
"bagman",1,6,2,4,0
"ievmk'ioffdpszulncogg",0,21,6,15,1
"blastospore",1,11,4,7,0
"methyl",1,6,1,5,0
"linty",1,5,1,4,0
"horseiest",1,9,4,5,0
"rheobases",1,9,4,5,0
"parled",1,6,2,4,0
"biteos",0,6,3,3,0
"rompha",0,6,2,4,0
"hkdsqkdiorkgtz",0,14,2,12,0
"englishes",1,9,3,6,0
"baridens",0,8,3,5,0
"scythagous",0,10,3,7,0
"splenoblast",1,11,3,8,0
"simoisius",1,9,5,4,0
"batsper",0,7,2,5,0
"mesmerisation",1,13,6,7,0
"dyzcgjkvmbg",0,11,0,11,0
"choush",1,6,2,4,0
"draglisticlympira",0,17,5,12,0
"devoid",1,6,3,3,0
"etian",0,5,3,2,0
"crappet",0,7,2,5,0
"denous",0,6,3,3,0
"nerwism",0,7,2,5,0
"opisthodomos",1,12,5,7,0
"nonrestida",0,10,4,6,0
"v'a'jzfzzcrlzkbhl",0,17,1,16,2
"butalma",0,7,3,4,0
"coercival",0,9,4,5,0
"impiarimanungrs",0,15,6,9,0
"penmaster",1,9,3,6,0
"martinelli",1,10,4,6,0
"exosporium",1,10,5,5,0
"emptoriness",0,11,4,7,0
"cannonier",1,9,4,5,0
"claustrophobic",1,14,5,9,0
"fourning",0,8,3,5,0
"calomaniaceae",0,13,8,5,0
"aksemin",0,7,3,4,0
"dowagiac",1,8,4,4,0
"rehemming",1,9,3,6,0
"plex",0,4,1,3,0
"yhwaeqynbioabyupb'olh",0,21,7,14,1
"jows",1,4,1,3,0
"smoothness",1,10,3,7,0
"swig",1,4,1,3,0
"blltingha",0,9,2,7,0
"cedarhurst",1,10,3,7,0
"horodko",1,7,3,4,0
"demimbering",0,11,4,7,0
"riu'nvcncphsybklp",0,17,2,15,1
"ini",0,3,2,1,0
"kavya",1,5,2,3,0
"unadjoined",1,10,5,5,0
"subimoanthum",0,12,5,7,0
"overgrade",1,9,4,5,0
"redurguaimallimelnes",0,20,9,11,0
"nobleness",1,9,3,6,0
"immind",1,6,2,4,0
"rallorviats",0,11,4,7,0
"glasswort",1,9,2,7,0
"borgeson",1,8,3,5,0
"jugatae",1,7,4,3,0
"sfnedjgcmosyhm'qij",0,18,3,15,1
"scheler",1,7,2,5,0
"polip",0,5,2,3,0
"bifront",1,7,2,5,0
"maile",1,5,3,2,0
"alomintiemotizhola",0,18,9,9,0
"obstructures",0,12,4,8,0
"donamins",0,8,3,5,0
"dusicyon",1,8,3,5,0
"orphan",1,6,2,4,0
"artexah",0,7,3,4,0
"glandlike",1,9,3,6,0
"qzmlpfgd'riyjdszqhtjtepno",0,25,3,22,1
"satisfaction",1,12,5,7,0
"passus",1,6,2,4,0
"guessentrayush",0,14,5,9,0
"echab",0,5,2,3,0
"perpouceckew",0,12,5,7,0
"massoy",1,6,2,4,0
"anglicized",1,10,4,6,0
"cyclinnwormia",0,13,4,9,0
"bestseller",1,10,3,7,0
"soap",1,4,2,2,0
"gmxwtksszd'br",0,13,0,13,1
"xylophils",0,9,2,7,0
"wenona",1,6,3,3,0
"damenacoid",0,10,5,5,0
"vesalian",1,8,4,4,0
"propaging",1,9,3,6,0
"roughousewife",0,13,7,6,0
"vahnkkfichhrpmwdhvpgw",0,21,2,19,0
"nons",0,4,1,3,0
"l'n",0,3,0,3,1
"diglossac",0,9,3,6,0
"naywaringumunwaris",0,18,7,11,0
"entinwomo",0,9,4,5,0
"carrosser",0,9,3,6,0
"dakota",1,6,3,3,0
"optologist",1,10,4,6,0
"kukvxokwhhuno",0,13,4,9,0
"justiceships",1,12,4,8,0
"babbitics",0,9,3,6,0
"nelumbo",1,7,3,4,0
"sabadievillifluctuations",0,24,11,13,0
"cohere",1,6,3,3,0
"seationates",0,11,6,5,0
"griddines",0,9,3,6,0
"wpn''",0,5,0,5,2
"larceners",1,9,3,6,0
"packages",1,8,3,5,0
"bacarposteady",0,13,5,8,0
"admireies",0,9,5,4,0
"snepracraast",0,12,4,8,0
"pensione",1,8,4,4,0
"harec",0,5,2,3,0
"wctlyelbvrp",0,11,1,10,0
"broguing",1,8,3,5,0
"revanchism",1,10,3,7,0
"whinang",0,7,2,5,0
"sweatsuits",1,10,4,6,0
"hatshepset",1,10,3,7,0
"interbastate",1,12,5,7,0
"roughness",1,9,3,6,0
"dressiness",1,10,3,7,0
"tactounpois",0,11,5,6,0
"transmutual",1,11,4,7,0
"tos",1,3,1,2,0
"pulaturis",0,9,4,5,0
"empatronizing",0,13,5,8,0
"streptoneura",1,12,5,7,0
"southard",1,8,3,5,0
"oconomowoc",1,10,5,5,0
"unsmokeable",1,11,5,6,0
"ganodonta",1,9,4,5,0
"bragg",1,5,1,4,0
"quadringenary",1,13,5,8,0
"scombroidea",1,11,5,6,0
"saseno",1,6,3,3,0
"vhckntnetr'zdad",0,15,2,13,1
"claque",1,6,3,3,0
"waft",1,4,1,3,0
"strichosauridae",0,15,7,8,0
"balon",1,5,2,3,0
"rorschach",1,9,2,7,0
"shawneetown",1,11,4,7,0
"isabelli",0,8,4,4,0
"katie",1,5,3,2,0
"elanurement",0,11,5,6,0
"ungenesis",0,9,4,5,0
"polarises",1,9,4,5,0
"dickhead",1,8,3,5,0
"truncatorotund",1,14,5,9,0
"inclinically",0,12,4,8,0
"anhydrosis",1,10,3,7,0
"ferongyldrynrklens",0,18,3,15,0
"nonproportionate",1,16,7,9,0
"prelatical",1,10,4,6,0
"mavournin",1,9,4,5,0
"acade",0,5,3,2,0
"papercutient",0,12,5,7,0
"rjt'xocbvphpt",0,13,1,12,1
"semipluminist",0,13,5,8,0
"toplaustomechbinded",0,19,7,12,0
"ple",0,3,1,2,0
"accessitudes",0,12,5,7,0
"countrywomen",1,12,4,8,0
"machs",1,5,1,4,0
"pyrogeneses",0,11,4,7,0
"tittles",1,7,2,5,0
"cian",0,4,2,2,0
"lennings",0,8,2,6,0
"intercorrelated",1,15,6,9,0
"sphygmic",1,8,1,7,0
"patiluda",0,8,4,4,0
"mastically",0,10,3,7,0
"ittacetters",0,11,4,7,0
"testand",0,7,2,5,0
"holuenthersed",0,13,5,8,0
"hatchonsiders",0,13,4,9,0
"'bym",0,4,0,4,1
"omphacy",1,7,2,5,0
"roundeleer",1,10,5,5,0
"glutinosity",1,11,4,7,0
"catholicisations",1,16,7,9,0
"trissartney",0,11,3,8,0
"islandic",1,8,3,5,0
"tgdlvissmvobez",0,14,3,11,0
"superabsorbent",1,14,5,9,0
"irimdxunzy",0,10,3,7,0
"reconverted",1,11,4,7,0
"eupurvis",0,8,4,4,0
"fegbqztxiebdaeuir'fpz",0,21,7,14,1
"acreodonisers",0,13,6,7,0
"emulsopticulabropet",0,19,8,11,0
"petrpolitic",0,11,4,7,0
"lexologic",0,9,4,5,0
"dishability",0,11,4,7,0
"aenneea",1,7,5,2,0
"playwoman",1,9,3,6,0
"trillionth",1,10,3,7,0
"artifactually",1,13,5,8,0
"homotore",0,8,4,4,0
"cornwell",1,8,2,6,0
"contrifugalled",0,14,5,9,0
"hrdrtiqbx'jx",0,12,1,11,1
"radioresigness",0,14,6,8,0
"ovie",0,4,3,1,0
"unbenevolentness",1,16,6,10,0
"iuvhsrrdcw",0,10,2,8,0
"zerla",1,5,2,3,0
"subcultun",0,9,3,6,0
"phatemeromuss",0,13,5,8,0
"coracovertebral",1,15,6,9,0
"strophyton",0,10,2,8,0
"partonshipmast",0,14,4,10,0
"mbitys",0,6,1,5,0
"aqxmhuhzxqt",0,11,2,9,0
"inboly",0,6,2,4,0
"porno",1,5,2,3,0
"bisulfite",1,9,4,5,0
"nullificationist",1,16,7,9,0
"fujfqxuemtbscyzpiuwt",0,20,5,15,0
"bespeaks",1,8,3,5,0
"heligmus",1,8,3,5,0
"hcaqslr",0,7,1,6,0
"prefabricant",0,12,4,8,0
"ijftzcyiy'qxlvvgb",0,17,2,15,1
"roops",1,5,2,3,0
"monegasque",1,10,5,5,0
"spdoxnpc",0,8,1,7,0
"jalevelulos",0,11,5,6,0
"nordicize",1,9,4,5,0
"parnites",0,8,3,5,0
"ndcc",1,4,0,4,0
"xiphopaguses",1,12,5,7,0
"corteise",1,8,4,4,0
"esticonkmed",0,11,4,7,0
"acrobative",0,10,5,5,0
"leatherist",0,10,4,6,0
"brenistle",0,9,3,6,0
"autistically",1,12,5,7,0
"tartraviated",0,12,5,7,0
"unbureaucratic",1,14,7,7,0
"triunity",1,8,3,5,0
"austrians",1,9,4,5,0
"welshism",1,8,2,6,0
"valternardo",0,11,4,7,0
"pyrolater",1,9,3,6,0
"cdqxnqelzivbcpgcow",0,18,3,15,0
"podothecium",0,11,5,6,0
"disparation",1,11,5,6,0
"slangulpy",0,9,2,7,0
"nonmembers",1,10,3,7,0
"temacronnipica",0,14,6,8,0
"blangle",0,7,2,5,0
"petees",0,6,3,3,0
"smudged",1,7,2,5,0
"htjcakalqk",0,10,2,8,0
"earpicks",1,8,3,5,0
"thermotaxic",1,11,4,7,0
"saphenosphere",0,13,5,8,0
"borte",0,5,2,3,0
"mentrabillu",0,11,4,7,0
"zmeyfcvovcbpsjuz",0,16,3,13,0
"onstad",1,6,2,4,0
"demythomatoscopes",0,17,6,11,0
"amoebida",1,8,5,3,0
"dataset",1,7,3,4,0
"centaur",1,7,3,4,0
"reshave",1,7,3,4,0
"homismeto",0,9,4,5,0
"radiodermatitis",1,15,7,8,0
"cropduster",1,10,3,7,0
"phujha",0,6,2,4,0
"nonpublication",1,14,6,8,0
"becquerel",1,9,4,5,0
"hygedroush",0,10,3,7,0
"hygromateri",0,11,4,7,0
"illegible",1,9,4,5,0
"extraterritorialness",0,20,8,12,0
"visnes",1,6,2,4,0
"guaneide",1,8,5,3,0
"subjenne",0,8,3,5,0
"subter",0,6,2,4,0
"cobocougbtro",0,12,5,7,0
"vasopressins",1,12,4,8,0
"extranormalities",0,16,7,9,0
"macushla",1,8,3,5,0
"franinated",0,10,4,6,0
"carcharodont",1,12,4,8,0
"electorial",1,10,5,5,0
"unmea",0,5,3,2,0
"dicrous",0,7,3,4,0
"affirmative",1,11,5,6,0
"uniriders",0,9,4,5,0
"overrefines",1,11,5,6,0
"synodalist",1,10,3,7,0
"unmolency",0,9,3,6,0
"trayscrabsorptional",0,19,6,13,0
"gimhrilgbpohlzcrpxrotkdojuub",0,28,7,21,0
"momos",1,5,2,3,0
"deceive",0,7,4,3,0
"conidia",1,7,4,3,0
"impuiser",0,8,4,4,0
"boastualian",0,11,6,5,0
"comanes",0,7,3,4,0
"wherefore",1,9,4,5,0
"jorgenstations",0,14,5,9,0
"blancanus",1,9,3,6,0
"tracheotome",1,11,5,6,0
"zygodactylous",1,13,4,9,0
"doxographically",0,15,5,10,0
"ichochrah",0,9,3,6,0
"gyliompogia",0,11,5,6,0
"sentifred",0,9,3,6,0
"catalysts",1,9,2,7,0
"dynastering",0,11,3,8,0
"tapermaker",1,10,4,6,0
"schizogregarinida",1,17,7,10,0
"upgathered",1,10,4,6,0
"rfdzkiw",0,7,1,6,0
"nonstyptical",1,12,3,9,0
"pardiac",0,7,3,4,0
"superiostegidae",0,15,8,7,0
"chevron",1,7,2,5,0
"anthimpist",0,10,3,7,0
"quitemoca",1,9,5,4,0
"triarchall",0,10,3,7,0
"evanetim",0,8,4,4,0
"termitaries",1,11,5,6,0
"auxoblast",1,9,4,5,0
"domatia",1,7,4,3,0
"wigranse",0,8,3,5,0
"daleloufryoppaste",0,17,7,10,0
"territuals",0,10,4,6,0
"ris",0,3,1,2,0
"xgiceliq''ylobx",0,15,4,11,2
"crampbit",1,8,2,6,0
"verile",1,6,3,3,0
"entonemertea",0,12,6,6,0
"taxialities",0,11,6,5,0
"mullo",0,5,2,3,0
"hexcumplarte",0,12,4,8,0
"chaiken",1,7,3,4,0
"tcrzknipzmavtgsyakclp",0,21,3,18,0
"filations",0,9,4,5,0
"understiculation",0,16,7,9,0
"hyporrhagia",0,11,4,7,0
"injectibility",0,13,5,8,0
"gerhan",1,6,2,4,0
"gy'kmvysodxruobjbucaimsgyqg",0,27,6,21,1
"myxopod",1,7,2,5,0
"chorioallantoid",1,15,7,8,0
"snugation",0,9,4,5,0
"anaxarete",1,9,5,4,0
"simplier",0,8,3,5,0
"substored",0,9,3,6,0
"ketosteroid",1,11,5,6,0
"tniswoamu",0,9,4,5,0
"unhydrated",1,10,3,7,0
"schizing",0,8,2,6,0
"vallery",1,7,2,5,0
"ranga",0,5,2,3,0
"eudism",0,6,3,3,0
"oxen",1,4,2,2,0
"mayoralty",1,9,3,6,0
"ungrd",0,5,1,4,0
"naevus",1,6,3,3,0
"oeseltingize",0,12,6,6,0
"molested",1,8,3,5,0
"excusively",1,10,4,6,0
"schrund",1,7,1,6,0
"sibbendy",1,8,2,6,0
"giuki",1,5,3,2,0
"shittle",0,7,2,5,0
"gundrove",0,8,3,5,0
"recombatant",0,11,4,7,0
"cypriatively",0,12,4,8,0
"drummy",1,6,1,5,0
"thalum",0,6,2,4,0
"sablenetbalastitessborfurt",0,26,9,17,0
"trimagin",0,8,3,5,0
"nonseasonable",1,13,6,7,0
"parcompartists",0,14,4,10,0
"emmensittye",0,11,4,7,0
"acequiaxed",0,10,6,4,0
"kaffing",0,7,2,5,0
"cippes",0,6,2,4,0
"a'miahf",0,7,3,4,1
"triturated",1,10,4,6,0
"uilijmswtw'ocda",0,15,5,10,1
"tqqydtxhtfebhze",0,15,2,13,0
"deadwort",1,8,3,5,0
"extirpative",1,11,5,6,0
"annalist",1,8,3,5,0
"peld",0,4,1,3,0
"bejesuiting",1,11,5,6,0
"absolutisms",1,11,4,7,0
"disunionisms",1,12,5,7,0
"joekins",0,7,3,4,0
"ichaly",0,6,2,4,0
"tula",1,4,2,2,0
"unguliform",0,10,4,6,0
"solick",0,6,2,4,0
"unhazarded",1,10,4,6,0
"resor",1,5,2,3,0
"festyna",0,7,2,5,0
"latyve",0,6,2,4,0
"disarconget",0,11,4,7,0
"maress",0,6,2,4,0
"monksofermarmantlends",0,21,6,15,0
"for",1,3,1,2,0
"attentively",1,11,4,7,0
"ancaliderf",0,10,4,6,0
"sturativelli",0,12,5,7,0
"rattlebrain",1,11,4,7,0
"micyle",0,6,2,4,0
"paraguayan",1,10,5,5,0
"louriest",1,8,4,4,0
"valerle",1,7,3,4,0
"nyceocumeridasms",0,16,6,10,0
"multibulaten",0,12,5,7,0
"paraspheric",0,11,4,7,0
"multipole",1,9,4,5,0
"psychodidae",1,11,4,7,0
"illimitation",1,12,6,6,0
"chagensathes",0,12,4,8,0
"preascenceably",0,14,5,9,0
"allys",1,5,1,4,0
"mandally",0,8,2,6,0
"jfc'c",0,5,0,5,1
"divisibility",1,12,5,7,0
"plumous",1,7,3,4,0
"hexokinase",1,10,5,5,0
"hospitium",1,9,4,5,0
"florulent",1,9,3,6,0
"innullsburg",0,11,3,8,0
"seeding",1,7,3,4,0
"babbism",0,7,2,5,0
"ock",0,3,1,2,0
"theurgis",0,8,3,5,0
"suberinize",1,10,5,5,0
"rionsburgenoholammeroddellymnum",0,31,11,20,0
"bibliopeithognosauria",0,21,11,10,0
"hypocarpic",0,10,3,7,0
"hietorebasives",0,14,7,7,0
"gabun",1,5,2,3,0
"mobproof",1,8,3,5,0
"byplay",1,6,1,5,0
"battlewagons",1,12,4,8,0
"maques",0,6,3,3,0
"maglemose",1,9,4,5,0
"slabbery",1,8,2,6,0
"vzsluwmhnzkifennlursgvb'pg",0,26,4,22,1
"archidologist",0,13,5,8,0
"rivet",1,5,2,3,0
"broadax",1,7,3,4,0
"concrease",0,9,4,5,0
"cascadine",0,9,4,5,0
"hiestandardbred",0,15,5,10,0
"furrow",1,6,2,4,0
"still",1,5,1,4,0
"femtometre",1,10,4,6,0
"bedworth",1,8,2,6,0
"uvhgafbkgfrwxjqyucgq",0,20,3,17,0
"glueprincumbentomethylglutings",0,30,9,21,0
"cicornly",0,8,2,6,0
"arthron",1,7,2,5,0
"destructibly",0,12,3,9,0
"pizzed",0,6,2,4,0
"mistriatchrosativarco",0,21,8,13,0
"whipstalk",1,9,2,7,0
"garageable",1,10,5,5,0
"membhismmmiorourophorinceexygacrpsiutyiasiforincy",0,49,19,30,0
"destinative",0,11,5,6,0
"pogit",0,5,2,3,0
"tarrationpers",0,13,5,8,0
"feijoada",1,8,5,3,0
"expurgators",1,11,4,7,0
"pollable",1,8,3,5,0
"hayrack",1,7,2,5,0
"halsed",1,6,2,4,0
"bromothymol",1,11,3,8,0
"sylvie",1,6,2,4,0
"siricid",1,7,3,4,0
"auxanogram",1,10,5,5,0
"khedivates",1,10,4,6,0
"navasota",1,8,4,4,0
"tapolyting",0,10,3,7,0
"beitris",1,7,3,4,0
"insignifier",0,11,5,6,0
"villanelle",1,10,4,6,0
"rhizon",0,6,2,4,0
"cel",0,3,1,2,0
"talker",1,6,2,4,0
"fraction",1,8,3,5,0
"resistibleness",0,14,5,9,0
"o'gghxpmt'mff'ydobqdxqo",0,23,3,20,3
"block",1,5,1,4,0
"misreprognaturability",0,21,8,13,0
"overhostility",1,13,5,8,0
"unevitably",1,10,4,6,0
"callions",0,8,3,5,0
"pronk",1,5,1,4,0
"reservationist",1,14,6,8,0
"aeromaean",0,9,6,3,0
"seroanaphylaxis",1,15,6,9,0
"dunsteirtophonical",0,18,7,11,0
"eurs",0,4,2,2,0
"ykao'dlgcd",0,10,2,8,1
"nurljdwgsrgnd",0,13,1,12,0
"ning",0,4,1,3,0
"calycentiators",0,14,5,9,0
"firmans",1,7,2,5,0
"isimud",1,6,3,3,0
"brio",1,4,2,2,0
"nonsummons",1,10,3,7,0
"uzqqqnckwdorvyetlhoy'jz",0,23,4,19,1
"marchd",0,6,1,5,0
"chromatists",1,11,3,8,0
"chaun",0,5,2,3,0
"scolparagula",0,12,5,7,0
"lynch",1,5,0,5,0
"imbecilite",0,10,5,5,0
"nosome",0,6,3,3,0
"mesogloea",1,9,5,4,0
"rhene",1,5,2,3,0
"ohineum",0,7,4,3,0
"phlegmatypy",0,11,2,9,0
"stockyard",1,9,2,7,0
"chesnut",1,7,2,5,0
"chiasmatic",1,10,4,6,0
"fleckers",1,8,2,6,0
"ushy",0,4,1,3,0
"heminal",0,7,3,4,0
"rubashelwe",0,10,4,6,0
"suchier",0,7,3,4,0
"earhenguns",0,10,4,6,0
"subocasuscal",0,12,5,7,0
"gramedy",0,7,2,5,0
"goverscarvel",0,12,4,8,0
"cercis",1,6,2,4,0
"superstructressed",0,17,5,12,0
"enculture",0,9,4,5,0
"nilometric",1,10,4,6,0
"counterpleural",0,14,6,8,0
"mellitons",0,9,3,6,0
"thredgwunt",0,10,2,8,0
"tastekin",1,8,3,5,0
"aswires",0,7,3,4,0
"'wrockjkirkw",0,12,2,10,1
"dilled",1,6,2,4,0
"adrenolytic",1,11,4,7,0
"cajwadodon",0,10,4,6,0
"jawcrusher",1,10,3,7,0
"nti",0,3,1,2,0
"heucheras",1,9,4,5,0
"ovariocyesis",1,12,6,6,0
"abanga",1,6,3,3,0
"throphoty",0,9,2,7,0
"fennelly",1,8,2,6,0
"muppet",1,6,2,4,0
"sheatherodiaster",0,16,7,9,0
"mareld",1,6,2,4,0
"dodlet",1,6,2,4,0
"gagastrochotory",0,15,5,10,0
"overcommits",1,11,4,7,0
"implacablenesses",1,16,6,10,0
"turpitude",1,9,4,5,0
"pileolus",0,8,4,4,0
"pabarensoltawobry",0,17,6,11,0
"chimakua",0,8,4,4,0
"engarment",1,9,3,6,0
"jyvwvyqktkrto'cio",0,17,3,14,1
"bonediak",0,8,4,4,0
"shinuting",0,9,3,6,0
"lodesman",1,8,3,5,0
"imaur",0,5,3,2,0
"ggpdhgfwstfjl",0,13,0,13,0
"nxibddh'dos",0,11,2,9,1
"divergence",1,10,4,6,0
"kjuliaminishness",0,16,6,10,0
"llvspjg'icyoyjsqjdcfeaakcq",0,26,5,21,1
"apokatastasis",1,13,6,7,0
"biallyl",1,7,2,5,0
"unexculpably",1,12,4,8,0
"supercriminant",0,14,5,9,0
"reightileness",0,13,5,8,0
"fumez",0,5,2,3,0
"moding",0,6,2,4,0
"snouistenexcer",0,14,6,8,0
"mountaineering",1,14,7,7,0
"clambe",0,6,2,4,0
"ulas",0,4,2,2,0
"hyperconsciousness",1,18,6,12,0
"stagflation",1,11,4,7,0
"temporofrontal",1,14,5,9,0
"bryn",1,4,0,4,0
"greenskeepers",1,13,5,8,0
"tinmnqerhtrdadhojoniqknte'k",0,27,7,20,1
"nkgxalpxxty",0,11,1,10,0
"aschelminthes",1,13,4,9,0
"uninsulating",1,12,5,7,0
"harportedly",0,11,3,8,0
"gonealectrobiosynthium",0,22,9,13,0
"kneeler",1,7,3,4,0
"hyposarca",1,9,3,6,0
"republicable",0,12,5,7,0
"parama",0,6,3,3,0
"nocea",0,5,3,2,0
"millechimic",0,11,4,7,0
"dhaleridiomiotrkbati",0,20,9,11,0
"hussy",1,5,1,4,0
"uncersh",0,7,2,5,0
"pleaseptualisedness",0,19,8,11,0
"anguiss",0,7,3,4,0
"elocutionist",1,12,6,6,0
"bushrangs",0,9,2,7,0
"visconti",1,8,3,5,0
"conferva",1,8,3,5,0
"syndactylic",1,11,2,9,0
"nitrimerates",0,12,5,7,0
"cleistos",0,8,3,5,0
"chiegenaniania",0,14,8,6,0
"decolorimer",0,11,5,6,0
"ballsenterovilleur",0,18,7,11,0
"'a'vauzwif",0,10,4,6,2
"lumidophycernvirt",0,17,5,12,0
"utughementhr",0,12,4,8,0
"pesade",1,6,3,3,0
"polystictus",1,11,3,8,0
"wock",1,4,1,3,0
"impetrator",1,10,4,6,0
"ddonozzan",0,9,3,6,0
"porulent",0,8,3,5,0
"uund",1,4,2,2,0
"bpxptbg",0,7,0,7,0
"unmissed",1,8,3,5,0
"nazymoricisatacarboscea",0,23,10,13,0
"phntinoubelima",0,14,6,8,0
"disputist",0,9,3,6,0
"doork",0,5,2,3,0
"progymnasium",1,12,4,8,0
"lamrouex",1,8,4,4,0
"mzcwwgxajdszm",0,13,1,12,0
"photoautotroph",1,14,6,8,0
"unthiondlgnapradlumatonaloopheterearaninttis",0,44,18,26,0
"cryphote",0,8,2,6,0
"holobioncouconed",0,16,8,8,0
"spassky",1,7,1,6,0
"chainwork",1,9,3,6,0
"amesaces",1,8,4,4,0
"stricons",0,8,2,6,0
"summersetted",1,12,4,8,0
"disimprovement",1,14,5,9,0
"pegboard",1,8,3,5,0
"peekapoos",1,9,5,4,0
"macrotherioid",1,13,6,7,0
"inglaementalocytiversoleds",0,26,10,16,0
"lezconpsaov'gkkgcc",0,18,4,14,1
"jointuress",1,10,4,6,0
"derogatorinesses",1,16,7,9,0
"snakelet",1,8,3,5,0
"supercarbureters",0,16,6,10,0
"continener",0,10,4,6,0
"effelatukergatl",0,15,6,9,0
"sakoviality",0,11,5,6,0
"pationthoesolike",0,16,8,8,0
"nonsolidifying",1,14,5,9,0
"bodies",1,6,3,3,0
"unfriendship",1,12,4,8,0
"quartermistresses",1,17,6,11,0
"omnigenous",1,10,5,5,0
"weat",0,4,2,2,0
"msmqxmcrosmp'z",0,14,1,13,1
"foreuse",1,7,4,3,0
"unackhus",0,8,3,5,0
"fructuarius",1,11,5,6,0
"discretinae",0,11,5,6,0
"glugs",1,5,1,4,0
"counterraids",1,12,5,7,0
"returnlessly",1,12,3,9,0
"zkfskcqtusnsujz",0,15,2,13,0
"glucayan",0,8,3,5,0
"morphologic",1,11,4,7,0
"rondelier",1,9,4,5,0
"harrhophylvats",0,14,3,11,0
"carbamine",1,9,4,5,0
"pyrenocorticelloid",0,18,7,11,0
"hydroferricyanide",0,17,6,11,0
"carbines",1,8,3,5,0
"ckeivelicactis",0,14,6,8,0
"senecal",1,7,3,4,0
"daffydowndillies",0,16,5,11,0
"asphalt",1,7,2,5,0
"erie",1,4,3,1,0
"coflakynemeatowarinonilaninsis",0,30,13,17,0
"dementing",1,9,3,6,0
"protoconcavengest",0,17,6,11,0
"spreaghery",1,10,3,7,0
"paba",1,4,2,2,0
"trophe",0,6,2,4,0
"persecutive",1,11,5,6,0
"peloton",1,7,3,4,0
"boars",1,5,2,3,0
"ecammidae",0,9,5,4,0
"sporangiform",1,12,4,8,0
"byland",1,6,1,5,0
"panticonogen",0,12,5,7,0
"giater",0,6,3,3,0
"bullshot",1,8,2,6,0
"granollership",0,13,4,9,0
"avestan",1,7,3,4,0
"exochlegs",0,9,3,6,0
"hpty",0,4,0,4,0
"roadside",1,8,4,4,0
"calogy",0,6,2,4,0
"platycephalograph",0,17,5,12,0
"macrorheometry",0,14,5,9,0
"anvilled",1,8,3,5,0
"jayem",1,5,2,3,0
"ramine",0,6,3,3,0
"mailburhynchy",0,13,3,10,0
"befoamingly",0,11,4,7,0
"masochisms",1,10,3,7,0
"shf",1,3,0,3,0
"tenewaregats",0,12,5,7,0
"postfoetal",1,10,4,6,0
"cetefle",0,7,3,4,0
"anaesthesia",1,11,6,5,0
"heddeja",0,7,3,4,0
"tellioscery",0,11,4,7,0
"baaft",0,5,2,3,0
"eberewavurerteuvaecoalyseros",0,28,14,14,0
"textuaries",1,10,5,5,0
"titillated",1,10,4,6,0
"botikpstidelmmeas",0,17,6,11,0
"ascii",1,5,3,2,0
"bernardine",1,10,4,6,0
"hipberry",1,8,2,6,0
"circaeaceae",1,11,7,4,0
"gasbag",1,6,2,4,0
"embrutening",0,11,4,7,0
"gackvfdmqjzpzvj",0,15,1,14,0
"izxacvtdrdkei",0,13,4,9,0
"caragadzonism",0,13,5,8,0
"fawnerallumine",0,14,6,8,0
"maximo",1,6,3,3,0
"distillment",1,11,3,8,0
"deurotocology",0,13,6,7,0
"playbills",1,9,2,7,0
"unsaids",0,7,3,4,0
"latowt",0,6,2,4,0
"seball",0,6,2,4,0
"athalodimerger",0,14,6,8,0
"headcastigophyllophagi",0,22,8,14,0
"jwznn'xfvvldybjir",0,17,1,16,1
"schoolmoschemic",0,15,5,10,0
"christianopagandist",0,19,7,12,0
"tkhvykarmcmetkoxp'",0,18,3,15,1
"glossolalists",1,13,4,9,0
"mutase",1,6,3,3,0
"melism",0,6,2,4,0
"cardom",0,6,2,4,0
"nonconcurrent",1,13,4,9,0
"unkneaded",1,9,4,5,0
"optimiser",1,9,4,5,0
"mulbarfondo",0,11,4,7,0
"kinsman",1,7,2,5,0
"donhercravoldecingobaryike",0,26,10,16,0
"belletristically",0,16,5,11,0
"ramism",1,6,2,4,0
"unthick",1,7,2,5,0
"pysegonarvinttrata",0,18,6,12,0
"dize",0,4,2,2,0
"sherbert",1,8,2,6,0
"adezwn",0,6,2,4,0
"proceduring",1,11,4,7,0
"cixtbkjuiv'lnxjopoqfyt'",0,23,5,18,2
"savorly",0,7,2,5,0
"seyler",1,6,2,4,0
"studinae",0,8,4,4,0
"sonk",1,4,1,3,0
"cornea",1,6,3,3,0
"snowmobilists",1,13,4,9,0
"pronohanut",0,10,4,6,0
"eremia",0,6,4,2,0
"utqrdrncyarca",0,13,3,10,0
"chaselessness",0,13,4,9,0
"debasic",0,7,3,4,0
"wiouseaca",0,9,6,3,0
"woszquusoyhteb'vty",0,18,5,13,1
"nonoccultatoria",0,15,7,8,0
"suturally",1,9,3,6,0
"maccabaws",1,9,3,6,0
"eburine",1,7,4,3,0
"'roubjuo'fdsux",0,14,5,9,2
"niuvbmymqe",0,10,3,7,0
"pseudodiphtheritises",0,20,8,12,0
"martias",0,7,3,4,0
"snowbell",1,8,2,6,0
"periacinous",1,11,6,5,0
"unpictured",1,10,4,6,0
"ustesimbichom",0,13,5,8,0
"ytkxfrpijthyac",0,14,2,12,0
"uncontralistituliparoecoins",0,27,12,15,0
"surome",0,6,3,3,0
"gabune",0,6,3,3,0
"whousnenchile",0,13,5,8,0
"hairweavers",1,11,5,6,0
"americ",0,6,3,3,0
"halamdiggeranning",0,17,6,11,0
"aden",1,4,2,2,0
"subconcealed",1,12,5,7,0
"blepharoptosis",1,14,5,9,0
"pugmarks",1,8,2,6,0
"podanger",1,8,3,5,0
"malle",0,5,2,3,0
"rhiniat",0,7,3,4,0
"ambittering",0,11,4,7,0
"guenna",1,6,3,3,0
"lietoypqyzxuozcjnexr",0,20,6,14,0
"puman",0,5,2,3,0
"boltcutter",1,10,3,7,0
"ruffs",1,5,1,4,0
"malvern",1,7,2,5,0
"electroneutralism",0,17,7,10,0
"anaesthesias",1,12,6,6,0
"baastan",1,7,3,4,0
"swerwinomyrapter",0,16,5,11,0
"gesanamis",0,9,4,5,0
"tega",1,4,2,2,0
"idelem",0,6,3,3,0
"mcgrody",1,7,1,6,0
"overadjustment",1,14,5,9,0
"ubianedxgv",0,10,4,6,0
"tastic",0,6,2,4,0
"moia",1,4,3,1,0
"unwily",1,6,2,4,0
"blubbering",1,10,3,7,0
"pexitictenmptaeibewad",0,21,9,12,0
"emulsification",1,14,7,7,0
"unsimulate",0,10,5,5,0
"thoom",1,5,2,3,0
"nist",0,4,1,3,0
"vermifugous",1,11,5,6,0
"laminectomies",1,13,6,7,0
"rndncynwnz'znm",0,14,0,14,1
"resses",0,6,2,4,0
"shri",1,4,1,3,0
"jinny",1,5,1,4,0
"enviolabilids",0,13,6,7,0
"garm",1,4,1,3,0
"revenued",1,8,4,4,0
"billabongs",1,10,3,7,0
"acand",0,5,2,3,0
"lugwort",0,7,2,5,0
"lycina",0,6,2,4,0
"complexifies",1,12,5,7,0
"nonromoebearton",0,15,7,8,0
"ze'ented",0,8,3,5,1
"ovispersistence",0,15,6,9,0
"chemicales",0,10,4,6,0
"jptrmybjnierlo",0,14,3,11,0
"desperolvilabitallanptll",0,24,8,16,0
"uness",0,5,2,3,0
"torpex",1,6,2,4,0
"granoishboyad",0,13,5,8,0
"relecon",0,7,3,4,0
"adscriptions",1,12,4,8,0
"ntitaneranesicicon",0,18,8,10,0
"vilite",0,6,3,3,0
"southwestwardmost",0,17,5,12,0
"sheeny",1,6,2,4,0
"tubar",1,5,2,3,0
"jacintha",1,8,3,5,0
"scotophobia",1,11,5,6,0
"catharan",1,8,3,5,0
"hworskbgycne",0,12,2,10,0
"jeerfate",0,8,4,4,0
"waregga",1,7,3,4,0
"didae",0,5,3,2,0
"mucomembrane",0,12,5,7,0
"compressible",1,12,4,8,0
"ineducatronix",0,13,6,7,0
"staggerers",1,10,3,7,0
"lepididymal",0,11,4,7,0
"filialnesses",1,12,5,7,0
"veferuswanpuetes",0,16,7,9,0
"labbarobirentholare",0,19,8,11,0
"lienomyelogenous",1,16,8,8,0
"chaffet",0,7,2,5,0
"fireship",1,8,3,5,0
"chap",1,4,1,3,0
"ter",0,3,1,2,0
"claywear",0,8,3,5,0
"punerouss",0,9,4,5,0
"calderca",1,8,3,5,0
"hfgwubodvjjfcaks'rlacab",0,23,5,18,1
"kegilinouts",0,11,5,6,0
"revely",0,6,2,4,0
"fulleginantawaninanelormueeviltilaullishenstic",0,46,20,26,0
"fulcra",1,6,2,4,0
"chortosterol",1,12,4,8,0
"austerities",1,11,6,5,0
"leo",1,3,2,1,0
"catamountain",1,12,6,6,0
"cormakincytheanhable",0,20,7,13,0
"gratten",1,7,2,5,0
"hagicea",0,7,4,3,0
"orrisroot",1,9,4,5,0
"gatiamaca",0,9,5,4,0
"sublimings",1,10,3,7,0
"vwjbizkjbjhkdplichofsjaqamcpj",0,29,5,24,0
"rydelinnatheiscorrealigotria",0,28,12,16,0
"occubrow",0,8,3,5,0
"biaxwism",0,8,3,5,0
"wheetnikov",0,10,4,6,0
"jacitara",1,8,4,4,0
"akrages",0,7,3,4,0
"unreasonably",1,12,5,7,0
"unclosers",0,9,3,6,0
"leptorrhine",1,11,4,7,0
"pataco",1,6,3,3,0
"augenincernaleist",0,17,8,9,0
"proformas",1,9,3,6,0
"slenicarimiu",0,12,6,6,0
"vkwvpwzxrqqy",0,12,0,12,0
"prerevelrousness",0,16,6,10,0
"undefeatableness",1,16,7,9,0
"fortumn",0,7,2,5,0
"syncess",0,7,1,6,0
"cascarillas",1,11,4,7,0
"lative",1,6,3,3,0
"peroneal",1,8,4,4,0
"mabobjumaitiped",0,15,7,8,0
"joculationatus",0,14,7,7,0
"labdabs",0,7,2,5,0
"overreduce",1,10,5,5,0
"unendoerus",0,10,5,5,0
"jhspyyrilfpmrc",0,14,1,13,0
"claimer",1,7,3,4,0
"brandisements",0,13,4,9,0
"hangbird",1,8,2,6,0
"nating",0,6,2,4,0
"involumets",0,10,4,6,0
"diprotodan",1,10,4,6,0
"importless",1,10,3,7,0
"assevered",1,9,4,5,0
"copal",1,5,2,3,0
"overmuse",1,8,4,4,0
"ophioninae",1,10,6,4,0
"unprotruded",1,11,4,7,0
"splenculus",1,10,3,7,0
"pourneyvorousness",0,17,7,10,0
"foreclothman",0,12,4,8,0
"theosophies",1,11,5,6,0
"navicella",1,9,4,5,0
"gangliosides",1,12,5,7,0
"literato",1,8,4,4,0
"brachiopod",1,10,4,6,0
"sari",1,4,2,2,0
"deplete",1,7,3,4,0
"steads",1,6,2,4,0
"ogqcjfl'iwpgucjivr'qjdp",0,23,4,19,2
"stinkwort",1,9,2,7,0
"goniffs",1,7,2,5,0
"disgarrisoning",1,14,5,9,0
"waterboro",1,9,4,5,0
"bonomits",0,8,3,5,0
"gaypialaus",0,10,5,5,0
"mositiancea",0,11,6,5,0
"chayotes",1,8,3,5,0
"imposthume",1,10,4,6,0
"chaponisted",0,11,4,7,0
"gippinesses",0,11,4,7,0
"pallion",1,7,3,4,0
"pressingnesses",1,14,4,10,0
"camphalterioplebard",0,19,7,12,0
"fanioned",1,8,4,4,0
"rctlgfs",0,7,0,7,0
"maginappreights",0,15,5,10,0
"inflectionist",0,13,5,8,0
"superbenefit",1,12,5,7,0
"tamals",1,6,2,4,0
"bian",0,4,2,2,0
"'iuqaqgystuyb",0,13,4,9,1
"legionry",1,8,3,5,0
"tipsiness",1,9,3,6,0
"vicariism",1,9,4,5,0
"ulznppyez",0,9,2,7,0
"satie",1,5,3,2,0
"gastroenterologists",1,19,7,12,0
"pphis",0,5,1,4,0
"inductance",1,10,4,6,0
"reinilate",0,9,5,4,0
"cobourage",0,9,5,4,0
"octomeral",1,9,4,5,0
"ouste",0,5,3,2,0
"dugongidae",1,10,5,5,0
"jdfwcjd'u",0,9,1,8,1
"cutey",1,5,2,3,0
"cognost",0,7,2,5,0
"boundivingly",0,12,4,8,0
"hepplewhit",0,10,3,7,0
"rebaptist",0,9,3,6,0
"amphisbaenian",1,13,6,7,0
"marginirostrate",0,15,6,9,0
"griffes",1,7,2,5,0
"suniesopinerionotanjapeys",0,25,12,13,0
"enchify",0,7,2,5,0
"crunt",1,5,1,4,0
"anser",1,5,2,3,0
"episkeletonian",0,14,7,7,0
"cnidaria",1,8,4,4,0
"elfrieda",1,8,4,4,0
"taganisms",0,9,3,6,0
"mikadoate",1,9,5,4,0
"nivir",0,5,2,3,0
"rywtwmmtciyxohzgsoq",0,19,3,16,0
"kordofan",1,8,3,5,0
"dentine",1,7,3,4,0
"ylimscsd",0,8,1,7,0
"pentyl",1,6,1,5,0
"traumatise",1,10,5,5,0
"imprudes",0,8,3,5,0
"sudable",0,7,3,4,0
"agnetic",0,7,3,4,0
"paroariousness",0,14,7,7,0
"qsjuqjefrelo",0,12,4,8,0
"royalist",1,8,3,5,0
"mediopation",0,11,6,5,0
"daugs",0,5,2,3,0
"buccate",1,7,3,4,0
"ambrosera",0,9,4,5,0
"coquinoid",0,9,5,4,0
"forresponsively",0,15,5,10,0
"costogenic",1,10,4,6,0
"hocuttinadaminkesutoalrnda",0,26,11,15,0
"brd",0,3,0,3,0
"nonmouthing",0,11,4,7,0
"nantyglo",1,8,2,6,0
"advection",1,9,4,5,0
"occupant",1,8,3,5,0
"wwnabz'xlxe",0,11,2,9,1
"tadscisthe",0,10,3,7,0
"sweetbrier",1,10,4,6,0
"uok",0,3,2,1,0
"enthrilling",0,11,3,8,0
"viatica",1,7,4,3,0
"mubonssuns",0,10,3,7,0
"uptrending",1,10,3,7,0
"acgfmwuzowqiv",0,13,4,9,0
"monodrama",1,9,4,5,0
"ausonian",1,8,5,3,0
"merunerolcas",0,12,5,7,0
"derability",0,10,4,6,0
"abms",1,4,1,3,0
"nacns",0,5,1,4,0
"pyrankillefutereumophograha",0,27,11,16,0
"salampore",1,9,4,5,0
"aucubas",1,7,4,3,0
"szekszrd",1,8,1,7,0
"bandset",0,7,2,5,0
"matuddly",0,8,2,6,0
"optacon",1,7,3,4,0
"pentacular",1,10,4,6,0
"lemintiverats",0,13,5,8,0
"buissons",0,8,3,5,0
"uncotoronainon",0,14,7,7,0
"dreams",1,6,2,4,0
"acronyms",1,8,2,6,0
"notintra",0,8,3,5,0
"ggari",0,5,2,3,0
"bettergate",0,10,4,6,0
"spondyloses",1,11,3,8,0
"rvxw'tfqilpafdckuisyeof",0,23,6,17,1
"poluttiontora",0,13,6,7,0
"sovietological",1,14,7,7,0
"aliatatismemse",0,14,7,7,0
"geochron",0,8,3,5,0
"buerger",1,7,3,4,0
"pliocentric",0,11,4,7,0
"caliologies",1,11,6,5,0
"landfordictive",0,14,5,9,0
"unrind",1,6,2,4,0
"proleta",0,7,3,4,0
"braemar",1,7,3,4,0
"tyrtaeus",1,8,3,5,0
"clinis",1,6,2,4,0
"cornrows",1,8,2,6,0
"inspirate",1,9,4,5,0
"andyncurs",0,9,2,7,0
"telecommunities",0,15,7,8,0
"thionism",0,8,3,5,0
"dibias",0,6,3,3,0
"polonial",1,8,4,4,0
"materghherimpennestanagitespernichabia",0,38,15,23,0
"homocentrals",0,12,4,8,0
"'cgsdikebbtbkwsbexet",0,20,4,16,1
"bgwfzoeoydnijjwluzlwsb",0,22,5,17,0
"hydrolysable",1,12,3,9,0
"clysma",1,6,1,5,0
"phersuperghebandablenevoleonia",0,30,13,17,0
"scurrilous",1,10,4,6,0
"unconversantly",0,14,4,10,0
"compossibleness",0,15,5,10,0
"cenaiss",0,7,3,4,0
"opissive",0,8,4,4,0
"umpirism",1,8,3,5,0
"fiatooelnagicoogrerarnie",0,24,13,11,0
"'vuebywoscaoi'pcsdof'r",0,22,7,15,3
"batheable",1,9,4,5,0
"duls",0,4,1,3,0
"oxamid",1,6,3,3,0
"nonvesture",1,10,4,6,0
"obsignated",1,10,4,6,0
"sphandrs",0,8,1,7,0
"incremental",1,11,4,7,0
"meisel",1,6,3,3,0
"sneath",1,6,2,4,0
"dullingelicoelippeprist",0,23,9,14,0
"pydbywvkswzddfz'",0,16,0,16,1
"gozamvxmmxvteqcbdsxq",0,20,3,17,0
"contifedin",0,10,4,6,0
"oreachemadestoneting",0,20,9,11,0
"miketrack",0,9,3,6,0
"megawatts",1,9,3,6,0
"updries",1,7,3,4,0
"randienterfishy",0,15,5,10,0
"cibis",1,5,2,3,0
"oabwrpmivqn''qihyimrs",0,21,5,16,2
"gasconism",1,9,3,6,0
"suberingleezle",0,14,6,8,0
"htllgayvcdjauhvucograc",0,22,6,16,0
"outspritous",0,11,5,6,0
"tashmiria",0,9,4,5,0
"hadean",1,6,3,3,0
"wbyvdzgmxxheuqetbrtqmfojrwxk",0,28,4,24,0
"pyrrhonia",0,9,3,6,0
"propulsions",1,11,4,7,0
"hausatic",0,8,4,4,0
"pati",0,4,2,2,0
"fliectristonistoratradent",0,25,9,16,0
"frithstood",0,10,3,7,0
"abilyne",1,7,3,4,0
"orientation",1,11,6,5,0
"calabreses",1,10,4,6,0
"huttan",1,6,2,4,0
"pyodflktfqdvrbau",0,16,3,13,0
"azjsgdalac'cswvtzia'pegz'nwhzs",0,30,6,24,3
"restrung",1,8,2,6,0
"diolasterched",0,13,5,8,0
"hypermerocyanoma",0,16,6,10,0
"brevis",1,6,2,4,0
"hlpqaqjpnprdplptz'khdxse",0,24,2,22,1
"mallanders",1,10,3,7,0
"maches",1,6,2,4,0
"misfalne",1,8,3,5,0
"caching",1,7,2,5,0
"misleared",1,9,4,5,0
"synovitelle",0,11,4,7,0
"prepolitically",1,14,5,9,0
"mahads",0,6,2,4,0
"resketchblock",0,13,3,10,0
"componerosis",0,12,5,7,0
"rucks",1,5,1,4,0
"'dluttozq",0,9,2,7,1
"lapacial",0,8,4,4,0
"deviseurs",0,9,4,5,0
"talon",1,5,2,3,0
"sistersink",0,10,3,7,0
"mielziner",1,9,4,5,0
"monosomic",1,9,4,5,0
"isadora",1,7,4,3,0
"trochemistracodontidae",0,22,9,13,0
"golanka",1,7,3,4,0
"factively",0,9,3,6,0
"ectasis",1,7,3,4,0
"prlyalapainovelles",0,18,7,11,0
"rgp",1,3,0,3,0
"templacentrop",0,13,4,9,0
"zebractylummederpitaristramlike",0,31,11,20,0
"grammatinism",0,12,4,8,0
"harb",1,4,1,3,0
"bumacerred",0,10,4,6,0
"udb",1,3,1,2,0
"tritonitis",0,10,4,6,0
"cagonc",0,6,2,4,0
"prehensibiliane",0,15,7,8,0
"neckatees",1,9,4,5,0
"motzas",1,6,2,4,0
"flimmer",1,7,2,5,0
"mataeotechnical",0,15,7,8,0
"anny",1,4,1,3,0
"gowdnie",1,7,3,4,0
"prise",1,5,2,3,0
"kxounvzrsjbezmwoeizqg",0,21,6,15,0
"sclaverous",0,10,4,6,0
"mindergravese",0,13,5,8,0
"immunopathologiser",0,18,8,10,0
"goyish",1,6,2,4,0
"nonecliptical",1,13,5,8,0
"trecenter",0,9,3,6,0
"perfused",1,8,3,5,0
"fundelt",0,7,2,5,0
"asparied",0,8,4,4,0
"pineywoods",1,10,4,6,0
"gladipleaxes",0,12,5,7,0
"haulyard",1,8,3,5,0
"superattractiveness",1,19,7,12,0
"plikeatens",0,10,4,6,0
"dianion",0,7,4,3,0
"terariipyraide",0,14,7,7,0
"wbmxrip",0,7,1,6,0
"keherinnerentomamoreene",0,23,11,12,0
"greenness",1,9,3,6,0
"somewhile",1,9,4,5,0
"yuponlee",0,8,4,4,0
"antiffolkingulation",0,19,8,11,0
"hiscortion",0,10,4,6,0
"heinties",0,8,4,4,0
"supersize",1,9,4,5,0
"unexhaustibly",1,13,5,8,0
"nutindolleys",0,12,4,8,0
"panjandarus",0,11,4,7,0
"parindistrial",0,13,5,8,0
"rten",0,4,1,3,0
"scurrility",1,10,3,7,0
"eupst",0,5,2,3,0
"frerallic",0,9,3,6,0
"unblushes",0,9,3,6,0
"glossodynia",1,11,4,7,0
"hucke",0,5,2,3,0
"mischaracterise",1,15,6,9,0
"blackbeat",0,9,3,6,0
"oyltkupinellyllidamtarabereedudompsshiched",0,42,15,27,0
"puppromola",0,10,4,6,0
"ltvn",0,4,0,4,0
"magallan",0,8,3,5,0
"aphototaxis",1,11,5,6,0
"metafictionist",1,14,6,8,0
"tecallgabus",0,11,4,7,0
"pinata",1,6,3,3,0
"fkqvshhkcpvj",0,12,0,12,0
"orella",1,6,3,3,0
"scatteration",1,12,5,7,0
"picist",0,6,2,4,0
"comersolan",0,10,4,6,0
"kelity",0,6,2,4,0
"kusin",1,5,2,3,0
"ensphering",1,10,3,7,0
"zpbt'g",0,6,0,6,1
"menings",0,7,2,5,0
"areographemeritmonger",0,21,9,12,0
"vcgviwgglslckacyk'y",0,19,2,17,1
"makeup",1,6,3,3,0
"atocidae",0,8,5,3,0
"infamonised",1,11,5,6,0
"earclip",1,7,3,4,0
"hassless",0,8,2,6,0
"spriteliest",1,11,4,7,0
"enrolment",1,9,3,6,0
"infest",1,6,2,4,0
"zooidiophilous",1,14,8,6,0
"proparda",0,8,3,5,0
"earthmoving",1,11,4,7,0
"uptrayzcmkipbegaxnfhbnfjrijj",0,28,6,22,0
"myenteron",1,9,3,6,0
"antichloristic",1,14,5,9,0
"marvella",1,8,3,5,0
"recatechheim",0,12,5,7,0
"bankets",1,7,2,5,0
"propoxyphene",1,12,4,8,0
"snarthybowicks",0,14,3,11,0
"pthalavia",0,9,4,5,0
"sulcidly",0,8,2,6,0
"baaojeqdzlfnmp",0,14,4,10,0
"guyses",1,6,2,4,0
"counterclaimant",1,15,6,9,0
"soggings",1,8,2,6,0
"obelions",1,8,4,4,0
"dispredus",0,9,3,6,0
"kzzoumlzgfbfkya'vveoqapppptut",0,29,7,22,1
"pocuiores",0,9,5,4,0
"ateymb'can",0,10,3,7,1
"clinkering",1,10,3,7,0
"icos",0,4,2,2,0
"ouuzjiur",0,8,5,3,0
"teleostomous",1,12,6,6,0
"ridicralidadie",0,14,7,7,0
"reskuing",1,8,3,5,0
"adey",1,4,2,2,0
"paleomagnetic",0,13,6,7,0
"romancy",0,7,2,5,0
"poliketterial",0,13,6,7,0
"cholesterinic",1,13,5,8,0
"sickleman",1,9,3,6,0
"aslop",1,5,2,3,0
"commationemonise",0,16,8,8,0
"maulding",0,8,3,5,0
"giamdmphcwegefolevqgzrd'jd",0,26,6,20,1
"undeceivers",1,11,5,6,0
"cicala",1,6,3,3,0
"schechitah",1,10,3,7,0
"unennoblewood",0,13,6,7,0
"syancingwiertiouslynoconpanhase",0,31,12,19,0
"gluciorian",0,10,5,5,0
"lespr",0,5,1,4,0
"subprincipal",1,12,4,8,0
"druptiness",0,10,3,7,0
"emblematised",1,12,5,7,0
"daker",1,5,2,3,0
"bedfjzbu'yk",0,11,2,9,1
"drearful",0,8,3,5,0
"mussal",1,6,2,4,0
"ionospheres",1,11,5,6,0
"loppers",1,7,2,5,0
"therari",0,7,3,4,0
"tegmentum",1,9,3,6,0
"tropomyosins",1,12,4,8,0
"silvertail",1,10,4,6,0
"pathunganaryngometroporolda",0,27,10,17,0
"cymprepint",0,10,2,8,0
"discontipur",0,11,4,7,0
"microcinematography",1,19,7,12,0
"drubber",1,7,2,5,0
"unstead",0,7,3,4,0
"podys",0,5,1,4,0
"exigeante",1,9,5,4,0
"puranic",1,7,3,4,0
"ethercap",1,8,3,5,0
"cer",0,3,1,2,0
"ennstoryl",0,9,2,7,0
"unmetrified",1,11,5,6,0
"qv'",0,3,0,3,1
"chizas",0,6,2,4,0
"edwardmore",0,10,4,6,0
"tughra",1,6,2,4,0
"infiltration",1,12,5,7,0
"hesperidiums",1,12,5,7,0
"bittner",1,7,2,5,0
"unconsurfactivealistial",0,23,10,13,0
"yonita",1,6,3,3,0
"collonotrophyta",0,15,5,10,0
"unpounded",1,9,4,5,0
"basidenestandialis",0,18,8,10,0
"nonreinstatement",1,16,6,10,0
"duchesney",0,9,3,6,0
"yxwob",0,5,1,4,0
"smes",0,4,1,3,0
"knickknacks",1,11,2,9,0
"hawpefewb",0,9,3,6,0
"koipopepignites",0,15,7,8,0
"beekeeper",1,9,5,4,0
"gryllus",1,7,1,6,0
"yhjpjhmbp'o",0,11,1,10,1
"barleysick",1,10,3,7,0
"stoory",1,6,2,4,0
"physicomathematical",1,19,7,12,0
"oat'jeunprtylrl",0,15,4,11,1
"morocco",1,7,3,4,0
"strehens",0,8,2,6,0
"frstracular",0,11,3,8,0
"medisucid",0,9,4,5,0
"hfuqqlawfr'avdbdsucwys",0,22,4,18,1
"karttikeya",1,10,4,6,0
"sbar",0,4,1,3,0
"unassailing",1,11,5,6,0
"chemult",1,7,2,5,0
"extraperiosteorrhaphy",0,21,8,13,0
"flacourth",0,9,3,6,0
"reprievabilities",0,16,8,8,0
"sovenances",1,10,4,6,0
"amalgam",1,7,3,4,0
"pecurg",0,6,2,4,0
"balmacaan",1,9,4,5,0
"slumbitiousness",0,15,6,9,0
"hirticedicalism",0,15,6,9,0
"gastrostomy",1,11,3,8,0
"katogle",1,7,3,4,0
"blendcorn",1,9,2,7,0
"superpossition",1,14,6,8,0
"prelusion",1,9,4,5,0
"astoundingly",1,12,4,8,0
"iambographer",1,12,5,7,0
"thaumatrope",1,11,5,6,0
"mannify",1,7,2,5,0
"britanniculi",0,12,5,7,0
"milldale",1,8,3,5,0
"barpendropola",0,13,5,8,0
"cxkigynk'q'qwg",0,14,1,13,2
"rhamsa",0,6,2,4,0
"tericeingmiongohabbbe",0,21,9,12,0
"huis",1,4,2,2,0
"spitussion",0,10,4,6,0
"payagua",1,7,4,3,0
"loxley",1,6,2,4,0
"pannosely",1,9,3,6,0
"cjsropj'xdvrihgoek'jaebakpf",0,27,7,20,2
"mitern",0,6,2,4,0
"musculospiral",1,13,5,8,0
"stronous",0,8,3,5,0
"chowchow",1,8,2,6,0
"autokoturpeivee",0,15,9,6,0
"prestidigitative",0,16,7,9,0
"dollar",1,6,2,4,0
"myelomenia",1,10,5,5,0
"bgnczctqvpz",0,11,0,11,0
"stoits",1,6,2,4,0
"windemiolloquy",0,14,6,8,0
"chame",0,5,2,3,0
"imluz",0,5,2,3,0
"scarrings",1,9,2,7,0
"homonymy",1,8,2,6,0
"uricosurgically",0,15,6,9,0
"bdifwhwhqev",0,11,2,9,0
"chea",0,4,2,2,0
"acetylenogen",1,12,5,7,0
"opposers",1,8,3,5,0
"calcedonios",1,11,5,6,0
"greenheart",1,10,4,6,0
"yolgoqpmxepcpytobxrahy",0,22,5,17,0
"barbarea",1,8,4,4,0
"vetiveria",1,9,5,4,0
"snabbie",1,7,3,4,0
"lendl",1,5,1,4,0
"syrians",1,7,2,5,0
"nonduciant",0,10,4,6,0
"leasemen",1,8,4,4,0
"phrensities",0,11,4,7,0
"repostclasstophorotund",0,22,7,15,0
"bioelectrotherapies",1,19,9,10,0
"xpagoxnokoabvj",0,14,5,9,0
"outtrick",0,8,3,5,0
"iwound",1,6,3,3,0
"unreachably",1,11,4,7,0
"'nlejwvjhtun",0,12,2,10,1
"fetishist",1,9,3,6,0
"rosellen",1,8,3,5,0
"schizoneura",1,11,5,6,0
"ox'hhlyhmp'jxtdkumn",0,19,2,17,2
"socrates",1,8,3,5,0
"davan",0,5,2,3,0
"jaguarondi",1,10,5,5,0
"demanders",1,9,3,6,0
"breaklet",0,8,3,5,0
"regnancy",1,8,2,6,0
"decoagulabilities",0,17,9,8,0
"sparrers",1,8,2,6,0
"dramnetick",0,10,3,7,0
"kubiak",1,6,3,3,0
"stornians",0,9,3,6,0
"frophall",0,8,2,6,0
"ikeyness",1,8,3,5,0
"polioneuromerism",0,16,8,8,0
"nontransportation",1,17,6,11,0
"scribeship",1,10,3,7,0
"gasfield",1,8,3,5,0
"birostrated",1,11,4,7,0
"amantadine",1,10,5,5,0
"dropflower",0,10,3,7,0
"lzvsnlvdvoy",0,11,1,10,0
"calamopitys",1,11,4,7,0
"jzel",0,4,1,3,0
"slabbinesses",1,12,4,8,0
"aphans",0,6,2,4,0
"strigulaceae",1,12,6,6,0
"tetrator",0,8,3,5,0
"ulasttomn",0,9,3,6,0
"rimola",1,6,3,3,0
"unwieldily",1,10,4,6,0
"belarusan",1,9,4,5,0
"renormality",0,11,4,7,0
"jmttuikyzmareo",0,14,5,9,0
"rehypothecation",1,15,6,9,0
"buddleman",1,9,3,6,0
"proenforced",0,11,4,7,0
"thalidomide",1,11,5,6,0
"nonexhaustible",1,14,6,8,0
"depopulates",1,11,5,6,0
"recertifyings",0,13,4,9,0
"schyt",0,5,0,5,0
"bisquick",1,8,3,5,0
"aucklands",0,9,3,6,0
"polyclone",1,9,3,6,0
"pevaber",0,7,3,4,0
"tarinellowskia",0,14,6,8,0
"bluencephalobectase",0,19,8,11,0
"chery",1,5,1,4,0
"moselesshemerogoi",0,17,8,9,0
"biddery",1,7,2,5,0
"kirtles",1,7,2,5,0
"habitational",1,12,6,6,0
"moistish",1,8,3,5,0
"horrorists",0,10,3,7,0
"adame",0,5,3,2,0
"goodwilies",1,10,5,5,0
"dillage",0,7,3,4,0
"overnalnes",0,10,4,6,0
"nonclingingly",0,13,3,10,0
"dci''hiodhqwfhwpewmypcspzkbfxf",0,30,4,26,2
"lageycubaidntinevadrhenitot",0,27,11,16,0
"franciscanism",1,13,4,9,0
"enton",0,5,2,3,0
"spagirist",1,9,3,6,0
"ariomma",1,7,4,3,0
"sagamen",1,7,3,4,0
"honestete",1,9,4,5,0
"awamaban",0,8,4,4,0
"ekvwkov'rl'odhrpcsn",0,19,3,16,2
"veterrally",0,10,3,7,0
"chiltonsville",0,13,4,9,0
"driers",1,6,2,4,0
"aegesta",1,7,4,3,0
"dantons",1,7,2,5,0
"seaboliefs",0,10,5,5,0
"polspolans",0,10,3,7,0
"'wx",0,3,0,3,1
"ponacosumer",0,11,5,6,0
"coordinator",1,11,5,6,0
"hoomilam",0,8,4,4,0
"jcufdjz'xft",0,11,1,10,1
"chiarezze",1,9,4,5,0
"atalimiotoy",0,11,6,5,0
"dorsoradial",1,11,5,6,0
"ssti",0,4,1,3,0
"eles",0,4,2,2,0
"hypontis",0,8,2,6,0
"ladefilinfuninferotoligragares",0,30,13,17,0
"onelqifvegtjxu",0,14,5,9,0
"subhunry",0,8,2,6,0
"reremith",0,8,3,5,0
"fustinella",1,10,4,6,0
"immured",1,7,3,4,0
"corporative",1,11,5,6,0
"westernly",1,9,2,7,0
"colourbreeds",1,12,5,7,0
"capitaled",1,9,4,5,0
"madrence",0,8,3,5,0
"pyrolysing",1,10,2,8,0
"populators",0,10,4,6,0
"infanticides",1,12,5,7,0
"reshowering",1,11,4,7,0
"duodedenums",1,11,5,6,0
"ceroid",1,6,3,3,0
"isxlvggq'c'henchym'oozuf",0,24,5,19,3
"qo",0,2,1,1,0
"customhouses",1,12,5,7,0
"fyhh",0,4,0,4,0
"occiologists",0,12,5,7,0
"taseometer",1,10,5,5,0
"pandemia",1,8,4,4,0
"revamps",1,7,2,5,0
"petrialenesis",0,13,6,7,0
"cous",0,4,2,2,0
"llivaleskbala",0,13,5,8,0
"zillionid",0,9,4,5,0
"spadify",0,7,2,5,0
"hoppy",1,5,1,4,0
"iomyi",0,5,3,2,0
"ticogis",0,7,3,4,0
"dowed",1,5,2,3,0
"prinsburg",1,9,2,7,0
"extrade",0,7,3,4,0
"gemony",1,6,2,4,0
"babirajazonisevol",0,17,8,9,0
"poortith",1,8,3,5,0
"jggbn",0,5,0,5,0
"dentification",1,13,6,7,0
"awkh'xujix",0,10,3,7,1
"nonpossed",0,9,3,6,0
"wonderlands",1,11,3,8,0
"sloyd",1,5,1,4,0
"antiasis",0,8,4,4,0
"prejepupplia",0,12,5,7,0
"gzofwlylabllvzrtxefswj",0,22,3,19,0
"mekhitarist",1,11,4,7,0
"susanoo",1,7,4,3,0
"lipopoda",1,8,4,4,0
"anderbromeda",0,12,5,7,0
"loing",0,5,2,3,0
"underperforming",1,15,5,10,0
"thorn",1,5,1,4,0
"mirably",0,7,2,5,0
"benzonine",0,9,4,5,0
"foulmart",1,8,3,5,0
"vomitelogishantra",0,17,7,10,0
"cahoneycomb",0,11,4,7,0
"apologic",0,8,4,4,0
"stopblock",1,9,2,7,0
"xvfkqjkmcvwwrhyumjivqudr",0,24,3,21,0
"eumostended",0,11,5,6,0
"conias",1,6,3,3,0
"unfrighted",1,10,3,7,0
"cereuphonia",0,11,6,5,0
"disinflations",1,13,5,8,0
"definificalness",0,15,6,9,0
"produced",1,8,3,5,0
"feisty",1,6,2,4,0
"isometrograph",1,13,5,8,0
"lavanine",0,8,4,4,0
"pimingles",0,9,3,6,0
"proximateness",1,13,5,8,0
"'qcgegtfawhjte",0,14,3,11,1
"cyndy",1,5,0,5,0
"yakow",1,5,2,3,0
"nemathelminthias",0,16,6,10,0
"identifier",1,10,5,5,0
"xqdsmnaunxfkloowikj'",0,20,5,15,1
"ples",0,4,1,3,0
"opet",0,4,2,2,0
"mercourtrahents",0,15,5,10,0
"accessivens",0,11,4,7,0
"frouncing",1,9,3,6,0
"hikgvkvyaiajhw'",0,15,4,11,1
"echolocate",1,10,5,5,0
"gilisation",0,10,5,5,0
"perpent",1,7,2,5,0
"cus",0,3,1,2,0
"ouydxmsg'ecubcigec",0,18,6,12,1
"wcs",1,3,0,3,0
"ewkymxuzgeodxxsv'dqdv",0,21,4,17,1
"dioberiwmjn",0,11,4,7,0
"pharynx",1,7,1,6,0
"perdita",1,7,3,4,0
"whasle",1,6,2,4,0
"wlcvfxrmlslfcvpifsyqddqbljv",0,27,1,26,0
"oizys",1,5,2,3,0
"beballed",1,8,3,5,0
"aspewindemanasadordiateepigfluorehekt",0,37,17,20,0
"ingurgitates",1,12,5,7,0
"oeg",0,3,2,1,0
"rectuated",0,9,4,5,0
"scaldberries",1,12,4,8,0
"hodophobia",1,10,5,5,0
"pseudochylous",1,13,5,8,0
"urr",0,3,1,2,0
"kceihupb",0,8,3,5,0
"mesosomatidae",0,13,7,6,0
"tqejitzumdrba",0,13,4,9,0
"polygenically",1,13,4,9,0
"mu'ofugdx",0,9,3,6,1
"ydrdwwrtdkfjitnrrwtv",0,20,1,19,0
"bonfire",1,7,3,4,0
"i'dw",0,4,1,3,1
"hillocks",1,8,2,6,0
"desktop",1,7,2,5,0
"sibylesque",1,10,4,6,0
"thrombidiidae",0,13,6,7,0
"outserving",0,10,4,6,0
"idious",0,6,4,2,0
"nonmanifestly",1,13,4,9,0
"perrier",1,7,3,4,0
"nondistracting",1,14,4,10,0
"supercautical",0,13,6,7,0
"bemuses",1,7,3,4,0
"tivepamimatllbchuiph",0,20,7,13,0
"hyalinosis",1,10,4,6,0
"bogbeaner",0,9,4,5,0
"deprian",0,7,3,4,0
"profile",1,7,3,4,0
"suithold",1,8,3,5,0
"jellyrolls",1,10,2,8,0
"whitlamp",0,8,2,6,0
"znij",0,4,1,3,0
"oreron",0,6,3,3,0
"anecdysis",1,9,3,6,0
"rionetrantroconsemangspeted",0,27,10,17,0
"naethiodamas",0,12,6,6,0
"slipstreamware",0,14,5,9,0
"kylie",1,5,2,3,0
"perk",1,4,1,3,0
"docks",1,5,1,4,0
"tealery",1,7,3,4,0
"f''djavlapw",0,11,2,9,2
"torrence",1,8,3,5,0
"jmdohjbo",0,8,2,6,0
"scologist",0,9,3,6,0
"galauxorteachallarlsoven",0,24,10,14,0
"mmarcomstvopms",0,14,3,11,0
"inone",1,5,3,2,0
"butinthrasseudoppys",0,19,6,13,0
"partonectronoist",0,16,6,10,0
"katholikos",1,10,4,6,0
"lakelike",1,8,4,4,0
"uncials",1,7,3,4,0
"pommelion",1,9,4,5,0
"gastarka",0,8,3,5,0
"cumarin",1,7,3,4,0
"propertyship",1,12,3,9,0
"tripsychos",0,10,2,8,0
"ambo",1,4,2,2,0
"octapody",1,8,3,5,0
"ingloriousnesses",1,16,7,9,0
"horsehair",1,9,4,5,0
"skencotorthalultrav",0,19,6,13,0
"sphite",0,6,2,4,0
"tassie",1,6,3,3,0
"bespermandriatedalists",0,22,8,14,0
"falkland",1,8,2,6,0
"unprovocativeness",1,17,7,10,0
"fucoideae",1,9,6,3,0
"isagogically",1,12,5,7,0
"underpopular",0,12,5,7,0
"sonablenesses",0,13,5,8,0
"toitonil",0,8,4,4,0
"vampleurassiner",0,15,6,9,0
"catenane",1,8,4,4,0
"burdens",1,7,2,5,0
"tcexbqzyd'f'hpleamnotr'cahrerp",0,30,6,24,3
"repulser",1,8,3,5,0
"viscometrically",1,15,5,10,0
"stockpilers",1,11,3,8,0
"quixotic",1,8,4,4,0
"zfkflruamb",0,10,2,8,0
"antirabilities",0,14,7,7,0
"proteosaurid",1,12,6,6,0
"badger",1,6,2,4,0
"wiese",1,5,3,2,0
"rcfopuyjykuburqhivn",0,19,5,14,0
"decuria",1,7,4,3,0
"amoebidae",1,9,6,3,0
"cle",0,3,1,2,0
"felettedincaerpond",0,18,7,11,0
"dh",0,2,0,2,0
"overswatchier",0,13,5,8,0
"clavolae",1,8,4,4,0
"minigardens",1,11,4,7,0
"benignness",1,10,3,7,0
"elisabetta",1,10,5,5,0
"huisheckpoine",0,13,6,7,0
"crily",0,5,1,4,0
"migeon",1,6,3,3,0
"superfortaine",0,13,6,7,0
"sanfood",0,7,3,4,0
"mooress",1,7,3,4,0
"transubstantialist",0,18,6,12,0
"pixiness",1,8,3,5,0
"eusol",1,5,3,2,0
"rpakvenwbxnorixtvyvzpipnhwqoq",0,29,6,23,0
"flarer",1,6,2,4,0
"fragmentariness",1,15,5,10,0
"usuriousness",1,12,6,6,0
"hypochondra",0,11,3,8,0
"arotcll",0,7,2,5,0
"tumult",1,6,2,4,0
"semipectologies",0,15,7,8,0
"snomies",0,7,3,4,0
"xb'uwbgbvwbrqpuid",0,17,3,14,1
"bernoulli",1,9,4,5,0
"meddler",1,7,2,5,0
"nonvibrating",1,12,4,8,0
"noum",0,4,2,2,0
"cnidosporidia",1,13,6,7,0
"troutflower",1,11,4,7,0
"cysted",1,6,1,5,0
"cerebels",0,8,3,5,0
"russophobist",1,12,4,8,0
"tradescantist",0,13,4,9,0
"unwic",0,5,2,3,0
"kirths",0,6,1,5,0
"stultification",1,14,6,8,0
"recounter",1,9,4,5,0
"pyrotritaric",1,12,4,8,0
"protostar",1,9,3,6,0
"subsidiser",1,10,4,6,0
"ganchaming",0,10,3,7,0
"ffrnnu'ehpmt",0,12,2,10,1
"archaicisms",1,11,4,7,0
"unrevolting",1,11,4,7,0
"bugging",1,7,2,5,0
"slederback",0,10,3,7,0
"acicrulcos",0,10,4,6,0
"shouldery",0,9,3,6,0
"crashlenbrakiehl",0,16,5,11,0
"nurselet",1,8,3,5,0
"guglet",1,6,2,4,0
"inunctuosity",1,12,5,7,0
"lcujl'vriy",0,10,2,8,1
"preobjectivally",0,15,5,10,0
"overtrample",1,11,4,7,0
"boatic",0,6,3,3,0
"gadsmen",1,7,2,5,0
"intertextual",1,12,5,7,0
"doblin",1,6,2,4,0
"nuchemantifule",0,14,6,8,0
"subprefectorial",1,15,6,9,0
"canilate",0,8,4,4,0
"sulphonephthalein",1,17,6,11,0
"concheas",0,8,3,5,0
"chroscorps",0,10,2,8,0
"oxyphenol",1,9,3,6,0
"dudi",0,4,2,2,0
"luisa",1,5,3,2,0
"backfish",0,8,2,6,0
"huichial",0,8,4,4,0
"flutters",1,8,2,6,0
"macdermanisiness",0,16,6,10,0
"ghrgdudbih",0,10,2,8,0
"cayuses",1,7,3,4,0
"casstown",1,8,2,6,0
"chord",1,5,1,4,0
"culunpularchme",0,14,5,9,0
"gilberte",1,8,3,5,0
"pirome",0,6,3,3,0
"ierna",1,5,3,2,0
"odologies",0,9,5,4,0
"warheaturessnesi",0,16,7,9,0
"triloculate",1,11,5,6,0
"cogenerator",1,11,5,6,0
"hu'hdrljng",0,10,1,9,1
"lissotrichan",1,12,4,8,0
"concordance",1,11,4,7,0
"piselli",1,7,3,4,0
"paraxially",1,10,4,6,0
"evoluntling",0,11,4,7,0
"staria",0,6,3,3,0
"apophthegmatises",1,16,6,10,0
"pindjajap",1,9,3,6,0
"u'oyinraqi",0,10,5,5,1
"omoraran",0,8,4,4,0
"staging",1,7,2,5,0
"valetudinously",0,14,6,8,0
"monadology",1,10,4,6,0
"prediscontentedness",0,19,6,13,0
"skeeling",1,8,3,5,0
"jhelum",1,6,2,4,0
"hagwesiris",0,10,4,6,0
"xofpmyzlrrxgszozpvcmep",0,22,3,19,0
"sublet",1,6,2,4,0
"baudrillard",1,11,4,7,0
"bombarongara",0,12,5,7,0
"catechumenship",1,14,5,9,0
"turbarkermentalness",0,19,6,13,0
"demonstrandwolves",0,17,5,12,0
"lecithin",1,8,3,5,0
"blackguardism",1,13,4,9,0
"rouens",1,6,3,3,0
"norilitiser",0,11,5,6,0
"untidy",1,6,2,4,0
"scruplesomenesses",0,17,6,11,0
"seaned",1,6,3,3,0
"sanelmobies",0,11,5,6,0
"ungracefulness",1,14,5,9,0
"meliorations",1,12,6,6,0
"compassings",1,11,3,8,0
"parles",1,6,2,4,0
"grundified",1,10,4,6,0
"rafordo",0,7,3,4,0
"womanishness",1,12,4,8,0
"photochloridic",0,14,5,9,0
"discommissioning",1,16,6,10,0
"modular",1,7,3,4,0
"evenger",0,7,3,4,0
"parmailpot",0,10,4,6,0
"crenelley",0,9,3,6,0
"montrony",0,8,2,6,0
"ndivenoly",0,9,3,6,0
"gvxirlbhsjegrmozcbilhxj",0,23,4,19,0
"nomocracy",1,9,3,6,0
"ragasericto",0,11,5,6,0
"arnifte",0,7,3,4,0
"unardious",0,9,5,4,0
"patchockes",1,10,3,7,0
"asbury",1,6,2,4,0
"lafferty",1,8,2,6,0
"degradualities",0,14,7,7,0
"floced",0,6,2,4,0
"occupy",1,6,2,4,0
"thrialinch",0,10,3,7,0
"midian",1,6,3,3,0
"pamphleteerings",1,15,5,10,0
"hicha",0,5,2,3,0
"overgence",0,9,4,5,0
"dugedfgsswostvf",0,15,3,12,0
"biphenylmethyl",0,14,3,11,0
"overbranchiser",0,14,5,9,0
"chestiness",1,10,3,7,0
"ecdyseismatis",0,13,5,8,0
"pyrinatings",0,11,3,8,0
"qulun",0,5,2,3,0
"rechisel",1,8,3,5,0
"maxillary",1,9,3,6,0
"scituate",1,8,4,4,0
"ceweings",0,8,3,5,0
"tffinglounulies",0,15,6,9,0
"lary",0,4,1,3,0
"hyperminisheriopathi",0,20,8,12,0
"anhunt",0,6,2,4,0
"prettermoist",0,12,4,8,0
"grestickil",0,10,3,7,0
"pyroclastics",1,12,3,9,0
"rebrick",1,7,2,5,0
"gmieualanaoganalizingedantyliala",0,32,16,16,0
"inardin",0,7,3,4,0
"noncongruency",1,13,4,9,0
"stethoscope",1,11,4,7,0
"angiocarbonemerger",0,18,8,10,0
"moracl",0,6,2,4,0
"uleshe",0,6,3,3,0
"millenia",1,8,4,4,0
"vidanch",0,7,2,5,0
"salicornia",1,10,5,5,0
"dishevel",1,8,3,5,0
"blephantomicroquefortuitoist",0,28,12,16,0
"toscafo",0,7,3,4,0
"reconomicropuses",0,16,7,9,0
"eventides",1,9,4,5,0
"guadelouper",0,11,6,5,0
"front",1,5,1,4,0
"crabb",1,5,1,4,0
"calikops",0,8,3,5,0
"keed",0,4,2,2,0
"superspective",0,13,5,8,0
"avarish",1,7,3,4,0
"imourcubontuatruryullicr",0,24,10,14,0
"palmerycia",0,10,4,6,0
"und",0,3,1,2,0
"anchants",0,8,2,6,0
"allantoidal",1,11,5,6,0
"monegasques",1,11,5,6,0
"mocuddums",1,9,3,6,0
"megallethads",0,12,4,8,0
"annunciating",1,12,5,7,0
"fuflelgcle'fvdxilbct",0,20,4,16,1
"portliest",1,9,3,6,0
"paties",0,6,3,3,0
"unexhibitableness",1,17,7,10,0
"nonimperenchmeling",0,18,6,12,0
"bithikhoneltaacatisstuelighess",0,30,12,18,0
"cosine",1,6,3,3,0
"kiddushes",1,9,3,6,0
"mulhationaryngelltrabaloant",0,27,10,17,0
"pantarbe",1,8,3,5,0
"edeologic",0,9,5,4,0
"inapostate",1,10,5,5,0
"knobel",1,6,2,4,0
"unasteries",0,10,5,5,0
"galenism",1,8,3,5,0
"braided",1,7,3,4,0
"quy",0,3,1,2,0
"paracenical",0,11,5,6,0
"chatly",0,6,1,5,0
"leucocytozoarialgia",0,19,10,9,0
"subiaco",1,7,4,3,0
"hexadd",1,6,2,4,0
"rtetrafoterinate",0,16,7,9,0
"unfardle",1,8,3,5,0
"bogan",1,5,2,3,0
"siffleuse",1,9,4,5,0
"o'donoghue",1,10,5,5,1
"pimply",1,6,1,5,0
"deverbatives",1,12,5,7,0
"interpleadedness",0,16,6,10,0
"metailogilatts",0,14,6,8,0
"salbu",1,5,2,3,0
"nursemibasitopausian",0,20,10,10,0
"vertebrochondral",1,16,5,11,0
"adenose",1,7,4,3,0
"muckhole",1,8,3,5,0
"beeriest",1,8,4,4,0
"coelestial",1,10,5,5,0
"wanpigerooganity",0,16,7,9,0
"bucarilocults",0,13,5,8,0
"accreted",1,8,3,5,0
"afterweb",0,8,3,5,0
"fuckamporachmanism",0,18,6,12,0
"coarchisoriness",0,15,6,9,0
"montages",1,8,3,5,0
"qantar",1,6,2,4,0
"noncompensation",1,15,6,9,0
"cutpurses",1,9,3,6,0
"intasilevskymowries",0,19,7,12,0
"arbut",0,5,2,3,0
"ethelin",1,7,3,4,0
"antecedent",1,10,4,6,0
"belem",1,5,2,3,0
"d'vkgtnvdfsvza",0,14,1,13,1
"okome",0,5,3,2,0
"snapshootee",0,11,5,6,0
"imd",1,3,1,2,0
"totalitizer",1,11,5,6,0
"shagging",1,8,2,6,0
"zoopantheon",1,11,5,6,0
"transkei",1,8,3,5,0
"isodomising",0,11,5,6,0
"agraga",1,6,3,3,0
"otjb'etpoqeynq",0,14,4,10,1
"wysjlyyvsjsiisthyvtefgfk",0,24,3,21,0
"z'gbmhanqrr'gqjxhpydhiaxl",0,25,3,22,2
"megaplex",1,8,3,5,0
"qdqz",0,4,0,4,0
"laypeople",1,9,4,5,0
"aylykxkspnec'qq",0,15,2,13,1
"evocations",1,10,5,5,0
"skyjackers",1,10,2,8,0
"hypoplanktonic",1,14,4,10,0
"recordicinae",0,12,6,6,0
"uatpjthmhavqq",0,13,3,10,0
"reinfilternations",0,17,7,10,0
"jequille",0,8,4,4,0
"dolphinets",1,10,3,7,0
"cosmosis",0,8,3,5,0
"busti",1,5,2,3,0
"udo'pcpxwoxnniianzgkpmi",0,23,7,16,1
"abscissions",1,11,4,7,0
"unipoes",0,7,4,3,0
"gops",0,4,1,3,0
"dupo",1,4,2,2,0
"leptonninframist",0,16,5,11,0
"spinnel",1,7,2,5,0
"phalacrosis",1,11,4,7,0
"amphioxide",0,10,5,5,0
"fadaticinetic",0,13,6,7,0
"marous",0,6,3,3,0
"subumbiliform",0,13,5,8,0
"waiinae",0,7,5,2,0
"blespuridamitummak",0,18,7,11,0
"obares",0,6,3,3,0
"tialines",0,8,4,4,0
"disponsolatry",0,13,4,9,0
"propagandist",1,12,4,8,0
"garberries",0,10,4,6,0
"reposses",0,8,3,5,0
"tranchmen",0,9,2,7,0
"quartersaws",1,11,4,7,0
"hwelon",1,6,2,4,0
"underable",0,9,4,5,0
"loculating",0,10,4,6,0
"icassiorutorond",0,15,7,8,0
"cotillions",1,10,4,6,0
"fluellin",1,8,3,5,0
"unstylishly",1,11,2,9,0
"spond",0,5,1,4,0
"temping",1,7,2,5,0
"steatopygium",0,12,5,7,0
"uriatrominbiographinniness",0,26,11,15,0
"cementums",1,9,3,6,0
"puncheon",1,8,3,5,0
"spaerobee",1,9,5,4,0
"archarentundies",0,15,6,9,0
"muskmelon",1,9,3,6,0
"fretten",1,7,2,5,0
"artlogy",0,7,2,5,0
"antidor",0,7,3,4,0
"lactucol",1,8,3,5,0
"'u'mbzuwvxluyczjscdolil",0,23,5,18,2
"thianisms",0,9,3,6,0
"louvale",1,7,4,3,0
"steganographic",1,14,5,9,0
"delike",0,6,3,3,0
"scruncler",0,9,2,7,0
"'memkz'cut'irsf'zuiaenx'",0,24,7,17,5
"hostlership",1,11,3,8,0
"thretivadia",0,11,5,6,0
"qjtgoqcdkfxnumfxulegtrykghtqyv",0,30,4,26,0
"gunation",1,8,4,4,0
"cardinalates",1,12,5,7,0
"coronomy",0,8,3,5,0
"bemuddle",1,8,3,5,0
"supermajority",1,13,5,8,0
"zmh'kt",0,6,0,6,1
"sedalia",1,7,4,3,0
"gregariniform",1,13,5,8,0
"abarweicaalcy",0,13,6,7,0
"unirradius",0,10,5,5,0
"subabbots",1,9,3,6,0
"undampable",1,10,4,6,0
"triazole",1,8,4,4,0
"kalites",0,7,3,4,0
"debites",0,7,3,4,0
"overorganify",0,12,5,7,0
"jackdated",0,9,3,6,0
"priveenenerng",0,13,5,8,0
"lcfl'ghkc",0,9,0,9,1
"rockandroll",1,11,3,8,0
"minaturgenicoaguentia",0,21,11,10,0
"colocation",0,10,5,5,0
"mhkncmltczobzwwxsgvr",0,20,1,19,0
"ghette",0,6,2,4,0
"ejkrnmgdgattgzvdals",0,19,3,16,0
"wheatgrowingness",0,16,5,11,0
"excerptions",1,11,4,7,0
"lbhsznhokalx",0,12,2,10,0
"teats",1,5,2,3,0
"cutlassfish",1,11,3,8,0
"cryptobatholite",0,15,5,10,0
"ventrally",1,9,2,7,0
"surjectively",0,12,4,8,0
"hypnales",0,8,2,6,0
"peribranchial",1,13,5,8,0
"overrighteous",1,13,6,7,0
"alberta",1,7,3,4,0
"maynord",1,7,2,5,0
"galimed",0,7,3,4,0
"nonicism",0,8,3,5,0
"tclifvyjrcmf",0,12,1,11,0
"cottian",0,7,3,4,0
"overestimation",1,14,7,7,0
"berrs",0,5,1,4,0
"assailments",1,11,4,7,0
"oldous",0,6,3,3,0
"kbpppmwghnl",0,11,0,11,0
"enelouabntflla",0,14,6,8,0
"pulourtfoolhygen",0,16,6,10,0
"fundraised",1,10,4,6,0
"tth",0,3,0,3,0
"shopwindows",1,11,3,8,0
"imwcfjkw'mjbnigutw",0,18,3,15,1
"woecxwaajea",0,11,6,5,0
"dorkus",1,6,2,4,0
"panmelodion",1,11,5,6,0
"erythmite",0,9,3,6,0
"eredueius",0,9,6,3,0
"higden",1,6,2,4,0
"tongngggs",0,9,1,8,0
"inwrapophlebifer",0,16,6,10,0
"synoecising",1,11,4,7,0
"undertaxed",1,10,4,6,0
"obsessed",1,8,3,5,0
"jlmxqseoiz",0,10,3,7,0
"cacorrhachis",1,12,4,8,0
"montal",0,6,2,4,0
"areca",1,5,3,2,0
"savonbugobracadorfeity",0,22,9,13,0
"retic",0,5,2,3,0
"rgocmoy'larkropcus",0,18,5,13,1
"peenwin",0,7,3,4,0
"thonfllenrossknfeopis",0,21,6,15,0
"denegations",1,11,5,6,0
"splairged",0,9,3,6,0
"thessuance",0,10,4,6,0
"erytheis",1,8,3,5,0
"caldaria",1,8,4,4,0
"horologian",0,10,5,5,0
"rodrique",1,8,4,4,0
"honeren",0,7,3,4,0
"pharmacognosy",1,13,4,9,0
"sallow",1,6,2,4,0
"dovekey",1,7,3,4,0
"enzamburgoney",0,13,5,8,0
"lintimeros",0,10,4,6,0
"anodine",1,7,4,3,0
"catalogice",0,10,5,5,0
"onen",0,4,2,2,0
"pauseless",1,9,4,5,0
"cetraria",1,8,4,4,0
"li'lyyyieipy'",0,13,4,9,2
"rutledge",1,8,3,5,0
"boomen",0,6,3,3,0
"horterstrata",0,12,4,8,0
"bookies",1,7,4,3,0
"aderwauke",0,9,5,4,0
"fingernails",1,11,4,7,0
"daraeo",1,6,4,2,0
"theologise",1,10,5,5,0
"legpull",1,7,2,5,0
"agalfoacitas",0,12,6,6,0
"inthralment",1,11,3,8,0
"villotcaking",0,12,4,8,0
"leesg",0,5,2,3,0
"rlphnjvoi'kjewy",0,15,3,12,1
"nadapt",0,6,2,4,0
"vvbxe",0,5,1,4,0
"hexanitrodiphenylamine",1,22,9,13,0
"galachist",0,9,3,6,0
"astacia",0,7,4,3,0
"mautioutogia",0,12,8,4,0
"romantic",1,8,3,5,0
"broomfield",1,10,4,6,0
"clarksville",1,11,3,8,0
"uranology",1,9,4,5,0
"posse",1,5,2,3,0
"uncate",0,6,3,3,0
"micromanagements",1,16,6,10,0
"carnahuba",1,9,4,5,0
"cmu",1,3,1,2,0
"interdealt",1,10,4,6,0
"kannah",0,6,2,4,0
"halfpennial",0,11,4,7,0
"dreamontmospeaker",0,17,7,10,0
"loisgulnes",0,10,4,6,0
"unmortgaged",1,11,4,7,0
"sniooemug",0,9,5,4,0
"achenes",1,7,3,4,0
"keywd",1,5,1,4,0
"miscomprehensions",1,17,6,11,0
"wtranteranophurmphiuimiais",0,26,11,15,0
"absenteeism",1,11,5,6,0
"vexcxxmjwgrwrkiq",0,16,2,14,0
"transsensually",1,14,4,10,0
"pedanticness",1,12,4,8,0
"dampere",0,7,3,4,0
"karstify",1,8,2,6,0
"gqm",0,3,0,3,0
"caseminute",0,10,5,5,0
"rodster",1,7,2,5,0
"witillb",0,7,2,5,0
"precurse",1,8,3,5,0
"telnuts",0,7,2,5,0
"vertrocktorgufraicah",0,20,7,13,0
"ulleorthise",0,11,5,6,0
"bansela",1,7,3,4,0
"pulloc",0,6,2,4,0
"shroousiana",0,11,6,5,0
"kroovermalah",0,12,5,7,0
"retrollekeepersecreticise",0,25,11,14,0
"unstoned",1,8,3,5,0
"griminess",1,9,3,6,0
"vaumur",0,6,3,3,0
"baltificationeche",0,17,8,9,0
"northington",1,11,3,8,0
"mard",0,4,1,3,0
"ookinesses",0,10,5,5,0
"htomqpadfxncoxoojvivjcbkq",0,25,6,19,0
"sheol",1,5,2,3,0
"srrawrwqqnrnqciycpzrkyk",0,23,2,21,0
"malleability",1,12,5,7,0
"mscqotzbpefnchkaqdeklhpx",0,24,4,20,0
"slickness",1,9,2,7,0
"jfddc'mq",0,8,0,8,1
"collivio",0,8,4,4,0
"stracialesgus",0,13,5,8,0
"galipine",1,8,4,4,0
"chasmananars",0,12,4,8,0
"mfb",1,3,0,3,0
"swtmsh'hvdvfrpigznj",0,19,1,18,1
"ctes",0,4,1,3,0
"argentone",0,9,4,5,0
"flora",1,5,2,3,0
"vice",1,4,2,2,0
"emprise",1,7,3,4,0
"lyyciyg",0,7,1,6,0
"whittlings",1,10,2,8,0
"stilette",0,8,3,5,0
"intwists",1,8,2,6,0
"heeder",1,6,3,3,0
"transposed",1,10,3,7,0
"degentilize",1,11,5,6,0
"coccosteidae",1,12,6,6,0
"ntaprinouleris",0,14,6,8,0
"phore",0,5,2,3,0
"pseudocritically",1,16,6,10,0
"'gkmahf'",0,8,1,7,2
"shellessness",0,12,3,9,0
"flufouyul",0,9,4,5,0
"garnerurg",0,9,3,6,0
"nondeformation",1,14,6,8,0
"oticoding",0,9,4,5,0
"saccharification",1,16,7,9,0
"candleshrift",1,12,3,9,0
"ujbszdfhxmxb",0,12,1,11,0
"desynonymization",1,16,6,10,0
"caky",1,4,1,3,0
"squeamish",1,9,4,5,0
"reimaginaceae",0,13,8,5,0
"ambimedliles",0,12,5,7,0
"wazinednessipere",0,16,7,9,0
"inguinappeased",0,14,7,7,0
"ponammenmaings",0,14,5,9,0
"orator",1,6,3,3,0
"commonsensibly",1,14,4,10,0
"evlovci",0,7,3,4,0
"crite",0,5,2,3,0
"daetoaccal",0,10,5,5,0
"nondecorating",0,13,5,8,0
"hiamata",0,7,4,3,0
"etrcqec'uasctdqmcp",0,18,4,14,1
"doomsday",1,8,3,5,0
"nonmenacing",1,11,4,7,0
"nonheimer",0,9,4,5,0
"hrwfzcfibcj",0,11,1,10,0
"desulfurised",1,12,5,7,0
"ballutes",1,8,3,5,0
"indignly",1,8,2,6,0
"porindrinrd",0,11,3,8,0
"purt",0,4,1,3,0
"excantation",1,11,5,6,0
"interlopers",1,11,4,7,0
"knopf",1,5,1,4,0
"platemaking",1,11,4,7,0
"jtlnaxajhgfwdxjsuzqdkuiakgd'",0,28,6,22,1
"hornlets",1,8,2,6,0
"tg'iavhjkbavon",0,14,4,10,1
"bontebok",1,8,3,5,0
"antimasquerade",1,14,7,7,0
"mailcoach",1,9,4,5,0
"runds",1,5,1,4,0
"afeard",1,6,3,3,0
"kallikrein",1,10,4,6,0
"depotentiate",1,12,6,6,0
"openoffice",1,10,5,5,0
"agloss",0,6,2,4,0
"ploid",0,5,2,3,0
"asur",1,4,2,2,0
"noneugenical",1,12,6,6,0
"stanyel",1,7,2,5,0
"raggy",1,5,1,4,0
"hemilenectivenenethyryer",0,24,9,15,0
"isenanoumenglethins",0,19,8,11,0
"salvableness",0,12,4,8,0
"calochorda",0,10,4,6,0
"armw",0,4,1,3,0
"actinon",1,7,3,4,0
"acrogen",1,7,3,4,0
"zymologic",1,9,3,6,0
"swooperant",0,10,4,6,0
"tanglingly",1,10,2,8,0
"caskful",1,7,2,5,0
"hotatoninembows",0,15,6,9,0
"miana",0,5,3,2,0
"carloid",0,7,3,4,0
"kassite",1,7,3,4,0
"setcla",0,6,2,4,0
"scauperinsisteridas",0,19,8,11,0
"nephelium",1,9,4,5,0
"traducianist",1,12,5,7,0
"bzbzomnkvuy",0,11,2,9,0
"endopodin",0,9,4,5,0
"breth",1,5,1,4,0
"vasoepididymostomy",1,18,7,11,0
"nonsenity",0,9,3,6,0
"poirer",1,6,3,3,0
"unia",0,4,3,1,0
"bitcoin",1,7,3,4,0
"vowelish",1,8,3,5,0
"flannelgraph",1,12,3,9,0
"preflorice",0,10,4,6,0
"pko",0,3,1,2,0
"callance",0,8,3,5,0
"stonecrosis",0,11,4,7,0
"undistrustless",0,14,4,10,0
"sansovino",1,9,4,5,0
"hakam",1,5,2,3,0
"venepunctulated",0,15,6,9,0
"rathoric",0,8,3,5,0
"lungan",1,6,2,4,0
"microgantly",0,11,3,8,0
"inenubi",0,7,4,3,0
"arilling",0,8,3,5,0
"tatisation",0,10,5,5,0
"covicleasory",0,12,5,7,0
"lutecium",1,8,4,4,0
"spurium",0,7,3,4,0
"harquebusier",1,12,6,6,0
"ovaliqueldecalluleimphosubrohys",0,31,13,18,0
"defatting",1,9,3,6,0
"housnopercherant",0,16,6,10,0
"cockney",1,7,2,5,0
"disruptersquamanling",0,20,7,13,0
"botaniser",1,9,4,5,0
"stody",0,5,1,4,0
"ulbitism",0,8,3,5,0
"wanlly",0,6,1,5,0
"anapodeictic",1,12,6,6,0
"hydroquinol",1,11,4,7,0
"hyperglorious",0,13,5,8,0
"multilingually",1,14,5,9,0
"correna",1,7,3,4,0
"precalosalistineled",0,19,8,11,0
"incons",0,6,2,4,0
"nqupnun",0,7,2,5,0
"archaris",0,8,3,5,0
"auamprecogoendifunss",0,20,9,11,0
"crimp",1,5,1,4,0
"girardo",1,7,3,4,0
"bjhnswssizcvworsfqv",0,19,2,17,0
"bqtujartuy",0,10,3,7,0
"homontevahlis",0,13,5,8,0
"ovids",0,5,2,3,0
"umbellule",1,9,4,5,0
"recemvirgiate",0,13,6,7,0
"disorderedness",1,14,5,9,0
"ison",0,4,2,2,0
"wrfsinfwbxwkwn",0,14,1,13,0
"tombac",1,6,2,4,0
"whanging",1,8,2,6,0
"friendsville",1,12,4,8,0
"ngrairceacrequetes",0,18,8,10,0
"idolatrously",1,12,5,7,0
"scheinencalfleshabites",0,22,8,14,0
"tassets",1,7,2,5,0
"postmedullary",1,13,4,9,0
"ghia",0,4,2,2,0
"merseyside",1,10,4,6,0
"indexlessness",1,13,4,9,0
"carcar",0,6,2,4,0
"inobediences",1,12,6,6,0
"ataxophemia",1,11,6,5,0
"chorologer",0,10,4,6,0
"compud",0,6,2,4,0
"unintermixture",0,14,6,8,0
"multiperforated",1,15,6,9,0
"iolcanglas",0,10,4,6,0
"hnkemgl",0,7,1,6,0
"cappyrandratassels",0,18,5,13,0
"steelmaking",1,11,4,7,0
"diddles",1,7,2,5,0
"silverpeak",1,10,4,6,0
"deigawpubicent",0,14,6,8,0
"gilroy",1,6,2,4,0
"delightfully",1,12,3,9,0
"chopboat",1,8,3,5,0
"garnett",1,7,2,5,0
"midysrlnqxyii",0,13,3,10,0
"vatedly",0,7,2,5,0
"minitimouted",0,12,6,6,0
"scotlandwards",1,13,3,10,0
"shas",0,4,1,3,0
"grindery",1,8,2,6,0
"idykw",0,5,1,4,0
"ninjas",1,6,2,4,0
"hebeany",0,7,3,4,0
"achussecare",0,11,5,6,0
"svuzxgtrssf",0,11,1,10,0
"reinnervations",1,14,6,8,0
"aramayoite",1,10,6,4,0
"divellication",0,13,6,7,0
"scarphs",1,7,1,6,0
"turbogenerate",0,13,6,7,0
"nimrod",1,6,2,4,0
"souglacomald",0,12,5,7,0
"flvesty",0,7,1,6,0
"renterochronological",0,20,8,12,0
"pinkiness",1,9,3,6,0
"trisulc",1,7,2,5,0
"rectille",0,8,3,5,0
"edwardianism",0,12,5,7,0
"chrisrooted",0,11,4,7,0
"johnsonians",1,11,4,7,0
"sebundies",1,9,4,5,0
"drudge",1,6,2,4,0
"rubblies",0,8,3,5,0
"tabularisations",1,15,7,8,0
"resonthexhan",0,12,4,8,0
"retransmited",1,12,4,8,0
"gelidiaceae",1,11,7,4,0
"watton",1,6,2,4,0
"chroes",0,6,2,4,0
"pgastablexor",0,12,4,8,0
"proxalist",0,9,3,6,0
"estheduschr",0,11,3,8,0
"typhic",1,6,1,5,0
"brtebrontrdenowocead",0,20,7,13,0
"microvilli",1,10,4,6,0
"coistrel",1,8,3,5,0
"cliteros",0,8,3,5,0
"iodoso",1,6,4,2,0
"assiniboine",1,11,6,5,0
"ullswater",1,9,3,6,0
"unblanketed",1,11,4,7,0
"landau",1,6,3,3,0
"dendrites",1,9,3,6,0
"mannah",0,6,2,4,0
"putaxlesceners",0,14,5,9,0
"arenaria",1,8,5,3,0
"sacramento",1,10,4,6,0
"ungebulyson",0,11,4,7,0
"keraunography",1,13,5,8,0
"kramatorsk",1,10,3,7,0
"superintendence",1,15,6,9,0
"slumgullions",1,12,4,8,0
"ductworks",1,9,2,7,0
"antidefamation",1,14,7,7,0
"uncolourblines",0,14,6,8,0
"nephrotyphoid",1,13,4,9,0
"loesceke",1,8,4,4,0
"bali",1,4,2,2,0
"spis",0,4,1,3,0
"aethalium",1,9,5,4,0
"vsugivdlxflo",0,12,3,9,0
"varronian",1,9,4,5,0
"cqx'lud",0,7,1,6,1
"censions",0,8,3,5,0
"vclfqpdoaecujoaoihgv",0,20,8,12,0
"kher",0,4,1,3,0
"scarcely",1,8,2,6,0
"preily",0,6,2,4,0
"disenclosure",0,12,5,7,0
"zwaq",0,4,1,3,0
"sinarchisms",1,11,3,8,0
"barrera",1,7,3,4,0
"cordaitales",1,11,5,6,0
"rehoboams",1,9,4,5,0
"semiorthodox",1,12,5,7,0
"fzgii'ziialj",0,12,5,7,1
"frangent",1,8,2,6,0
"reng",0,4,1,3,0
"athalee",1,7,4,3,0
"y'beegaj'gcwi",0,13,4,9,2
"antly",0,5,1,4,0
"forbade",1,7,3,4,0
"anch",0,4,1,3,0
"kummerbund",1,10,3,7,0
"gambusia",1,8,4,4,0
"bibliophils",1,11,4,7,0
"chank",1,5,1,4,0
"ventriloquise",1,13,6,7,0
"brother",1,7,2,5,0
"sipeddleheadespons",0,18,7,11,0
"ivoirians",1,9,5,4,0
"chop",1,4,1,3,0
"crabtree",1,8,3,5,0
"bovill",1,6,2,4,0
"rhegnopteri",1,11,4,7,0
"albert",1,6,2,4,0
"orphabell",0,9,3,6,0
"aventeotbaccilt",0,15,6,9,0
"parats",0,6,2,4,0
"filvpfdrelpefkoipo",0,18,6,12,0
"mastes",0,6,2,4,0
"overb",0,5,2,3,0
"crumbly",1,7,1,6,0
"trisiticomon",0,12,5,7,0
"ddafiboltibrkigrksm",0,19,5,14,0
"exploitage",1,10,5,5,0
"intermeasuria",0,13,7,6,0
"utophane",0,8,4,4,0
"hemerocallis",1,12,5,7,0
"diatretum",1,9,4,5,0
"cantiradoxographic",0,18,7,11,0
"apoluphloes",0,11,5,6,0
"hbjuip",0,6,2,4,0
"vardingale",1,10,4,6,0
"aus",0,3,2,1,0
"eungy",0,5,2,3,0
"shugart",1,7,2,5,0
"coalgood",1,8,4,4,0
"nonmanagements",1,14,5,9,0
"dismissiveness",1,14,5,9,0
"ferrochrome",0,11,4,7,0
"cbipssbtfut",0,11,2,9,0
"wahehe",1,6,3,3,0
"proitalinhtiechecocupreitrerrbily",0,33,13,20,0
"anty",0,4,1,3,0
"dscelacklgenthas",0,16,4,12,0
"entertainment",1,13,5,8,0
"phytognomy",1,10,2,8,0
"sileni",1,6,3,3,0
"progelerfectlecly",0,17,5,12,0
"nonoskin",0,8,3,5,0
"overtrue",1,8,4,4,0
"mannoses",1,8,3,5,0
"dubiosities",1,11,6,5,0
"psephurus",1,9,3,6,0
"zfuvdfmvuqu",0,11,3,8,0
"inscrolls",1,9,2,7,0
"honelly",0,7,2,5,0
"trichechus",1,10,3,7,0
"nolock",0,6,2,4,0
"saccule",1,7,3,4,0
"enduros",1,7,3,4,0
"tomfortuga",0,10,4,6,0
"bailiwicks",1,10,4,6,0
"psammocharidae",1,14,6,8,0
"whiff",1,5,1,4,0
"symmers",0,7,1,6,0
"nonguarantinable",0,16,7,9,0
"unsable",0,7,3,4,0
"hwaggendiaetzlxgvdagr",0,21,6,15,0
"otherworldish",1,13,4,9,0
"mqzkgwflsnjbsvhgzjgzqhz",0,23,0,23,0
"inism",0,5,2,3,0
"lombarde",0,8,3,5,0
"crowville",1,9,3,6,0
"counterflower",0,13,5,8,0
"kilithia",0,8,4,4,0
"daffery",1,7,2,5,0
"unfanton",0,8,3,5,0
"paguroid",1,8,4,4,0
"nosematic",0,9,4,5,0
"letona",1,6,3,3,0
"guake",0,5,3,2,0
"'thlrjwpkpwmawjeiuwzv",0,21,4,17,1
"unconvulsiveness",1,16,6,10,0
"batty",1,5,1,4,0
"churidae",0,8,4,4,0
"khamseen",1,8,3,5,0
"foretake",1,8,4,4,0
"caroach",1,7,3,4,0
"indoorstead",0,11,5,6,0
"yrdckgpyfumrfoxmhwwq",0,20,2,18,0
"corseting",1,9,3,6,0
"bism",0,4,1,3,0
"unconspire",0,10,4,6,0
"nskcpxavuhjsuurzwce",0,19,5,14,0
"vigkbw",0,6,1,5,0
"goldenbush",1,10,3,7,0
"inuring",1,7,3,4,0
"nonspherings",0,12,3,9,0
"densimetry",1,10,3,7,0
"gesse",1,5,2,3,0
"trichomona",0,10,4,6,0
"deducements",1,11,4,7,0
"hempster",0,8,2,6,0
"vatonoadefnitinthe",0,18,8,10,0
"overcommendment",0,15,5,10,0
"cilicet",0,7,3,4,0
"jhpoyhvnk",0,9,1,8,0
"voluntee",0,8,4,4,0
"nasonally",0,9,3,6,0
"coom",1,4,2,2,0
"utzukxx'klx",0,11,2,9,1
"migglotingbasquer",0,17,6,11,0
"terury",0,6,2,4,0
"monopolite",0,10,5,5,0
"datormagajratecurachic",0,22,9,13,0
"ethtwlbcz",0,9,1,8,0
"porett",1,6,2,4,0
"verifiedness",0,12,5,7,0
"dommego",0,7,3,4,0
"munitioneer",1,11,6,5,0
"anisidine",1,9,5,4,0
"wallerian",1,9,4,5,0
"bfnjygsxfe'",0,11,1,10,1
"beinanorm",0,9,4,5,0
"driftlessness",1,13,3,10,0
"edrosomissiccaromanting",0,23,9,14,0
"preaccord",1,9,3,6,0
"retreading",1,10,4,6,0
"miscorrectest",0,13,4,9,0
"hoser",1,5,2,3,0
"adonais",1,7,4,3,0
"cercyon",1,7,2,5,0
"petalkinsonose",0,14,6,8,0
"rhizomatous",1,11,5,6,0
"elvers",1,6,2,4,0
"paration",0,8,4,4,0
"ravonelle",1,9,4,5,0
"aciformes",0,9,4,5,0
"fanache",0,7,3,4,0
"nggsjty'",0,8,0,8,1
"theomorpha",0,10,4,6,0
"biopsychologist",1,15,5,10,0
"parometerols",0,12,5,7,0
"stowbordmen",0,11,3,8,0
"parochialised",1,13,6,7,0
"rayage",1,6,3,3,0
"bvzjhpudbmmyjbja",0,16,2,14,0
"nillblinbrutics",0,15,4,11,0
"rialatiopigre",0,13,7,6,0
"chanedblepocelpss",0,17,5,12,0
"sekofski",1,8,3,5,0
"impersuasibly",1,13,5,8,0
"dist",0,4,1,3,0
"ladle",1,5,2,3,0
"intersusceptibly",0,16,5,11,0
"bridgetin",1,9,3,6,0
"marshier",1,8,3,5,0
"exaerphy",0,8,3,5,0
"assuetudinariness",0,17,8,9,0
"ventade",0,7,3,4,0
"vaginectomy",1,11,4,7,0
"affenpinscher",1,13,4,9,0
"vivant",1,6,2,4,0
"repudiationist",1,14,7,7,0
"sovietist",1,9,4,5,0
"tikalesinfaros",0,14,6,8,0
"ephorates",1,9,4,5,0
"euheme",0,6,4,2,0
"hepamppidarcyarengrmiapprddes",0,29,9,20,0
"pertia",0,6,3,3,0
"reshowing",1,9,3,6,0
"bandelette",1,10,4,6,0
"wkqutfwctjwiheumn'",0,18,4,14,1
"gallical",0,8,3,5,0
"blouddion",0,9,4,5,0
"heterakid",1,9,4,5,0
"mestees",1,7,3,4,0
"infralapsarianisms",1,18,7,11,0
"moorgamy",0,8,3,5,0
"phylephebic",1,11,3,8,0
"insecured",0,9,4,5,0
"cymbidiums",1,10,3,7,0
"ladybird",1,8,2,6,0
"itymatr",0,7,2,5,0
"deptelerle",0,10,4,6,0
"unameliorable",1,13,7,6,0
"vauting",1,7,3,4,0
"otah",0,4,2,2,0
"oenone",1,6,4,2,0
"kinnuroicrante",0,14,6,8,0
"findigo",0,7,3,4,0
"schoascar",0,9,3,6,0
"wheller",1,7,2,5,0
"rosophisms",0,10,3,7,0
"nonwarrantableness",0,18,6,12,0
"snoozling",1,9,3,6,0
"intemonal",0,9,4,5,0
"zoogeography",1,12,5,7,0
"metioukcleadelforgic",0,20,9,11,0
"civin",0,5,2,3,0
"ghvki'",0,6,1,5,1
"jolleyerosomatoideal",0,20,10,10,0
"teel",1,4,2,2,0
"medes",1,5,2,3,0
"theropoda",1,9,4,5,0
"ichthyian",1,9,3,6,0
"arromignesi",0,11,5,6,0
"nattorine",0,9,4,5,0
"comforchysoplanjibanic",0,22,7,15,0
"gloriosa",1,8,4,4,0
"nonnated",0,8,3,5,0
"remorseproof",1,12,5,7,0
"phacoidal",1,9,4,5,0
"hypnosporangia",1,14,5,9,0
"rattletop",1,9,3,6,0
"drolet",1,6,2,4,0
"pepperies",0,9,4,5,0
"teleano",0,7,4,3,0
"superlenient",1,12,5,7,0
"nissensohn",1,10,3,7,0
"salurawms",0,9,3,6,0
"unquick",1,7,3,4,0
"torris",0,6,2,4,0
"subarrhation",1,12,5,7,0
"playlist",1,8,2,6,0
"j'accuse",1,8,3,5,1
"squaw",1,5,2,3,0
"enrage",1,6,3,3,0
"tsutsi",0,6,2,4,0
"hydrolase",1,9,3,6,0
"uncontemner",0,11,4,7,0
"percoids",1,8,3,5,0
"heteratomic",1,11,5,6,0
"unsummerlike",1,12,5,7,0
"minelayer",1,9,4,5,0
"bashemath",1,9,3,6,0
"hotoxicatabilitted",0,18,8,10,0
"bagpuize",1,8,4,4,0
"hirami",0,6,3,3,0
"qz'jsmxjaamyvglnvhwm",0,20,2,18,1
"catinass",0,8,3,5,0
"nonament",0,8,3,5,0
"yttria",1,6,2,4,0
"temoplartomckes",0,15,5,10,0
"gwvhges'jaiuwa",0,14,5,9,1
"chomens",0,7,2,5,0
"pericline",1,9,4,5,0
"saffier",1,7,3,4,0
"unbroking",0,9,3,6,0
"ununanimously",1,13,6,7,0
"perisers",0,8,3,5,0
"purgations",1,10,4,6,0
"superwise",1,9,4,5,0
"antilethargising",0,16,6,10,0
"hallucinogens",1,13,5,8,0
"origenism",1,9,4,5,0
"kremlinologic",0,13,5,8,0
"bakersfield",1,11,4,7,0
"brudesation",0,11,5,6,0
"meifopealabengholine",0,20,10,10,0
"uricae",0,6,4,2,0
"pattable",1,8,3,5,0
"groundabout",0,11,5,6,0
"homwbquufrwb'",0,13,3,10,1
"sootied",1,7,4,3,0
"watercourse",1,11,5,6,0
"retiolizzurolvulphebraders",0,26,10,16,0
"kgnuccfmgwcc",0,12,1,11,0
"nondegrette",0,11,4,7,0
"hyssopus",1,8,2,6,0
"cajoles",1,7,3,4,0
"zeguessness",0,11,4,7,0
"kubergs",0,7,2,5,0
"rayonisms",1,9,3,6,0
"incrustations",1,13,5,8,0
"multiliness",0,11,4,7,0
"acantasted",0,10,4,6,0
"nydsgamsfrk",0,11,1,10,0
"armpeniestemes",0,14,6,8,0
"ziqwkimmdynycbbajngoocesj",0,25,6,19,0
"boers",1,5,2,3,0
"groundmass",1,10,3,7,0
"tussar",1,6,2,4,0
"dabes",0,5,2,3,0
"elucianist",0,10,5,5,0
"lunateds",1,8,3,5,0
"microts",0,7,2,5,0
"kale",1,4,2,2,0
"tiro",1,4,2,2,0
"perissodactyla",1,14,5,9,0
"diger",0,5,2,3,0
"hyperexcitator",0,14,5,9,0
"nwced'nzgrokqrvivblx'",0,21,3,18,2
"pazice",1,6,3,3,0
"sniernion",0,9,4,5,0
"pathary",0,7,2,5,0
"ksxvezv'dbgcgvxrnes''nfliqgqzu",0,30,4,26,3
"boheatimplans",0,13,5,8,0
"unsyphobarbitura",0,16,6,10,0
"uwfb",0,4,1,3,0
"ostrya",1,6,2,4,0
"lumpsuckers",1,11,3,8,0
"attalla",1,7,3,4,0
"doomingness",0,11,4,7,0
"stovall",1,7,2,5,0
"underactors",1,11,4,7,0
"sigmoidoproctous",0,16,7,9,0
"ld'ibzend",0,9,2,7,1
"istomenonstrelatoloparrew",0,25,10,15,0
"gunki",0,5,2,3,0
"rolypolines",0,11,4,7,0
"trencherwoman",1,13,4,9,0
"paraaminobenzoic",1,16,8,8,0
"alipomans",0,9,4,5,0
"sleekiest",1,9,4,5,0
"abscugged",0,9,3,6,0
"vetiveriaceae",0,13,8,5,0
"phytogeographer",1,15,5,10,0
"elfkin",1,6,2,4,0
"oppressor",1,9,3,6,0
"illimitable",1,11,5,6,0
"sextetrocycles",0,14,4,10,0
"conjunct",1,8,2,6,0
"expecter",1,8,3,5,0
"gormandie",0,9,4,5,0
"abstaneous",0,10,5,5,0
"fdqlczmuzndpoakiadpackdyhxw",0,27,6,21,0
"erignathus",1,10,4,6,0
"cadgies",0,7,3,4,0
"wgsdr",0,5,0,5,0
"alenconcomendyescs",0,18,6,12,0
"sy'xvoo'gkbfa",0,13,3,10,2
"maisie",1,6,4,2,0
"symbolicalnesses",1,16,5,11,0
"ioykotnx'qggskk",0,15,3,12,1
"protoascales",1,12,5,7,0
"nephwinsexiusehipisslereptae",0,28,12,16,0
"steid",1,5,2,3,0
"dishful",1,7,2,5,0
"traryba",0,7,2,5,0
"zzobrifrit",0,10,3,7,0
"noah",1,4,2,2,0
"arnosaurid",0,10,5,5,0
"mystify",1,7,1,6,0
"ih'bbqfsieeflvefnmqdgeawvowb",0,28,8,20,1
"adlay",1,5,2,3,0
"nonpubli",0,8,3,5,0
"repton",1,6,2,4,0
"cocreassus",0,10,4,6,0
"immantiminal",0,12,5,7,0
"novachord",1,9,3,6,0
"subinfluence",0,12,5,7,0
"kcuzqcgvpnzzkeipooxy'xmsg",0,25,5,20,1
"absolutest",1,10,4,6,0
"addling",1,7,2,5,0
"vhdvenyodxukfqdjpmeaaga",0,23,7,16,0
"urnursearrests",0,14,5,9,0
"fucama",0,6,3,3,0
"headstall",1,9,3,6,0
"xtel'fmsdtnt''moguqanbt",0,23,4,19,3
"fabiolas",1,8,4,4,0
"traditions",1,10,4,6,0
"desalinated",1,11,5,6,0
"fluitzstroster",0,14,4,10,0
"premunitions",1,12,5,7,0
"ulpatiy'xrf'aswl",0,16,4,12,2
"shawwal",1,7,2,5,0
"ungritty",1,8,2,6,0
"eted",0,4,2,2,0
"electivelterywoodchoid",0,22,9,13,0
"spanglish",1,9,2,7,0
"brightendist",0,12,3,9,0
"danted",1,6,2,4,0
"metaphorically",1,14,5,9,0
"jingleaf",0,8,3,5,0
"uptic",0,5,2,3,0
"partitible",0,10,4,6,0
"coaxal",1,6,3,3,0
"fringer",0,7,2,5,0
"demutualisation",1,15,8,7,0
"cerde",0,5,2,3,0
"strombus",1,8,2,6,0
"deadener",1,8,4,4,0
"axatuntiech",0,11,5,6,0
"heraseable",0,10,5,5,0
"fumblers",1,8,2,6,0
"wreadatationsulators",0,20,9,11,0
"esperador",0,9,4,5,0
"thondracians",1,12,4,8,0
"bokoto",1,6,3,3,0
"sorees",1,6,3,3,0
"boolean",1,7,4,3,0
"solays",0,6,2,4,0
"wakhottelene",0,12,5,7,0
"tellies",1,7,3,4,0
"unwearily",1,9,4,5,0
"francophile",1,11,4,7,0
"pald",0,4,1,3,0
"leifer",1,6,3,3,0
"rosamund",1,8,3,5,0
"hispanick",0,9,3,6,0
"spcc",1,4,0,4,0
"polemicising",1,12,5,7,0
"defragatory",0,11,4,7,0
"agenea",0,6,4,2,0
"sipple",1,6,2,4,0
"bailees",1,7,4,3,0
"sity",0,4,1,3,0
"phenobarbitol",1,13,5,8,0
"alathia",1,7,4,3,0
"scedules",1,8,3,5,0
"periqunkanedrrios",0,17,7,10,0
"armarium",1,8,4,4,0
"counterplay",1,11,4,7,0
"stravinsky",1,10,2,8,0
"xvnortqecqkoxvbqdjycezihn",0,25,5,20,0
"pinpricks",1,9,2,7,0
"convexly",1,8,2,6,0
"surrejoinder",1,12,5,7,0
"unclearable",1,11,5,6,0
"rearranging",1,11,4,7,0
"clogthemoes",0,11,4,7,0
"phylqcunkqqawyt",0,15,2,13,0
"'ewnibpv'inilvczonvdz",0,21,5,16,2
"chargeless",1,10,3,7,0
"prologos",1,8,3,5,0
"cindaetal",0,9,4,5,0
"bqjqtcmz''iqg",0,13,1,12,2
"riverbank",1,9,3,6,0
"chrysomelidae",1,13,5,8,0
"nissanderworkmatematognathisi",0,29,11,18,0
"coryphaenoididae",1,16,8,8,0
"sdezon",0,6,2,4,0
"impingence",1,10,4,6,0
"philhymnist",0,11,2,9,0
"flutter",1,7,2,5,0
"ec",1,2,1,1,0
"sdra",0,4,1,3,0
"mintmark",1,8,2,6,0
"ornate",1,6,3,3,0
"exply",0,5,1,4,0
"compiled",1,8,3,5,0
"californium",1,11,5,6,0
"rement",0,6,2,4,0
"deltic",1,6,2,4,0
"nologiliticiping",0,16,7,9,0
"thyreocoridae",1,13,6,7,0
"al'pbcofjisou",0,13,5,8,1
"plummetless",1,11,3,8,0
"parasyntheta",1,12,4,8,0
"nerg",0,4,1,3,0
"neill",1,5,2,3,0
"restyling",1,9,2,7,0
"wcdszizzzi",0,10,2,8,0
"warrob",0,6,2,4,0
"hyperorthognathous",1,18,6,12,0
"vgi",1,3,1,2,0
"aphthalmists",0,12,3,9,0
"muharrum",1,8,3,5,0
"dictyoxylon",1,11,3,8,0
"cke",0,3,1,2,0
"pet",1,3,1,2,0
"toluate",1,7,4,3,0
"mikan",1,5,2,3,0
"baiel",1,5,3,2,0
"bhisti",1,6,2,4,0
"converturbings",0,14,4,10,0
"relocable",1,9,4,5,0
"isoantimonarda",0,14,7,7,0
"unerotically",0,12,5,7,0
"impoo",0,5,3,2,0
"lustily",1,7,2,5,0
"undeclarable",1,12,5,7,0
"myrmica",1,7,2,5,0
"kyl",1,3,0,3,0
"barbadoes",1,9,4,5,0
"calf",1,4,1,3,0
"kelvespolotong",0,14,5,9,0
"minon",0,5,2,3,0
"msm",1,3,0,3,0
"cognisance",1,10,4,6,0
"uncouching",1,10,4,6,0
"ascosporic",1,10,4,6,0
"solebury",1,8,3,5,0
"undnessemianian",0,15,7,8,0
"eeogolmxpvzs",0,12,4,8,0
"recurrently",1,11,3,8,0
"modifiabilities",1,15,8,7,0
"corrodier",1,9,4,5,0
"jacobite",1,8,4,4,0
"jussive",1,7,3,4,0
"terridae",0,8,4,4,0
"cornhamidinitionics",0,19,8,11,0
"arecibo",1,7,4,3,0
"superheterophyll",0,16,5,11,0
"collos",0,6,2,4,0
"debruised",1,9,4,5,0
"superwife",1,9,4,5,0
"severe",1,6,3,3,0
"bletherings",1,11,3,8,0
"piiollonedbotirke",0,17,8,9,0
"imago",1,5,3,2,0
"howtowdies",1,10,4,6,0
"haliographer",1,12,5,7,0
"sulphohaloid",1,12,5,7,0
"coercively",1,10,4,6,0
"sewerless",1,9,3,6,0
"nurnberg",1,8,2,6,0
"baaskap",1,7,3,4,0
"tomolo",1,6,3,3,0
"loreless",1,8,3,5,0
"onlalululpaxcogitinty",0,21,8,13,0
"ujnebiav",0,8,4,4,0
"fetidoniltfles",0,14,5,9,0
"unordinary",1,10,4,6,0
"dehydraters",1,11,3,8,0
"defeater",1,8,4,4,0
"thievery",1,8,3,5,0
"apg",1,3,1,2,0
"catiline",1,8,4,4,0
"spigot",1,6,2,4,0
"inquinating",1,11,5,6,0
"forastorigges",0,13,5,8,0
"sternages",1,9,3,6,0
"xffbfpuatjpnofjhwwjfrhc'fp",0,26,3,23,1
"dhjn",0,4,0,4,0
"superball",1,9,3,6,0
"phedenhan",0,9,3,6,0
"et",0,2,1,1,0
"ze",0,2,1,1,0
"productivenesses",1,16,6,10,0
"meleagrinae",1,11,6,5,0
"wawls",1,5,1,4,0
"salivations",1,11,5,6,0
"ayve'xyk",0,8,2,6,1
"tamaria",0,7,4,3,0
"amphichrom",1,10,3,7,0
"subblenessly",0,12,3,9,0
"pcgunwfytkvngr''mre'n",0,21,2,19,3
"meingoldas",1,10,4,6,0
"squassation",0,11,5,6,0
"miniconvexed",0,12,5,7,0
"necessarion",0,11,5,6,0
"concactenated",1,13,5,8,0
"jfiib'cmnpywxzjjsyueuzpu'br",0,27,6,21,2
"countual",0,8,4,4,0
"shirtless",1,9,2,7,0
"mingenlin",0,9,3,6,0
"magsaysay",1,9,3,6,0
"pithecanthropidae",1,17,7,10,0
"bolingbrook",0,11,4,7,0
"antipramine",0,11,5,6,0
"negotiates",1,10,5,5,0
"tutors",1,6,2,4,0
"jermain",1,7,3,4,0
"skaddle",1,7,2,5,0
"cozeness",0,8,3,5,0
"superfamiliarity",0,16,7,9,0
"triviality",1,10,4,6,0
"mard",0,4,1,3,0
"cacus",1,5,2,3,0
"lienotoxin",1,10,5,5,0
"poth",1,4,1,3,0
"unsuspiciousness",1,16,7,9,0
"defibrillative",1,14,6,8,0
"ofurystledgrtropla",0,18,5,13,0
"unreciprocalistidae",0,19,9,10,0
"isoscopia",0,9,5,4,0
"dragging",1,8,2,6,0
"iosyz",0,5,2,3,0
"superver",0,8,3,5,0
"yrekantness",0,11,3,8,0
"marionettes",1,11,5,6,0
"retiparivoreswax",0,16,7,9,0
"chartless",1,9,2,7,0
"whelming",1,8,2,6,0
"tinc",1,4,1,3,0
"begunin",0,7,3,4,0
"pseudocoelomate",1,15,8,7,0
"pseudotto",0,9,4,5,0
"'eypvkitfbjheicdimczclhv",0,24,5,19,1
"ultrasensitive",1,14,6,8,0
"solvent",1,7,2,5,0
"loming",1,6,2,4,0
"kamerman",1,8,3,5,0
"pauli",1,5,3,2,0
"caud",0,4,2,2,0
"damnonians",1,10,4,6,0
"saladang",1,8,3,5,0
"waney",1,5,2,3,0
"fireside",1,8,4,4,0
"reesville",1,9,4,5,0
"synaesthetic",1,12,4,8,0
"legically",0,9,3,6,0
"godaureroliarritisionge",0,23,12,11,0
"herize",0,6,3,3,0
"tonsi",0,5,2,3,0
"algonian",0,8,4,4,0
"snorcertise",0,11,4,7,0
"obang",1,5,2,3,0
"fermentability",1,14,5,9,0
"kaposi",1,6,3,3,0
"bonbon",1,6,2,4,0
"fhtbcbve",0,8,1,7,0
"pummice",1,7,3,4,0
"excus",0,5,2,3,0
"dipodomyinae",1,12,6,6,0
"heliotypically",1,14,5,9,0
"k'ltfmiiwmijqlucotns",0,20,5,15,1
"nbe",1,3,1,2,0
"procks",0,6,1,5,0
"chromat",0,7,2,5,0
"oscilloscopic",1,13,5,8,0
"qgrwgevusjzj",0,12,2,10,0
"hyqijjezkinycngaj",0,17,4,13,0
"monadheadedly",0,13,5,8,0
"'iqlakbawmw",0,11,3,8,1
"visibilities",1,12,6,6,0
"holotrich",1,9,3,6,0
"rearise",1,7,4,3,0
"sawtimber",1,9,3,6,0
"hassocky",1,8,2,6,0
"rushee",1,6,3,3,0
"kolus",0,5,2,3,0
"trochaic",1,8,3,5,0
"parotis",1,7,3,4,0
"extravagated",1,12,5,7,0
"kewhicassac",0,11,4,7,0
"phymatorhysin",1,13,3,10,0
"plermircum",0,10,3,7,0
"oreshoot",1,8,4,4,0
"ohkiijzobp'mwoiulgx'a",0,21,8,13,2
"heterogge",0,9,4,5,0
"lark",1,4,1,3,0
"outscorporanites",0,16,7,9,0
"polack",1,6,2,4,0
"plath",1,5,1,4,0
"gradine",1,7,3,4,0
"pyritohedra",1,11,4,7,0
"vaticanical",1,11,5,6,0
"castigatories",1,13,6,7,0
"sporogonial",1,11,5,6,0
"pseudoliberally",1,15,6,9,0
"preportadelloisbody",0,19,7,12,0
"loadeoff",0,8,4,4,0
"collocation",1,11,5,6,0
"ostensorium",1,11,5,6,0
"distantly",1,9,2,7,0
"osteometrical",1,13,6,7,0
"leukotomes",1,10,5,5,0
"legius",0,6,3,3,0
"carnival",1,8,3,5,0
"oreodontidae",1,12,7,5,0
"trisyllable",1,11,3,8,0
"duplicidentata",1,14,6,8,0
"patied",0,6,3,3,0
"nonoily",1,7,3,4,0
"beaverinductioniser",0,19,9,10,0
"duvet",1,5,2,3,0
"chimneypieces",1,13,5,8,0
"paragonite",1,10,5,5,0
"oulinis",0,7,4,3,0
"pokomo",1,6,3,3,0
"rideirismintrogres",0,18,7,11,0
"onomatopoeically",1,16,8,8,0
"gfnflsxnzkeigve'cpib",0,20,4,16,1
"dreyfusard",1,10,3,7,0
"cqrr",0,4,0,4,0
"punizatids",0,10,4,6,0
"rubbet",1,6,2,4,0
"oilfields",1,9,4,5,0
"prosmodjackling",0,15,4,11,0
"icclichr",0,8,2,6,0
"lillionica",0,10,5,5,0
"temonglike",0,10,4,6,0
"oversum",1,7,3,4,0
"'fhvgftluacebdmdyseug",0,21,5,16,1
"protometallic",1,13,5,8,0
"ceramium",1,8,4,4,0
"omezk",0,5,2,3,0
"alime",0,5,3,2,0
"blashiest",1,9,3,6,0
"libia",1,5,3,2,0
"phificoriversox",0,15,6,9,0
"symmetrisation",1,14,5,9,0
"barrone",0,7,3,4,0
"oute",0,4,3,1,0
"caloyers",1,8,3,5,0
"tableaux",1,8,4,4,0
"skry",1,4,0,4,0
"unsubstings",0,11,3,8,0
"anticritically",1,14,5,9,0
"lessen",1,6,2,4,0
"springtrap",1,10,2,8,0
"alyssum",1,7,2,5,0
"chickenshit",1,11,3,8,0
"untough",1,7,3,4,0
"pushbird",0,8,2,6,0
"volumise",1,8,4,4,0
"donidananeptopuralespet",0,23,10,13,0
"attainera",0,9,5,4,0
"barotseland",1,11,4,7,0
"ichthyornithoid",1,15,5,10,0
"trypanum",0,8,2,6,0
"ariaciform",0,10,5,5,0
"leazes",1,6,3,3,0
"ludibry",1,7,2,5,0
"unbefringeflowerinesses",0,23,9,14,0
"symphodel",0,9,2,7,0
"ogliads",0,7,3,4,0
"dispossessional",0,15,6,9,0
"nrhmxyvdtwafp'wpa",0,17,2,15,1
"chromolithiasis",0,15,6,9,0
"taliacotian",1,11,6,5,0
"saker",1,5,2,3,0
"latirostres",1,11,4,7,0
"oedkgm",0,6,2,4,0
"saltants",1,8,2,6,0
"monite",0,6,3,3,0
"maniford",0,8,3,5,0
"calicos",1,7,3,4,0
"starned",1,7,2,5,0
"mariatiemoues",0,13,8,5,0
"afcwtic",0,7,2,5,0
"carcherrightmen",0,15,4,11,0
"brosistorbote",0,13,5,8,0
"bec",0,3,1,2,0
"vinetta",1,7,3,4,0
"pslfnck",0,7,0,7,0
"alectrionidae",1,13,7,6,0
"emulation",1,9,5,4,0
"clnxpcvbhfru",0,12,1,11,0
"minervic",1,8,3,5,0
"remus",1,5,2,3,0
"barthia",0,7,3,4,0
"quarterspace",1,12,5,7,0
"visiting",1,8,3,5,0
"damnability",1,11,4,7,0
"strippable",1,10,3,7,0
"leucherin",0,9,4,5,0
"threadvowsan",0,12,4,8,0
"metch",0,5,1,4,0
"casoness",0,8,3,5,0
"pronarched",0,10,3,7,0
"conturbations",0,13,5,8,0
"glanville",1,9,3,6,0
"otfgyivbazu",0,11,4,7,0
"refreshener",1,11,4,7,0
"tarlipitonicellegism",0,20,8,12,0
"burnham",1,7,2,5,0
"caren",1,5,2,3,0
"agasiotheousthevorite",0,21,11,10,0
"tatariales",0,10,5,5,0
"renex",0,5,2,3,0
"wzqhhm'n'x'trfwi",0,16,1,15,3
"gamblyman",0,9,2,7,0
"aerodynamicist",1,14,6,8,0
"arcena",0,6,3,3,0
"troutiest",1,9,4,5,0
"olnay",1,5,2,3,0
"chet",1,4,1,3,0
"stoncthanetepr",0,14,4,10,0
"kalumpangweulu",0,14,6,8,0
"apharition",0,10,5,5,0
"matriculate",1,11,5,6,0
"ratche",0,6,2,4,0
"punily",1,6,2,4,0
"cubicula",1,8,4,4,0
"opiners",1,7,3,4,0
"monocondylar",1,12,4,8,0
"gatunfra",0,8,3,5,0
"zanyisms",1,8,2,6,0
"riette",0,6,3,3,0
"walterboro",1,10,4,6,0
"gason",0,5,2,3,0
"kanqzpoagvvsgna'xzspkie",0,23,6,17,1
"aeronometrisation",0,17,9,8,0
"bdsits",0,6,1,5,0
"merseburg",1,9,3,6,0
"interjack",0,9,3,6,0
"associationism",1,14,7,7,0
"unloweata",0,9,5,4,0
"seorkmhzhnx",0,11,2,9,0
"pactivize",0,9,4,5,0
"nindowa",0,7,3,4,0
"archaeoastrologies",0,18,9,9,0
"deminesulluxurvargs",0,19,7,12,0
"ecqlpfs'uhpyvuokbhuzh",0,21,5,16,1
"iophuss",0,7,3,4,0
"nonsciolins",0,11,4,7,0
"effigiated",1,10,5,5,0
"d'xlqvwqwdkx'xrjzemwv",0,21,1,20,2
"quadrum",1,7,3,4,0
"cafulamostatarerrherymedang",0,27,10,17,0
"ywfpzo",0,6,1,5,0
"achlorhydric",1,12,3,9,0
"eavabellonader",0,14,7,7,0
"qasion",0,6,3,3,0
"latched",1,7,2,5,0
"anesses",0,7,3,4,0
"jerenshanteregantan",0,19,7,12,0
"aomgbyjg",0,8,2,6,0
"rhizopheny",0,10,3,7,0
"homing",1,6,2,4,0
"apologer",1,8,4,4,0
"jamesonite",1,10,5,5,0
"bringenmonapstabiandstitietagroffloglainwom",0,43,16,27,0
"pentameran",1,10,4,6,0
"tungus",1,6,2,4,0
"ebullo",0,6,3,3,0
"whaizle",1,7,3,4,0
"aiken",1,5,3,2,0
"unbouniabbendswalbus",0,20,8,12,0
"mpu'dxhizswww",0,13,2,11,1
"shipowner",1,9,3,6,0
"smartweeds",1,10,3,7,0
"reoils",1,6,3,3,0
"abuttal",1,7,3,4,0
"wwpk",0,4,0,4,0
"ajivika",1,7,4,3,0
"intestiniform",1,13,5,8,0
"caverney",0,8,3,5,0
"podophyllin",1,11,3,8,0
"idsmicar",0,8,3,5,0
"natassia",1,8,4,4,0
"pilfre",1,6,2,4,0
"bobbin",1,6,2,4,0
"disturber",1,9,3,6,0
"roguerie",0,8,5,3,0
"amustridarrucinessa",0,19,8,11,0
"forbarred",1,9,3,6,0
"musnudgers",0,10,3,7,0
"ratexpencequixicathaymandubirriessubs",0,37,15,22,0
"aureated",0,8,5,3,0
"coactility",0,10,4,6,0
"pantographies",1,13,5,8,0
"brandonville",1,12,4,8,0
"mammonteus",1,10,4,6,0
"postdrug",1,8,2,6,0
"ptitatodoncheren",0,16,6,10,0
"limnograher",0,11,4,7,0
"xthgtvlaxugnfsjxlqdjxwtg",0,24,2,22,0
"timpsons",0,8,2,6,0
"unauthorise",1,11,6,5,0
"heptadecyl",1,10,3,7,0
"interphobia",0,11,5,6,0
"typist",1,6,1,5,0
"danica",1,6,3,3,0
"rabbinistic",1,11,4,7,0
"phosphatise",1,11,4,7,0
"scalesmith",1,10,3,7,0
"stagnation",1,10,4,6,0
"threskiornithidae",1,17,7,10,0
"unshrinee",0,9,4,5,0
"zaconerag",0,9,4,5,0
"oneaclendognon",0,14,6,8,0
"todevvy",0,7,2,5,0
"rosenbaum",1,9,4,5,0
"squattered",1,10,4,6,0
"sinisitrilinerere",0,17,8,9,0
"tatoos",1,6,3,3,0
"aride",0,5,3,2,0
"cald",0,4,1,3,0
"epize",0,5,3,2,0
"messor",1,6,2,4,0
"tellegists",0,10,3,7,0
"srama",0,5,2,3,0
"glands",1,6,1,5,0
"elfheim",0,7,3,4,0
"spartanly",1,9,2,7,0
"uncleansed",1,10,4,6,0
"pyla",0,4,1,3,0
"lus",0,3,1,2,0
"rannactiocaliselamap",0,20,9,11,0
"sargassos",1,9,3,6,0
"puttin",0,6,2,4,0
"ykigystinrlhh",0,13,2,11,0
"pilchard",1,8,2,6,0
"swearedness",0,11,4,7,0
"dispaint",1,8,3,5,0
"dagu",1,4,2,2,0
"proprietory",1,11,4,7,0
"panabling",0,9,3,6,0
"exoga",0,5,3,2,0
"forkland",1,8,2,6,0
"repristinate",1,12,5,7,0
"wn",0,2,0,2,0
"portions",1,8,3,5,0
"nonprocedurally",1,15,5,10,0
"countermen",1,10,4,6,0
"cuttleman",0,9,3,6,0
"subsidiarinesses",1,16,7,9,0
"carotaterlo",0,11,5,6,0
"oreretepilerecotls",0,18,8,10,0
"pointmen",1,8,3,5,0
"phosphorolysis",1,14,4,10,0
"luehrman",0,8,3,5,0
"kalimba",1,7,3,4,0
"excurvated",1,10,4,6,0
"astally",0,7,2,5,0
"medinalidias",0,12,6,6,0
"kerittall",0,9,3,6,0
"dolomites",1,9,4,5,0
"piaropus",1,8,4,4,0
"monticuli",0,9,4,5,0
"dephitivers",0,11,4,7,0
"simonal",0,7,3,4,0
"dynaming",0,8,2,6,0
"paraengineery",0,13,6,7,0
"migmatite",1,9,4,5,0
"sunrisings",1,10,3,7,0
"provenient",1,10,4,6,0
"exophthalmos",1,12,4,8,0
"tpeizlcgtch'lcqr",0,16,2,14,1
"bilgeways",0,9,3,6,0
"vsnwcqpcbam",0,11,1,10,0
"archimorphic",1,12,4,8,0
"stephensburg",1,12,3,9,0
"ashvillidesrooteronsucted",0,25,10,15,0
"omnifacimentedness",0,18,7,11,0
"scarchbism",0,10,2,8,0
"bee",1,3,2,1,0
"jyyjcxzyehf",0,11,1,10,0
"cardione",0,8,4,4,0
"papaio",1,6,4,2,0
"cheluviation",0,12,6,6,0
"synarding",0,9,2,7,0
"dichoantiphophopal",0,18,7,11,0
"baldie",1,6,3,3,0
"salwauw",0,7,3,4,0
"arminian",1,8,4,4,0
"echewshoraise",0,13,6,7,0
"myroxylon",1,9,2,7,0
"kuqkrkvrnpwjtqawalplychak",0,25,4,21,0
"ureterveny",0,10,4,6,0
"solidarity",1,10,4,6,0
"recollectivistically",0,20,7,13,0
"appressorium",1,12,5,7,0
"fowloumon",0,9,4,5,0
"skylarkings",1,11,2,9,0
"bie",0,3,2,1,0
"beprisatters",0,12,4,8,0
"misappendance",0,13,5,8,0
"esifeert",0,8,4,4,0
"conpakeling",0,11,4,7,0
"nonmaturity",1,11,4,7,0
"palatoscopic",0,12,5,7,0
"pluvialis",1,9,4,5,0
"slighty",1,7,1,6,0
"thermoperies",0,12,5,7,0
"bowpin",1,6,2,4,0
"poirvz",0,6,2,4,0
"cubas",1,5,2,3,0
"ke",0,2,1,1,0
"gaslizzatat",0,11,4,7,0
"mahoonalectarson",0,16,7,9,0
"sceputs",0,7,2,5,0
"physicianer",1,11,4,7,0
"parthenogenous",1,14,6,8,0
"backlandstuffe",0,14,4,10,0
"pgalgnfrgksnzikdivfreoacq",0,25,6,19,0
"remedite",0,8,4,4,0
"ddrexxiort",0,10,3,7,0
"automatidae",0,11,7,4,0
"costen",1,6,2,4,0
"ardthailolthamericha",0,20,8,12,0
"subocuration",0,12,6,6,0
"semisubmersible",1,15,6,9,0
"plainchant",1,10,3,7,0
"shmo",1,4,1,3,0
"aterberly",0,9,3,6,0
"dipa",0,4,2,2,0
"femorange",0,9,4,5,0
"monovalency",1,11,4,7,0
"algregalse",0,10,4,6,0
"henrigidae",0,10,5,5,0
"hashum",1,6,2,4,0
"traipsings",1,10,3,7,0
"ignishes",0,8,3,5,0
"lkmyfhfyijnpkcenn",0,17,2,15,0
"graeus",0,6,3,3,0
"quiescing",1,9,4,5,0
"snippy",1,6,1,5,0
"philosophicalness",1,17,6,11,0
"refractometry",1,13,4,9,0
"dromaeognathism",1,15,6,9,0
"botvilers",0,9,3,6,0
"nonfieldambooka",0,15,7,8,0
"jeta",1,4,2,2,0
"ugrwbleuprnzkeyrlsc",0,19,4,15,0
"micotylomustbranctive",0,21,7,14,0
"flyfish",1,7,1,6,0
"winesops",1,8,3,5,0
"bankits",1,7,2,5,0
"dareece",1,7,4,3,0
"ve",0,2,1,1,0
"pseudotachometry",0,16,6,10,0
"tritenesian",0,11,5,6,0
"otheliast",0,9,4,5,0
"nonresidential",1,14,6,8,0
"pvdgiluhfkrngu'fgzjey'oly",0,25,5,20,2
"gleda",1,5,2,3,0
"nutritides",0,10,4,6,0
"vxuvnphwwuttiantetn'",0,20,5,15,1
"downhaussuckie",0,14,6,8,0
"colcelley",0,9,3,6,0
"bioninqualve",0,12,6,6,0
"amnia",1,5,3,2,0
"cortfassufulplutic",0,18,6,12,0
"xenophilias",1,11,5,6,0
"tatin",1,5,2,3,0
"omu'ocifhzzyc",0,13,4,9,1
"colligatoriness",0,15,6,9,0
"raipuriagakinsud",0,16,8,8,0
"arrayan",1,7,3,4,0
"chanths",0,7,1,6,0
"bouncers",1,8,3,5,0
"zermatt",1,7,2,5,0
"amale",0,5,3,2,0
"effrjxagzn",0,10,2,8,0
"harpp",1,5,1,4,0
"ecumene",1,7,4,3,0
"hirobumi",1,8,4,4,0
"preightilionate",0,15,7,8,0
"leukaemogenes",0,13,7,6,0
"hdqnajolsv'qtugiyxfbf",0,21,4,17,1
"paneidency",0,10,4,6,0
"nzvbhvmy'fucecnqxrfzhry",0,23,2,21,1
"moonally",0,8,3,5,0
"intermelt",1,9,3,6,0
"snicationism",0,12,5,7,0
"bomengenetrainillively",0,22,9,13,0
"serrancy",0,8,2,6,0
"wawina",1,6,3,3,0
"muezzin",1,7,3,4,0
"myelencephala",1,13,5,8,0
"copharternadationcaeart",0,23,10,13,0
"cabiria",1,7,4,3,0
"noney",0,5,2,3,0
"zasgzgchadwrs",0,13,2,11,0
"corinthianism",1,13,5,8,0
"unpersuasible",1,13,6,7,0
"tralirmaders",0,12,4,8,0
"fishgig",1,7,2,5,0
"vivaletuding",0,12,5,7,0
"soundheartedness",1,16,6,10,0
"succesive",1,9,4,5,0
"contempestivity",0,15,5,10,0
"marybeller",0,10,3,7,0
"pripet",1,6,2,4,0
"exrupeal",1,8,4,4,0
"xeuzjlufinf'rfhnl'plijtwf",0,25,5,20,2
"discanting",1,10,3,7,0
"movableness",1,11,4,7,0
"epigraphyll",0,11,3,8,0
"suabejows",0,9,4,5,0
"anaccounderiestation",0,20,10,10,0
"zaptiah",1,7,3,4,0
"mab",1,3,1,2,0
"noncurative",1,11,5,6,0
"merychippus",1,11,3,8,0
"oys",1,3,1,2,0
"adorns",1,6,2,4,0
"jepmnbqr'dsk",0,12,1,11,1
"hegira",1,6,3,3,0
"flambeed",1,8,3,5,0
"undergeneral",1,12,5,7,0
"savonburg",1,9,3,6,0
"compositella",0,12,5,7,0
"soligioid",0,9,5,4,0
"thigmotropisms",1,14,4,10,0
"represellschaft",0,15,4,11,0
"tatripatione",0,12,6,6,0
"dbxjq'auybposeebkhgzftt",0,23,5,18,1
"bakersfield",1,11,4,7,0
"trustification",1,14,6,8,0
"polepsialsisssinglioces",0,23,9,14,0
"delphina",1,8,3,5,0
"ererbeerepokeragearus",0,21,11,10,0
"bacardiographic",0,15,6,9,0
"canophobia",1,10,5,5,0
"ensigns",1,7,2,5,0
"lecideaceous",1,12,7,5,0
"rippa",0,5,2,3,0
"opisthotonus",1,12,5,7,0
"praehallux",1,10,4,6,0
"fawkes",1,6,2,4,0
"upele",0,5,3,2,0
"misknowledges",1,13,4,9,0
"quemado",1,7,4,3,0
"stila",1,5,2,3,0
"intrarachide",0,12,5,7,0
"homoiousianisms",1,15,8,7,0
"herenesses",1,10,4,6,0
"neesed",1,6,3,3,0
"binjiepholllocrobunchendes",0,26,9,17,0
"bbtsvkfuwupu",0,12,3,9,0
"counterscientific",1,17,7,10,0
"overmasterfully",1,15,5,10,0
"intralingual",1,12,5,7,0
"lous",0,4,2,2,0
"fossilise",1,9,4,5,0
"premolars",1,9,3,6,0
"agronomist",1,10,4,6,0
"pernas",1,6,2,4,0
"uncompulsorinesses",0,18,7,11,0
"ove",0,3,2,1,0
"repulp",1,6,2,4,0
"saddlestiffnesses",0,17,5,12,0
"wastable",1,8,3,5,0
"unremlesminge",0,13,5,8,0
"missouri",1,8,4,4,0
"rozokhopoune",0,12,6,6,0
"lbdib",0,5,1,4,0
"methylsilant",0,12,3,9,0
"ouphs",1,5,2,3,0
"nonadoptable",1,12,5,7,0
"hu'l'bbxxpii",0,12,3,9,2
"sprotista",0,9,3,6,0
"foins",0,5,2,3,0
"giessemecdurbid",0,15,6,9,0
"abstentious",1,11,5,6,0
"lonelinesses",1,12,5,7,0
"fodznloapfkocqdqjpwq",0,20,4,16,0
"coyndgiphfh",0,11,2,9,0
"devestreamer",0,12,5,7,0
"sanctual",0,8,3,5,0
"vgzcrbbbm",0,9,0,9,0
"recompendious",0,13,6,7,0
"geals",1,5,2,3,0
"ficula",1,6,3,3,0
"gcilwehyuyhr''d",0,15,3,12,2
"checkweigher",1,12,4,8,0
"osubass",0,7,3,4,0
"dimethylnitrosified",0,19,7,12,0
"cholecystectasia",1,16,6,10,0
"faux",1,4,2,2,0
"telfers",0,7,2,5,0
"dowmake",0,7,3,4,0
"redical",0,7,3,4,0
"conglobuling",0,12,4,8,0
"lunatene",0,8,4,4,0
"durning",1,7,2,5,0
"tilney",1,6,2,4,0
"autoregulative",1,14,8,6,0
"variolator",1,10,5,5,0
"colter",1,6,2,4,0
"clupea",1,6,3,3,0
"closplinterlocking",0,18,5,13,0
"chieftainry",1,11,4,7,0
"unastounded",1,11,5,6,0
"thinghood",1,9,3,6,0
"ichthyodorylinae",0,16,6,10,0
"ventriloquism",1,13,5,8,0
"schmooze",1,8,3,5,0
"conventual",1,10,4,6,0
"renormalaprotectiveness",0,23,9,14,0
"barbiest",0,8,3,5,0
"apetalous",1,9,5,4,0
"honkytonks",1,10,2,8,0
"habletdom",0,9,3,6,0
"superclub",1,9,3,6,0
"talmudistical",1,13,5,8,0
"coness",0,6,2,4,0
"polyprotodontinae",0,17,7,10,0
"bakalei",1,7,4,3,0
"flowerlet",1,9,3,6,0
"dhoti",1,5,2,3,0
"esllius",0,7,3,4,0
"tawney",1,6,2,4,0
"chapstick",1,9,2,7,0
"pommard",1,7,2,5,0
"hoodies",1,7,4,3,0
"trask",1,5,1,4,0
"dutchwoman",1,10,3,7,0
"adipocerite",1,11,6,5,0
"protutorial",0,11,5,6,0
"ffless",0,6,1,5,0
"ancilla",1,7,3,4,0
"euskallonsburg",0,14,5,9,0
"fegrade",0,7,3,4,0
"nashoma",1,7,3,4,0
"simpregular",0,11,4,7,0
"postconsonantal",1,15,5,10,0
"naboberies",1,10,5,5,0
"nonethically",1,12,4,8,0
"coccygeal",1,9,3,6,0
"auran",0,5,3,2,0
"encarpus",1,8,3,5,0
"peucjswzvsnbnnjtnwv",0,19,2,17,0
"gujral",1,6,2,4,0
"fedykvyeajn",0,11,3,8,0
"unprecenturaenie",0,16,8,8,0
"writely",0,7,2,5,0
"ctenoy",0,6,2,4,0
"galetriggenmul",0,14,5,9,0
"lectrifying",0,11,3,8,0
"recalling",1,9,3,6,0
"trysail",1,7,2,5,0
"mimalntrenolvomistogerus",0,24,9,15,0
"nondifferentiable",1,17,7,10,0
"varicosity",1,10,4,6,0
"orthodox",1,8,3,5,0
"stronal",0,7,2,5,0
"sistency",1,8,2,6,0
"gettysburg",1,10,2,8,0
"spicebushes",1,11,4,7,0
"reviviscence",1,12,5,7,0
"vineyarder",1,10,4,6,0
"trobupropore",0,12,5,7,0
"inacceptableness",0,16,6,10,0
"nike",1,4,2,2,0
"cashablenesses",0,14,5,9,0
"hent",1,4,1,3,0
"augury",1,6,3,3,0
"overprisation",0,13,6,7,0
"groass",0,6,2,4,0
"dee",1,3,2,1,0
"antinaturally",1,13,5,8,0
"vinsneuryloephiks",0,17,6,11,0
"unkhablectillagofie",0,19,8,11,0
"chronograph",1,11,3,8,0
"backspacer",1,10,3,7,0
"cartetosis",0,10,4,6,0
"pseudomonadales",0,15,7,8,0
"mergees",1,7,3,4,0
"midwesterner",1,12,4,8,0
"lydidae",0,7,3,4,0
"flagraris",0,9,3,6,0
"pharmacopoeias",1,14,7,7,0
"interdevour",1,11,5,6,0
"jiglike",1,7,3,4,0
"ptfy",0,4,0,4,0
"noordbrabant",1,12,4,8,0
"hastraiser",0,10,4,6,0
"moonwasperoords",0,15,6,9,0
"isoetales",1,9,5,4,0
"misanthropically",1,16,5,11,0
"grmirusllinevebist",0,18,6,12,0
"unpoetical",1,10,5,5,0
"katsuwonidae",1,12,6,6,0
"lolium",1,6,3,3,0
"caefop",0,6,3,3,0
"reprimandingly",1,14,4,10,0
"yousuf",1,6,3,3,0
"dermen",0,6,2,4,0
"pawl",1,4,1,3,0
"trygve",1,6,1,5,0
"libvzicixbwdzizbp'xb",0,20,4,16,1
"spline",1,6,2,4,0
"todotaur",0,8,4,4,0
"normothermia",1,12,5,7,0
"'isxvokciq",0,10,3,7,1
"scareful",1,8,3,5,0
"anacareousness",0,14,7,7,0
"teleidophianism",0,15,7,8,0
"gnoseme",0,7,3,4,0
"kantappotaea",0,12,6,6,0
"mhn",0,3,0,3,0
"strepitantly",1,12,3,9,0
"tracheopharyngeal",1,17,6,11,0
"bethemiabatino",0,14,7,7,0
"descedaliancertia",0,17,8,9,0
"disrespecial",0,12,5,7,0
"shrie",0,5,2,3,0
"parsechatelet",0,13,5,8,0
"prurigos",1,8,3,5,0
"sprc",0,4,0,4,0
"digger",1,6,2,4,0
"neumayer",1,8,4,4,0
"maricolous",1,10,5,5,0
"vocondomest",0,11,4,7,0
"uralubbetemisqusthun",0,20,8,12,0
"pouldred",1,8,3,5,0
"etwite",1,6,3,3,0
"connemarielsonville",0,19,8,11,0
"dewilliny",0,9,3,6,0
"physiography",1,12,3,9,0
"ocellation",1,10,5,5,0
"spect",1,5,1,4,0
"gancensivitograph",0,17,6,11,0
"hriontas",0,8,3,5,0
"copurified",1,10,5,5,0
"dfrer",1,5,1,4,0
"kalasky",1,7,2,5,0
"skintia",0,7,3,4,0
"psychoneuroimmunologist",1,23,9,14,0
"a'oghiqaoggdtjkloxarezk'",0,24,8,16,2
"gretta",1,6,2,4,0
"semuncia",1,8,4,4,0
"slumberousness",1,14,5,9,0
"farthingles",0,11,3,8,0
"bizare",0,6,3,3,0
"infibulate",1,10,5,5,0
"scheock",0,7,2,5,0
"sahosporphonelli",0,16,6,10,0
"rampliste",0,9,3,6,0
"flancicuigacang",0,15,6,9,0
"harneen",1,7,3,4,0
"lemniscal",1,9,3,6,0
"semia",0,5,3,2,0
"villegiately",0,12,5,7,0
"ctansunghalcterangitheris",0,25,8,17,0
"colophon",1,8,3,5,0
"dawk",1,4,1,3,0
"scarlatti",1,9,3,6,0
"mauvais",0,7,4,3,0
"mfzhyqvednyo",0,12,2,10,0
"uoopuls",0,7,4,3,0
"aplysiidae",0,10,5,5,0
"ronope",0,6,3,3,0
"workship",1,8,2,6,0
"lightbulb",1,9,2,7,0
"missal",1,6,2,4,0
"jugsful",1,7,2,5,0
"medicamentally",1,14,5,9,0
"cararchium",0,10,4,6,0
"stous",0,5,2,3,0
"camorrista",1,10,4,6,0
"sanativeness",1,12,5,7,0
"jacone",0,6,3,3,0
"amen",1,4,2,2,0
"tailoress",1,9,4,5,0
"microbusses",1,11,4,7,0
"cataphrygianism",1,15,5,10,0
"scammonyroot",1,12,4,8,0
"unmemorably",1,11,4,7,0
"gqs'gkphmw'he'",0,14,1,13,3
"fnno'vazbqh",0,11,2,9,1
"atyzispelee",0,11,5,6,0
"hilts",1,5,1,4,0
"unamenableness",0,14,6,8,0
"discouragement",1,14,6,8,0
"uncreativeness",1,14,6,8,0
"defeminised",1,11,5,6,0
"jqvhhikjse'jxgbu",0,16,3,13,1
"wrxc",0,4,0,4,0
"cambrian",1,8,3,5,0
"impresser",1,9,3,6,0
"preassumed",1,10,4,6,0
"jiceite",0,7,4,3,0
"retic",0,5,2,3,0
"nasethmoid",1,10,4,6,0
"tracrateartarsly",0,16,5,11,0
"gracilariidae",1,13,7,6,0
"vacanthi",0,8,3,5,0
"natterers",1,9,3,6,0
"layerages",1,9,4,5,0
"palabrium",0,9,4,5,0
"strophote",0,9,3,6,0
"shnaps",1,6,1,5,0
"proteus",1,7,3,4,0
"esurient",1,8,4,4,0
"zoons",1,5,2,3,0
"cladio",0,6,3,3,0
"slimsiest",1,9,3,6,0
"ascophyllum",1,11,3,8,0
"meyerbeek",0,9,4,5,0
"displanolism",0,12,4,8,0
"psignics",0,8,2,6,0
"ngalitetysn",0,11,3,8,0
"eparterial",1,10,5,5,0
"divinyl",1,7,2,5,0
"hypocathexis",1,12,4,8,0
"jabbllaveatroniczlatam",0,22,8,14,0
"ecoute",1,6,4,2,0
"phurmmrhydarebimseluin",0,22,7,15,0
"nbakhoxeouqwem",0,14,6,8,0
"spectroheliogram",1,16,6,10,0
"unexcerptions",0,13,5,8,0
"misrepublico",0,12,5,7,0
"darreterium",0,11,5,6,0
"pdjxpyefgc",0,10,1,9,0
"ckesetrior",0,10,4,6,0
"seducer",1,7,3,4,0
"diorita",0,7,4,3,0
"fantasia",1,8,4,4,0
"devian",0,6,3,3,0
"dislinks",1,8,2,6,0
"cantled",1,7,2,5,0
"soot",1,4,2,2,0
"lowery",1,6,2,4,0
"fortifications",1,14,6,8,0
"incodes",0,7,3,4,0
"punicaceae",1,10,6,4,0
"boardings",1,9,3,6,0
"wickens",1,7,2,5,0
"epationatoriservisomitttness",0,28,12,16,0
"tornus",1,6,2,4,0
"delts",1,5,1,4,0
"sinctness",0,9,2,7,0
"aernichtirhoponti",0,17,7,10,0
"confusable",1,10,4,6,0
"bitudgeadolincelvals",0,20,8,12,0
"blackfigured",1,12,4,8,0
"priori",1,6,3,3,0
"literatophyte",0,13,5,8,0
"atura",0,5,3,2,0
"septicide",0,9,4,5,0
"waysvillotrevic",0,15,5,10,0
"roundhead",1,9,4,5,0
"blueball",1,8,3,5,0
"ciondagaured",0,12,6,6,0
"allayed",1,7,3,4,0
"taved",0,5,2,3,0
"panchomerish",0,12,4,8,0
"pou",0,3,2,1,0
"cajvt",0,5,1,4,0
"footdraggers",1,12,4,8,0
"abwebbis",0,8,3,5,0
"girdler",1,7,2,5,0
"probabilism",1,11,4,7,0
"sternonuchal",1,12,4,8,0
"chapeaus",1,8,4,4,0
"equiped",1,7,4,3,0
"jilgie",1,6,3,3,0
"phonaebigulopipang",0,18,8,10,0
"termagantish",1,12,4,8,0
"poked",1,5,2,3,0
"pondville",1,9,3,6,0
"cettola",0,7,3,4,0
"wearhy",0,6,2,4,0
"superabnormally",1,15,5,10,0
"phograp",0,7,2,5,0
"gatecrasher",1,11,4,7,0
"clywd",1,5,0,5,0
"lungis",1,6,2,4,0
"agemiaseticras",0,14,7,7,0
"etheful",0,7,3,4,0
"wampus",1,6,2,4,0
"marchical",0,9,3,6,0
"heysham",1,7,2,5,0
"improbities",1,11,5,6,0
"predom",0,6,2,4,0
"siler",1,5,2,3,0
"cpm",1,3,0,3,0
"unimpelled",1,10,4,6,0
"supersexualisation",0,18,9,9,0
"anticalliclinate",0,16,7,9,0
"degering",0,8,3,5,0
"necrotic",1,8,3,5,0
"misprovident",0,12,4,8,0
"catowhililvignattupatics",0,24,9,15,0
"wedgie",1,6,3,3,0
"latoid",0,6,3,3,0
"yommorkstaximoncrophis",0,22,7,15,0
"rounce",1,6,3,3,0
"trenchies",0,9,3,6,0
"pinonbernciation",0,16,7,9,0
"hanaparm",0,8,3,5,0
"detaerfelpoyspic",0,16,6,10,0
"unlette",0,7,3,4,0
"endometer",0,9,4,5,0
"uptrail",1,7,3,4,0
"coenures",1,8,4,4,0
"tagalo",1,6,3,3,0
"nonpurulent",1,11,4,7,0
"fantoddishness",0,14,4,10,0
"elasmobranchian",1,15,6,9,0
"shijiazhuang",1,12,5,7,0
"lareoidewabiddley're",0,20,9,11,1
"alang",1,5,2,3,0
"morphias",1,8,3,5,0
"rationalisable",1,14,7,7,0
"retina",1,6,3,3,0
"conneedness",0,11,4,7,0
"shoa",1,4,2,2,0
"dispassionate",1,13,6,7,0
"chargeship",1,10,3,7,0
"antonionally",0,12,5,7,0
"helminized",0,10,4,6,0
"mphanchtexemizichvifrndlardy",0,28,7,21,0
"bespecklement",1,13,4,9,0
"noncorresponds",0,14,4,10,0
"jammy",1,5,1,4,0
"ces",0,3,1,2,0
"auctary",0,7,3,4,0
"propylene",1,9,3,6,0
"frett",0,5,1,4,0
"gunpoint",1,8,3,5,0
"reinsertion",1,11,5,6,0
"american",1,8,4,4,0
"chisellings",1,11,3,8,0
"wynmjslqentpoxoejkmn",0,20,4,16,0
"stanislaw",1,9,3,6,0
"nxljetijkjybgmfy",0,16,2,14,0
"profanator",0,10,4,6,0
"drummies",0,8,3,5,0
"diniochawenas",0,13,6,7,0
"helsingkite",1,11,4,7,0
"pacolet",1,7,3,4,0
"iyrenetidest",0,12,5,7,0
"arthel",1,6,2,4,0
"nonsburth",0,9,2,7,0
"coproduct",1,9,3,6,0
"impracticipial",0,14,6,8,0
"becrush",1,7,2,5,0
"wriggling",1,9,2,7,0
"snowscape",1,9,3,6,0
"bipropellant",1,12,4,8,0
"mcrusin",0,7,2,5,0
"tithebook",1,9,4,5,0
"gellinesis",0,10,4,6,0
"cumbency",0,8,2,6,0
"anabaptist",1,10,4,6,0
"flaments",0,8,2,6,0
"quickerlitzier",0,14,6,8,0
"polychlorines",0,13,4,9,0
"stationman",1,10,4,6,0
"hyperoxidation",1,14,6,8,0
"obdckwzvs",0,9,1,8,0
"alkenhayn",0,9,3,6,0
"stirrers",1,8,2,6,0
"unodoriferously",1,15,7,8,0
"sebuikellingelisteole",0,21,10,11,0
"conchalynous",0,12,4,8,0
"feathlegenata",0,13,6,7,0
"gerbilloaing",0,12,5,7,0
"champshears",0,11,3,8,0
"perfervent",1,10,3,7,0
"cortadels",0,9,3,6,0
"quittederitposingt",0,18,7,11,0
"pine",1,4,2,2,0
"dunsermergraph",0,14,4,10,0
"cidoyriesmeos",0,13,6,7,0
"m'cymmqsrlzocmdqmkasj",0,21,2,19,1
"abulescence",0,11,5,6,0
"overmastering",1,13,5,8,0
"maeander",1,8,4,4,0
"ravioli",1,7,4,3,0
"yglysmnggueikfmvsmz'jcjfy'nk",0,28,3,25,2
"nacreins",0,8,3,5,0
"palmilobed",1,10,4,6,0
"tinervitiali",0,12,6,6,0
"overful",0,7,3,4,0
"boreace",0,7,4,3,0
"aphasmidia",1,10,5,5,0
"botchiation",0,11,5,6,0
"affrontee",1,9,4,5,0
"unwich",0,6,2,4,0
"biegnetisationally",0,18,8,10,0
"unrecognizing",0,13,5,8,0
"womeras",1,7,3,4,0
"hifidakerolan",0,13,6,7,0
"orefies",0,7,4,3,0
"xerostomia",1,10,5,5,0
"apostatises",1,11,5,6,0
"ethelicised",0,11,5,6,0
"ezskacmkveul",0,12,4,8,0
"lonesomes",1,9,4,5,0
"irrees",0,6,3,3,0
"bloodier",1,8,4,4,0
"exsiccator",1,10,4,6,0
"bromoacetaldehyde",0,17,7,10,0
"tollable",1,8,3,5,0
"julienite",0,9,5,4,0
"tipays",0,6,2,4,0
"dingdong",1,8,2,6,0
"pomology",1,8,3,5,0
"physalospora",1,12,4,8,0
"macrocin",0,8,3,5,0
"barolong",1,8,3,5,0
"chaircutto",0,10,4,6,0
"uture",0,5,3,2,0
"supraline",0,9,4,5,0
"scisotte",0,8,3,5,0
"qbom",0,4,1,3,0
"jadda",1,5,2,3,0
"octodecillionaire",0,17,9,8,0
"unpumicated",1,11,5,6,0
"pardo",1,5,2,3,0
"causeway",1,8,4,4,0
"snapshootied",0,12,5,7,0
"camisade",1,8,4,4,0
"unanatomical",0,12,6,6,0
"zqrrcicsyweatbui",0,16,5,11,0
"chokecoilabian",0,14,7,7,0
"neurygan",0,8,3,5,0
"haydlar",0,7,2,5,0
"seemliest",1,9,4,5,0
"hickwalls",1,9,2,7,0
"mydicoecta",0,10,4,6,0
"biliterelptionn",0,15,6,9,0
"noncontentious",1,14,6,8,0
"cornets",1,7,2,5,0
"palaeologist",0,12,6,6,0
"madisterium",1,11,5,6,0
"iswara",1,6,3,3,0
"plagiochusett",0,13,5,8,0
"loyd",1,4,1,3,0
"suboscigenic",0,12,5,7,0
"xoxbyjdycyumzctu",0,16,3,13,0
"temmoku",1,7,3,4,0
"gracelike",1,9,4,5,0
"phenothiazine",1,13,6,7,0
"magmulanjus",0,11,4,7,0
"bedulatopa",0,10,5,5,0
"rophytenexylarigh",0,17,5,12,0
"tachyphasias",1,12,4,8,0
"burgilinges",0,11,4,7,0
"poles",1,5,2,3,0
"loging",0,6,2,4,0
"marleight",0,9,3,6,0
"lugansk",1,7,2,5,0
"ambience",1,8,4,4,0
"availmen",0,8,4,4,0
"repeddling",1,10,3,7,0
"'vkbwsxmxosfmv",0,14,1,13,1
"whiskylin",0,9,2,7,0
"kura",1,4,2,2,0
"troped",1,6,2,4,0
"naphthalmouthe",0,14,5,9,0
"clairsden",0,9,3,6,0
"fhwcz'ucqetief",0,14,4,10,1
"nonnegligibly",1,13,4,9,0
"anablephamative",0,15,7,8,0
"khoumaini",1,9,5,4,0
"specialest",1,10,4,6,0
"atinles",0,7,3,4,0
"unanograsthose",0,14,6,8,0
"romancical",1,10,4,6,0
"abstain",1,7,3,4,0
"sacrilated",0,10,4,6,0
"blentralimpurs",0,14,4,10,0
"blatherskite",1,12,4,8,0
"dinative",0,8,4,4,0
"hypsometer",1,10,3,7,0
"overofficemax",0,13,6,7,0
"ticklely",1,8,2,6,0
"pate",1,4,2,2,0
"blackhanders",1,12,3,9,0
"crawdaddy",1,9,2,7,0
"declarant",1,9,3,6,0
"foreses",0,7,3,4,0
"invalette",0,9,4,5,0
"repolishednesses",0,16,6,10,0
"misapperclate",0,13,5,8,0
"manitoba",1,8,4,4,0
"paroemiologists",0,15,7,8,0
"overhaus",0,8,4,4,0
"cemen",0,5,2,3,0
"preunite",1,8,4,4,0
"mogravarylogic",0,14,5,9,0
"nankingese",1,10,4,6,0
"embern",0,6,2,4,0
"overregulatress",0,15,6,9,0
"urbanities",1,10,5,5,0
"xwylbublxzknkq",0,14,1,13,0
"ambomalant",0,10,4,6,0
"isosporides",0,11,5,6,0
"gectrothes",0,10,3,7,0
"wahabite",1,8,4,4,0
"adoptant",1,8,3,5,0
"punchromators",0,13,4,9,0
"noncolloid",1,10,4,6,0
"acclaimin",0,9,4,5,0
"monotrematous",1,13,6,7,0
"certa",0,5,2,3,0
"alvlmxvhrsesfqwoglmfxkcdz",0,25,3,22,0
"bblaphrircino",0,13,4,9,0
"glockened",0,9,3,6,0
"entrenchymotic",0,14,4,10,0
"veal",1,4,2,2,0
"girafano",1,8,4,4,0
"nymwegen",1,8,2,6,0
"chacma",1,6,2,4,0
"balantom",0,8,3,5,0
"accurpans",0,9,3,6,0
"chalaza",1,7,3,4,0
"interrogatives",1,14,6,8,0
"reddish",1,7,2,5,0
"aerobraked",1,10,5,5,0
"siophis",0,7,3,4,0
"ascrive",1,7,3,4,0
"icel",1,4,2,2,0
"rumal",1,5,2,3,0
"ejgbguulaevgomg",0,15,6,9,0
"slsbvfzpdat",0,11,1,10,0
"pseudopods",1,10,4,6,0
"clanton",1,7,2,5,0
"harveyizing",1,11,4,7,0
"recreator",1,9,4,5,0
"noncircumferentiate",0,19,8,11,0
"gecko",1,5,2,3,0
"hyetoonsolding",0,14,5,9,0
"pigeons",1,7,3,4,0
"rigling",1,7,2,5,0
"sestette",1,8,3,5,0
"deforesters",1,11,4,7,0
"ratification",1,12,6,6,0
"dously",0,6,2,4,0
"mussmannia",0,10,4,6,0
"scamphimacusis",0,14,5,9,0
"macrosynther",0,12,3,9,0
"roping",1,6,2,4,0
"umbreres",1,8,3,5,0
"twileloulylok",0,13,5,8,0
"hzlhmbmpghwoo'px'acfm",0,21,3,18,2
"brillianting",1,12,4,8,0
"pistermes",0,9,3,6,0
"twitched",1,8,2,6,0
"alunile",0,7,4,3,0
"mwykbov",0,7,1,6,0
"elders",1,6,2,4,0
"ecugmfa",0,7,3,4,0
"goniopholis",1,11,5,6,0
"thistrochroofishly",0,18,5,13,0
"hlewm",0,5,1,4,0
"leresedry",0,9,3,6,0
"adularescent",1,12,5,7,0
"cowpunch",1,8,2,6,0
"oxford",1,6,2,4,0
"westwards",1,9,2,7,0
"unmarierial",0,11,6,5,0
"ehvqvondhowkkayzxdip",0,20,5,15,0
"mastoncus",1,9,3,6,0
"annexation",1,10,5,5,0
"towziest",1,8,3,5,0
"aneides",1,7,4,3,0
"svewavppcycnhixetwfzgpqb",0,24,4,20,0
"cachunderlandes",0,15,5,10,0
"hangasi",0,7,3,4,0
"behaviouristic",1,14,7,7,0
"costispinal",1,11,4,7,0
"cracow",1,6,2,4,0
"kecksies",1,8,3,5,0
"intradosed",0,10,4,6,0
"misgigs",0,7,2,5,0
"ortlers",0,7,2,5,0
"requested",1,9,4,5,0
"fle",0,3,1,2,0
"pioners",1,7,3,4,0
"borawpistolosiacastes",0,21,9,12,0
"wideboard",0,9,4,5,0
"okohingerlorutounabetuse",0,24,12,12,0
"ovoplasticised",0,14,6,8,0
"beri",1,4,2,2,0
"wrimple",1,7,2,5,0
"misgovernor",1,11,4,7,0
"gangrels",1,8,2,6,0
"tagalo",1,6,3,3,0
"protoctist",1,10,3,7,0
"revna",0,5,2,3,0
"tastevins",1,9,3,6,0
"administrascarfarm",0,18,6,12,0
"jaquintly",0,9,3,6,0
"morrhuas",1,8,3,5,0
"bpreyqgqamndzyw'g'zfxvq",0,23,2,21,2
"pepeduct",0,8,3,5,0
"inactual",0,8,4,4,0
"lynsey",1,6,1,5,0
"coulometries",1,12,6,6,0
"ctoc",0,4,1,3,0
"tard",0,4,1,3,0
"langshans",1,9,2,7,0
"dopocehoconelolopomperd",0,23,10,13,0
"catherwood",1,10,4,6,0
"toxoplasmata",0,12,5,7,0
"raruroiosem",0,11,6,5,0
"sunkland",1,8,2,6,0
"hematosalpinx",1,13,5,8,0
"cephaloplegia",1,13,6,7,0
"hoppercar",1,9,3,6,0
"flancritest",0,11,3,8,0
"gantenes",0,8,3,5,0
"bowness",0,7,2,5,0
"gelseminine",1,11,5,6,0
"codachaboon",0,11,5,6,0
"reide",0,5,3,2,0
"bellerophontes",1,14,5,9,0
"bill",1,4,1,3,0
"discrimina",0,10,4,6,0
"agonising",1,9,4,5,0
"psalmic",1,7,2,5,0
"vitrifactures",1,13,5,8,0
"rodi",1,4,2,2,0
"miscredits",1,10,3,7,0
"stichid",1,7,2,5,0
"caviller",1,8,3,5,0
"deaden",1,6,3,3,0
"reclinants",0,10,3,7,0
"cornta",0,6,2,4,0
"tuixmnjklxrpxuhyppmsz",0,21,3,18,0
"enaces",0,6,3,3,0
"uyng",0,4,1,3,0
"noncomplacency",1,14,4,10,0
"binomial",1,8,4,4,0
"sowlth",1,6,1,5,0
"cyclopteroid",1,12,4,8,0
"tylerton",1,8,2,6,0
"leopardbane",1,11,5,6,0
"patella",1,7,3,4,0
"cleveland",1,9,3,6,0
"anterrisscrolino",0,16,6,10,0
"trophoplasms",1,12,3,9,0
"angly",0,5,1,4,0
"ovant",1,5,2,3,0
"malechotanculaspagra",0,20,8,12,0
"symbolised",1,10,3,7,0
"ixboevyoznopdf",0,14,5,9,0
"tornithiformes",0,14,5,9,0
"miserables",1,10,4,6,0
"unins",0,5,2,3,0
"lovelard",0,8,3,5,0
"topmakers",1,9,3,6,0
"matias",1,6,3,3,0
"walach",1,6,2,4,0
"astilbe",1,7,3,4,0
"vevb",0,4,1,3,0
"vhclnsnnpgxadhmqgdph'xxth",0,25,1,24,1
"stilu",1,5,2,3,0
"galibi",1,6,3,3,0
"catalogue",1,9,5,4,0
"basanite",1,8,4,4,0
"interconvention",0,15,6,9,0
"carried",1,7,3,4,0
"ntrngs",0,6,0,6,0
"tyburnian",1,9,3,6,0
"mentogyraily",0,12,4,8,0
"rgpaullec'",0,10,3,7,1
"priouslavour",0,12,6,6,0
"horsewhipped",1,12,4,8,0
"analbuminemia",1,13,7,6,0
"colliquativeness",1,16,7,9,0
"conelonceerfledyigiosiudate",0,27,13,14,0
"mabieond",0,8,4,4,0
"eysekxcf",0,8,2,6,0
"iyar",1,4,2,2,0
"subcash",1,7,2,5,0
"rtmoqepyrgrlbjgawp",0,18,3,15,0
"nartjies",1,8,3,5,0
"prethreadworsaktyles",0,20,6,14,0
"anence",0,6,3,3,0
"apokatastasis",1,13,6,7,0
"eventrictiven",0,13,5,8,0
"honolulan",1,9,4,5,0
"lole",1,4,2,2,0
"morin",1,5,2,3,0
"aprets",0,6,2,4,0
"venfopooslasicyme",0,17,7,10,0
"uneschewed",1,10,4,6,0
"blackleg",1,8,2,6,0
"fetlocolans",0,11,4,7,0
"needfires",1,9,4,5,0
"scrimmage",1,9,3,6,0
"archeus",1,7,3,4,0
"percherigrawing",0,15,5,10,0
"peripherocystopulmonickers",0,26,9,17,0
"yukio",1,5,3,2,0
"hypoploidicals",0,14,5,9,0
"hindoo",1,6,3,3,0
"cabinties",0,9,4,5,0
"chapelize",1,9,4,5,0
"gaslighting",1,11,3,8,0
"anticlastic",1,11,4,7,0
"dustus",0,6,2,4,0
"sconchoscopical",0,15,5,10,0
"cies",0,4,2,2,0
"oesophagism",1,11,5,6,0
"ramosity",1,8,3,5,0
"brelymom",0,8,2,6,0
"apporet",0,7,3,4,0
"aerancepta",0,10,5,5,0
"peonage",1,7,4,3,0
"interinvolved",1,13,5,8,0
"a'wvnmljxqfcyex",0,15,2,13,1
"chanencereunicalytreadesmillectockling",0,38,14,24,0
"cumulate",1,8,4,4,0
"unretrograded",1,13,5,8,0
"claes",1,5,2,3,0
"transparency",1,12,3,9,0
"bankia",1,6,3,3,0
"anear",1,5,3,2,0
"syvers",1,6,1,5,0
"kthira",1,6,2,4,0
"lanarkshire",1,11,4,7,0
"atheimes",0,8,4,4,0
"condensation",1,12,5,7,0
"flagonet",1,8,3,5,0
"ramqjjmmiseewvncubf",0,19,5,14,0
"mamises",0,7,3,4,0
"volitational",1,12,6,6,0
"overattention",1,13,6,7,0
"pistableawretted",0,16,6,10,0
"huatimpatrkeril",0,15,6,9,0
"buff",1,4,1,3,0
"jejunostomy",1,11,4,7,0
"outbannerous",0,12,6,6,0
"undismayedness",0,14,5,9,0
"fratchiks",0,9,2,7,0
"farlike",0,7,3,4,0
"caritta",1,7,3,4,0
"quirksomeness",0,13,5,8,0
"ptoc",0,4,1,3,0
"uzsnsesqfqaxtkclzxmxzvais",0,25,5,20,0
"diels",1,5,2,3,0
"cornflake",1,9,3,6,0
"smithianism",1,11,4,7,0
"xiongnu",1,7,3,4,0
"pseudoculturally",1,16,6,10,0
"parger",0,6,2,4,0
"lectra",1,6,2,4,0
"phthalanilic",1,12,4,8,0
"hypotypic",1,9,2,7,0
"gripsack",1,8,2,6,0
"hypnopelandroclity",0,18,5,13,0
"helder",1,6,2,4,0
"mertow",0,6,2,4,0
"dolichosaurus",1,13,6,7,0
"pentuatcating",0,13,5,8,0
"compares",1,8,3,5,0
"wadjcmryiqtgkdfasyqh",0,20,3,17,0
"hasms",0,5,1,4,0
"latifactiauts",0,13,6,7,0
"lphevvlwqb'lxbnpgmnlev'",0,23,2,21,2
"annonopal",0,9,4,5,0
"ranitta",1,7,3,4,0
"subpackall",0,10,3,7,0
"cated",0,5,2,3,0
"series",1,6,3,3,0
"aradanchemioria",0,15,8,7,0
"carousal",1,8,4,4,0
"zirams",1,6,2,4,0
"gmignicleerudrcicry",0,19,6,13,0
"prer",0,4,1,3,0
"crossingly",0,10,2,8,0
"lumbashelinks",0,13,4,9,0
"myroffs",0,7,1,6,0
"hiromedusae",0,11,6,5,0
"polioencephalomyelitis",1,22,10,12,0
"diorrotedae",0,11,6,5,0
"quinzieme",1,9,5,4,0
"thirting",0,8,2,6,0
"rediscommodem",0,13,5,8,0
"bjzxmbagcmiqyvtzpo'ruqhboybm",0,28,5,23,1
"psorosperm",1,10,3,7,0
"paced",1,5,2,3,0
"unacclaimate",1,12,6,6,0
"ossietzky",1,9,3,6,0
"molybdoparathyrohyoidal",0,23,8,15,0
"crs",1,3,0,3,0
"thysanopteri",0,12,4,8,0
"diallists",1,9,3,6,0
"precisive",1,9,4,5,0
"faoence",1,7,4,3,0
"couchantly",1,10,3,7,0
"waramakerioneorevity",0,20,10,10,0
"supercutaneously",0,16,7,9,0
"balletenauctismonand",0,20,8,12,0
"dbr",0,3,0,3,0
"wfcjotnpee",0,10,3,7,0
"leqz",0,4,1,3,0
"lsgjosybql",0,10,1,9,0
"ftxuxzpxrwhttiput",0,17,3,14,0
"respirableness",1,14,5,9,0
"nerved",1,6,2,4,0
"lpcdf",1,5,0,5,0
"brocatello",1,10,4,6,0
"moskonfyt",1,9,2,7,0
"staiths",1,7,2,5,0
"fulman",0,6,2,4,0
"karlis",1,6,2,4,0
"phasiastere",0,11,5,6,0
"perilless",1,9,3,6,0
"exonerating",1,11,5,6,0
"rijeka",1,6,3,3,0
"trailles",0,8,3,5,0
"lffrstan",0,8,1,7,0
"moan",1,4,2,2,0
"grquin",0,6,2,4,0
"revestiaristocraticness",0,23,9,14,0
"presenter",1,9,3,6,0
"vjatprzuuegykdpzdnsauun",0,23,7,16,0
"nespelem",1,8,3,5,0
"nikkel",0,6,2,4,0
"deptioneurochaerided",0,20,10,10,0
"lief",1,4,2,2,0
"kaff",0,4,1,3,0
"psycholinguistics",1,17,5,12,0
"allurer",1,7,3,4,0
"gamblers",1,8,2,6,0
"ticker",1,6,2,4,0
"symbolising",1,11,3,8,0
"weissuasoy",0,10,5,5,0
"zippo",1,5,2,3,0
"advisable",1,9,4,5,0
"erinaceus",1,9,5,4,0
"forbysening",1,11,3,8,0
"polytric",0,8,2,6,0
"demiglossa",0,10,4,6,0
"dispostexises",0,13,5,8,0
"preremoval",1,10,4,6,0
"planies",0,7,3,4,0
"hemkbutsydcrxxrfk'globyo",0,24,4,20,1
"maccabees",1,9,4,5,0
"subdie",1,6,3,3,0
"chaitya",1,7,3,4,0
"indn",1,4,1,3,0
"'dcrbjsgdl'dfmwn",0,16,0,16,2
"rigmaroles",1,10,4,6,0
"ambage",1,6,3,3,0
"murrey",1,6,2,4,0
"lieut",1,5,3,2,0
"zqajrcxtgw",0,10,1,9,0
"macroconia",0,10,5,5,0
"arcadians",1,9,4,5,0
"ophthalmorrhexis",1,16,5,11,0
"mantnitable",0,11,4,7,0
"graduated",1,9,4,5,0
"unnameableness",1,14,6,8,0
"silkwagginardablenessnesses",0,27,9,18,0
"sicknesses",1,10,3,7,0
"tere",0,4,2,2,0
"joacimah",1,8,4,4,0
"reshenter",0,9,3,6,0
"hu",1,2,1,1,0
"coinin",0,6,3,3,0
"mantaddie",0,9,4,5,0
"recropella",0,10,4,6,0
"hymenomycetous",1,14,5,9,0
"brakeroot",1,9,4,5,0
"emissi",1,6,3,3,0
"troia",1,5,3,2,0
"chatscoratloulomnalele",0,22,9,13,0
"chawia",1,6,3,3,0
"afforestages",0,12,5,7,0
"farthingsworth",1,14,3,11,0
"spoilage",1,8,4,4,0
"hrakical",0,8,3,5,0
"semidifference",1,14,6,8,0
"cattalievestaks",0,15,6,9,0
"rimshone",0,8,3,5,0
"waxflower",1,9,3,6,0
"morna",1,5,2,3,0
"knoblick",1,8,2,6,0
"flourtyard",0,10,3,7,0
"faenas",1,6,3,3,0
"frau",1,4,2,2,0
"predeclare",1,10,4,6,0
"idkzay'",0,7,2,5,1
"marvella",1,8,3,5,0
"disregardless",1,13,4,9,0
"sporozoid",1,9,4,5,0
"vipathier",0,9,4,5,0
"scence",0,6,2,4,0
"scesarallfocket",0,15,5,10,0
"und",0,3,1,2,0
"ashurbanipal",1,12,5,7,0
"markomaticalite",0,15,7,8,0
"rebaiting",1,9,4,5,0
"collodiochloride",1,16,7,9,0
"measle",1,6,3,3,0
"prepensing",1,10,3,7,0
"xanthochroias",1,13,5,8,0
"gravery",1,7,2,5,0
"estoile",1,7,4,3,0
"presterna",1,9,3,6,0
"nomographical",1,13,5,8,0
"lism",0,4,1,3,0
"wosvialietrenid",0,15,7,8,0
"prep",0,4,1,3,0
"dostoevskian",1,12,5,7,0
"given",1,5,2,3,0
"subsequent",1,10,4,6,0
"undiostersess",0,13,5,8,0
"tennuns",0,7,2,5,0
"thyptinsciants",0,14,3,11,0
"hopleanindly",0,12,4,8,0
"unsenses",1,8,3,5,0
"helmsman",1,8,2,6,0
"cuscoverranelectuae",0,19,9,10,0
"cryocauleanism",0,14,6,8,0
"arrenotokous",1,12,6,6,0
"graces",1,6,2,4,0
"hidders",1,7,2,5,0
"interdeputative",0,15,7,8,0
"greekess",1,8,3,5,0
"synura",1,6,2,4,0
"farhatod",0,8,3,5,0
"trigonometer",1,12,5,7,0
"elucidators",1,11,5,6,0
"roneidves",0,9,4,5,0
"boronia",1,7,4,3,0
"'cqw",0,4,0,4,1
"loloisterer",0,11,5,6,0
"papilio",1,7,4,3,0
"forgetfulnesses",1,15,5,10,0
"dviong",0,6,2,4,0
"amiantievolutionalness",0,22,11,11,0
"yciheaikznuc",0,12,5,7,0
"hissculzpice",0,12,4,8,0
"pwhaqlbozlmrhpwtsi",0,18,3,15,0
"luxemburger",1,11,4,7,0
"ferrochrome",1,11,4,7,0
"nonauricular",1,12,6,6,0
"stegocephalian",1,14,6,8,0
"ckns",0,4,0,4,0
"ostrya",1,6,2,4,0
"ichannell",0,9,3,6,0
"utiterdecestdosed",0,17,7,10,0
"hippoboscages",0,13,5,8,0
"tudgistawayste'ligazatoweenesslingionknes",0,41,16,25,1
"forefeel",1,8,4,4,0
"polygonales",1,11,4,7,0
"deformalizes",1,12,5,7,0
"taddsentreugh",0,13,4,9,0
"carrow",0,6,2,4,0
"cobol",1,5,2,3,0
"ppertinthelemalnghibutimine",0,27,10,17,0
"lithochromies",1,13,5,8,0
"equitableness",1,13,6,7,0
"gptuyeduph",0,10,3,7,0
"rolfraic",0,8,3,5,0
"puntaritius",0,11,5,6,0
"lorationsis",0,11,5,6,0
"jrsozn''oijkfy'q",0,16,3,13,3
"anglophile",1,10,4,6,0
"jswqwuugtlrywawy",0,16,3,13,0
"priong",0,6,2,4,0
"aggri",1,5,2,3,0
"eroagedy",0,8,4,4,0
"tnindhin",0,8,2,6,0
"lobelines",1,9,4,5,0
"wnnefy",0,6,1,5,0
"jillsburg",0,9,2,7,0
"mayos",1,5,2,3,0
"dinics",1,6,2,4,0
"unaking",1,7,3,4,0
"outweeps",1,8,4,4,0
"sonnie",1,6,3,3,0
"baldachini",1,10,4,6,0
"marionets",0,9,4,5,0
"moviedom",1,8,4,4,0
"tirled",1,6,2,4,0
"nauguace",0,8,5,3,0
"ravigator",0,9,4,5,0
"catiosses",0,9,4,5,0
"animatism",1,9,4,5,0
"dontamwood",0,10,4,6,0
"preformationist",1,15,6,9,0
"palestinian",1,11,5,6,0
"prescience",1,10,4,6,0
"joannes",1,7,3,4,0
"stulm",1,5,1,4,0
"pleusshrirfbxwlgrkfccovw",0,24,4,20,0
"jrcmpuzddzmomaqyk'n",0,19,3,16,1
"quinolinyl",1,10,4,6,0
"overattached",1,12,5,7,0
"grbw'",0,5,0,5,1
"ceteracy",0,8,3,5,0
"acanthracitation",0,16,7,9,0
"pukobincodostisederna",0,21,9,12,0
"limeteorollegorical",0,19,9,10,0
"unaxes",0,6,3,3,0
"bowsings",0,8,2,6,0
"chorizontic",1,11,4,7,0
"nateed",0,6,3,3,0
"logoff",1,6,2,4,0
"moorgate",1,8,4,4,0
"bspe",1,4,1,3,0
"circumductive",0,13,5,8,0
"if'vek'uqhxgvrjfbyia",0,20,5,15,2
"mzgikfnalhafe",0,13,4,9,0
"tfyctjyevu",0,10,2,8,0
"fragmentatively",0,15,5,10,0
"decanthocus",0,11,4,7,0
"leptin",1,6,2,4,0
"clamper",1,7,2,5,0
"sphate",0,6,2,4,0
"antifier",0,8,4,4,0
"deaerator",1,9,5,4,0
"constatations",1,13,5,8,0
"immanus",0,7,3,4,0
"glzbmuhotkgrw",0,13,2,11,0
"engers",0,6,2,4,0
"plummlersavicincormellangly",0,27,8,19,0
"apdu",1,4,2,2,0
"ploughwright",1,12,3,9,0
"nolynescsarbrvydaugeetemas",0,26,9,17,0
"misgrades",1,9,3,6,0
"officialisation",1,15,8,7,0
"lavalava",1,8,4,4,0
"jesuist",1,7,3,4,0
"microlithiformed",0,16,6,10,0
"fugally",1,7,2,5,0
"crowliegermist",0,14,5,9,0
"roundo",1,6,3,3,0
"frigots",1,7,2,5,0
"sollicker",1,9,3,6,0
"biosa",0,5,3,2,0
"nium",0,4,2,2,0
"nonnarrative",1,12,5,7,0
"petrea",1,6,3,3,0
"trauner",1,7,3,4,0
"fishbein",1,8,3,5,0
"acks",0,4,1,3,0
"crucidslucla",0,12,4,8,0
"demantoid",1,9,4,5,0
"nonpassionate",1,13,6,7,0
"hamamelidaceous",1,15,8,7,0
"orseille",1,8,4,4,0
"ovaj",0,4,2,2,0
"metaphysical",1,12,4,8,0
"preconcertedness",1,16,5,11,0
"becarpeting",1,11,4,7,0
"rexis",0,5,2,3,0
"yahwe",1,5,2,3,0
"yaobabbitterelacensonabsoluto",0,29,13,16,0
"microphagocytical",0,17,6,11,0
"halalithuses",0,12,5,7,0
"musnudger",0,9,3,6,0
"lairdsville",1,11,4,7,0
"apostolian",1,10,5,5,0
"rmeyes",0,6,2,4,0
"anticommercialist",1,17,7,10,0
"austin",1,6,3,3,0
"overfastidiously",1,16,7,9,0
"prevising",1,9,3,6,0
"rapidest",1,8,3,5,0
"cantoris",1,8,3,5,0
"enjambements",1,12,4,8,0
"immering",0,8,3,5,0
"tous",0,4,2,2,0
"rtonctis",0,8,2,6,0
"maguayulette",0,12,6,6,0
"tprdzlqaf'geohmirugwhs'xvlbvk",0,29,5,24,2
"syrets",0,6,1,5,0
"coryphee",1,8,3,5,0
"ovellectionsprians",0,18,7,11,0
"barrette",1,8,3,5,0
"fendillate",1,10,4,6,0
"glacialist",1,10,4,6,0
"douglassful",0,11,4,7,0
"plc",1,3,0,3,0
"nonlacteous",1,11,5,6,0
"oneillin",0,8,4,4,0
"laria",1,5,3,2,0
"reemergent",1,10,4,6,0
"visualising",1,11,5,6,0
"parly",1,5,1,4,0
"hyalinisation",1,13,6,7,0
"carbureted",1,10,4,6,0
"dijkstra",1,8,2,6,0
"gimpion",0,7,3,4,0
"sarto",1,5,2,3,0
"hirundinidae",1,12,6,6,0
"glucosia",0,8,4,4,0
"preacesciny",0,11,4,7,0
"eyeleting",1,9,4,5,0
"kepu",0,4,2,2,0
"zene",0,4,2,2,0
"adiarceammasunverst",0,19,8,11,0
"clericalist",1,11,4,7,0
"anebiss",0,7,3,4,0
"sunbaubolaylyr",0,14,5,9,0
"pyrrhalf",0,8,1,7,0
"seless",0,6,2,4,0
"onolv",0,5,2,3,0
"mealworm",1,8,3,5,0
"honamecolemy",0,12,5,7,0
"buchloe",1,7,3,4,0
"heliolitidae",1,12,7,5,0
"telekiness",0,10,4,6,0
"hydroxides",1,10,3,7,0
"butchering",1,10,3,7,0
"lgajcfndeeskmafeflfbq'dkh",0,25,5,20,1
"overbuilds",1,10,4,6,0
"antenatally",1,11,4,7,0
"xafogdfoetpilypi'lskys",0,22,6,16,1
"crinanqugrs",0,11,3,8,0
"xrjdhemrrfugiq''",0,16,3,13,2
"ctenodont",1,9,3,6,0
"vascernes",0,9,3,6,0
"restrains",1,9,3,6,0
"latshealy",0,9,3,6,0
"clerodac",0,8,3,5,0
"acina",0,5,3,2,0
"picofarad",1,9,4,5,0
"kindleman",0,9,3,6,0
"uranoscope",1,10,5,5,0
"silvan",1,6,2,4,0
"gambreled",1,9,3,6,0
"telepiser",0,9,4,5,0
"unfruitfulness",1,14,5,9,0
"bg",1,2,0,2,0
"shoer",1,5,2,3,0
"sesquisextal",1,12,5,7,0
"liniment",1,8,3,5,0
"pselar",0,6,2,4,0
"beelol",1,6,3,3,0
"hppuqxjmgutamofypglfhtdrfyehlj",0,30,5,25,0
"clansman",1,8,2,6,0
"chies",0,5,2,3,0
"mithraist",1,9,3,6,0
"farcer",1,6,2,4,0
"hootling",0,8,3,5,0
"amnio",1,5,3,2,0
"overshowering",1,13,5,8,0
"octocoralline",1,13,6,7,0
"scilithol",0,9,3,6,0
"kxpljmhwpfvy'bweqn",0,18,1,17,1
"polk",1,4,1,3,0
"therdivlonst",0,12,3,9,0
"quaal",0,5,3,2,0
"jzgzkglda'ozhrwy",0,16,2,14,1
"qgkynzgwr'jrra",0,14,1,13,1
"cully",1,5,1,4,0
"indentureship",1,13,5,8,0
"thjatsi",1,7,2,5,0
"homalgenes",0,10,4,6,0
"elevated",1,8,4,4,0
"subsence",0,8,3,5,0
"syzygial",1,8,2,6,0
"shipman",1,7,2,5,0
"abstractionisms",1,15,5,10,0
"nonconculiacyte",0,15,6,9,0
"cleares",0,7,3,4,0
"mixicky",0,7,2,5,0
"compromisee",0,11,5,6,0
"dysphenograph",0,13,3,10,0
"sense",1,5,2,3,0
"ety",0,3,1,2,0
"buwkifhfstjg'qoevvgmylkch",0,25,4,21,1
"paratheas",0,9,4,5,0
"mixednesses",1,11,4,7,0
"kdzw'qfbbg",0,10,0,10,1
"stenobly",0,8,2,6,0
"tinding",1,7,2,5,0
"vh'peuqnrrhhapck",0,16,3,13,1
"exopterygidae",0,13,6,7,0
"faucers",0,7,3,4,0
"tailly",0,6,2,4,0
"unsconne",0,8,3,5,0
"rnzgipqze'vmqaovunda",0,20,6,14,1
"oaduistoury",0,11,6,5,0
"ngrssmul",0,8,1,7,0
"dise",0,4,2,2,0
"temedigeespational",0,18,9,9,0
"dophic",0,6,2,4,0
"varembe",0,7,3,4,0
"hamanly",0,7,2,5,0
"bxzlu'odyvuihiumjs",0,18,6,12,1
"rockholmeter",0,12,4,8,0
"ferth",1,5,1,4,0
"proration",1,9,4,5,0
"chiller",1,7,2,5,0
"preiser",1,7,3,4,0
"schismatised",1,12,4,8,0
"corabella",1,9,4,5,0
"bzf'p'fxdp'ivjpicoqo",0,20,4,16,3
"chinnam",1,7,2,5,0
"cameis",0,6,3,3,0
"segainnemopterionoid",0,20,10,10,0
"octose",1,6,3,3,0
"dq",1,2,0,2,0
"synding",1,7,1,6,0
"kejdczkuaflrxibsuallhha",0,23,7,16,0
"ymtvdopfvbnckuh",0,15,2,13,0
"umpirages",1,9,4,5,0
"bukehunathra",0,12,5,7,0
"enas",0,4,2,2,0
"fluors",1,6,2,4,0
"marris",1,6,2,4,0
"dermatothertone",0,15,6,9,0
"hlsietin",0,8,3,5,0
"mayor",1,5,2,3,0
"polyaxial",1,9,4,5,0
"spallings",1,9,2,7,0
"upcurledly",0,10,3,7,0
"motif",1,5,2,3,0
"uctdqroomc",0,10,3,7,0
"ohioan",1,6,4,2,0
"prao",1,4,2,2,0
"tecouaneses",0,11,6,5,0
"overdistance",1,12,5,7,0
"linendraper",1,11,4,7,0
"blileowas",0,9,4,5,0
"wedpbzxjunrcjzhnlkuepoqm",0,24,5,19,0
"snaking",1,7,2,5,0
"hawkeye",1,7,3,4,0
"ensbelleceil",0,12,5,7,0
"alveary",1,7,3,4,0
"loganton",1,8,3,5,0
"fornix",1,6,2,4,0
"greasiness",1,10,4,6,0
"hebraicise",1,10,5,5,0
"woodstock",1,9,3,6,0
"iodinophilia",0,12,7,5,0
"legitime",1,8,4,4,0
"magisteriums",1,12,5,7,0
"unobligative",1,12,6,6,0
"wlqhihozkwjpjrl'",0,16,2,14,1
"aphalate",0,8,4,4,0
"melotragic",1,10,4,6,0
"bohme",1,5,2,3,0
"paterson",1,8,3,5,0
"gongology",0,9,3,6,0
"quatrin",1,7,3,4,0
"poneramoeba",1,11,6,5,0
"adele",1,5,3,2,0
"uncart",1,6,2,4,0
"klestintine",0,11,4,7,0
"forintegrange",0,13,5,8,0
"quadrinomial",1,12,6,6,0
"upbrast",1,7,2,5,0
"centimana",0,9,4,5,0
"allians",0,7,3,4,0
"rearbrus",0,8,3,5,0
"secretest",1,9,3,6,0
"unthinning",1,10,3,7,0
"mspithpzzvvrh",0,13,1,12,0
"unavertable",1,11,5,6,0
"odourlessness",0,13,5,8,0
"gopvsbcblggk'qtfohdabexg",0,24,4,20,1
"autobacterio",0,12,7,5,0
"cephalaspis",1,11,4,7,0
"goner",1,5,2,3,0
"fahypatowissorisckaincagntht",0,28,9,19,0
"laulau",1,6,4,2,0
"ophthalmia",1,10,4,6,0
"ter",0,3,1,2,0
"titanesque",1,10,5,5,0
"falky",0,5,1,4,0
"gwpyqbqrdbktcvflnagpk",0,21,1,20,0
"bekallawinotration",0,18,8,10,0
"cvr",1,3,0,3,0
"sellbacks",1,9,2,7,0
"sternberg",1,9,2,7,0
"preevolutionist",1,15,7,8,0
"epirus",1,6,3,3,0
"qozshhm''im",0,11,2,9,2
"myography",1,9,2,7,0
"ctictes",0,7,2,5,0
"eskishehir",1,10,4,6,0
"ginn",1,4,1,3,0
"gaedelia",0,8,5,3,0
"malive",0,6,3,3,0
"theorematic",1,11,5,6,0
"palip",0,5,2,3,0
"swifters",1,8,2,6,0
"premolarisa",0,11,5,6,0
"foreductorly",0,12,4,8,0
"kyrbxcoptcvxzkeyjrnryda'dsl",0,27,3,24,1
"scatterpunctuate",0,16,6,10,0
"unsensitiveness",0,15,6,9,0
"dyssyner",0,8,1,7,0
"unchristochondroid",0,18,6,12,0
"laodicea",1,8,5,3,0
"unconfutations",0,14,6,8,0
"defless",0,7,2,5,0
"balemyorforynzirtieconglifiscaroveurenedd",0,41,16,25,0
"mesiestle",0,9,4,5,0
"sleepover",1,9,4,5,0
"zimmerman",1,9,3,6,0
"eraxitidghe",0,11,5,6,0
"caling",0,6,2,4,0
"funinarinatetugummarodrrce",0,26,11,15,0
"wentzville",1,10,3,7,0
"plotinize",1,9,4,5,0
"broot",0,5,2,3,0
"hycupidromaldaibialayring",0,25,10,15,0
"chaule",1,6,3,3,0
"maunobna",0,8,4,4,0
"spectroheliograph",1,17,6,11,0
"supzzrkwmx'ri",0,13,2,11,1
"funinenvegmero",0,14,6,8,0
"xtej",0,4,1,3,0
"reunites",1,8,4,4,0
"ibrinally",0,9,3,6,0
"gapingly",1,8,2,6,0
"isodef",1,6,3,3,0
"redamn",0,6,2,4,0
"inviability",1,11,5,6,0
"unparaded",1,9,4,5,0
"plumpf",0,6,1,5,0
"ueausdfjscixbpmbkisqkb'",0,23,6,17,1
"uuyilojdoojs",0,12,6,6,0
"unacceptant",1,11,4,7,0
"reattributional",0,15,7,8,0
"unresearchaeophobia",0,19,10,9,0
"xylomelum",1,9,3,6,0
"qulmqcmflo'ehgrbajr",0,19,4,15,1
"engird",1,6,2,4,0
"xfixdgufvwqdfldmuixzm",0,21,4,17,0
"aromatherapies",1,14,7,7,0
"iulidae",0,7,5,2,0
"electrostaticovesical",0,21,9,12,0
"outcompletely",0,13,5,8,0
"ccexyx",0,6,1,5,0
"terebinthus",1,11,4,7,0
"choth",0,5,1,4,0
"ejupollll",0,9,3,6,0
"gbgluzfyf'kv",0,12,1,11,1
"adsorbed",1,8,3,5,0
"himora",0,6,3,3,0
"izcates",0,7,3,4,0
"ura",0,3,2,1,0
"quadrinucleate",1,14,7,7,0
"oalonachinghycaswes",0,19,7,12,0
"phyte",0,5,1,4,0
"haersprinifermerhermeoitato",0,27,12,15,0
"unmasker",1,8,3,5,0
"inspirometry",0,12,4,8,0
"pzzevgeewnaqaxstduop",0,20,7,13,0
"dinnidechlcele",0,14,5,9,0
"taighthooles",0,12,5,7,0
"bograpotrocomenismargishroin",0,28,11,17,0
"xyodcurbyhcvy",0,13,2,11,0
"cousing",0,7,3,4,0
"vetipjyzdmeifmwydvyeban",0,23,6,17,0
"ointness",0,8,3,5,0
"teda",1,4,2,2,0
"briggs",1,6,1,5,0
"arales",1,6,3,3,0
"underbushing",1,12,4,8,0
"semimamidstrousingly",0,20,7,13,0
"petals",1,6,2,4,0
"unback",0,6,2,4,0
"underareadipstergee",0,19,9,10,0
"seed",1,4,2,2,0
"antetype",1,8,3,5,0
"wassyngton",1,10,2,8,0
"zanetinmitetinchwgatellinthantroncotresicerw",0,44,15,29,0
"guardist",0,8,3,5,0
"slinc",0,5,1,4,0
"c'uqnmotbavkxjxysppuv",0,21,4,17,1
"mlsshad",0,7,1,6,0
"pachophaniflupulogistondermasivowpereowe",0,40,17,23,0
"heny",0,4,1,3,0
"paysagist",1,9,3,6,0
"nonchopelverles",0,15,5,10,0
"posceptic",0,9,3,6,0
"ders",0,4,1,3,0
"ency",0,4,1,3,0
"mematics",0,8,3,5,0
"rosanna",1,7,3,4,0
"oxgates",1,7,3,4,0
"broccoli",1,8,3,5,0
"microhabitat",1,12,5,7,0
"jekxlx'rgmnfjvylaaouilep",0,24,7,17,1
"uncoveterandish",0,15,6,9,0
"islay",1,5,2,3,0
"elodeaceae",1,10,7,3,0
"heletoniac",0,10,5,5,0
"comonic",0,7,3,4,0
"aeolocorrhagy",0,13,6,7,0
"crion",0,5,2,3,0
"enarthrodia",1,11,5,6,0
"malblikacuspeg",0,14,5,9,0
"hed",0,3,1,2,0
"pfosi",1,5,2,3,0
"sysgenicisation",0,15,6,9,0
"papaws",1,6,2,4,0
"hannally",0,8,2,6,0
"fornlanculper",0,13,4,9,0
"zippingly",1,9,2,7,0
"blles",0,5,1,4,0
"cakiness",1,8,3,5,0
"polypothermen",0,13,4,9,0
"hydragrook",0,10,3,7,0
"leriomisetaiivelor",0,18,10,8,0
"telemeteorograph",1,16,7,9,0
"nonsanguishment",0,15,5,10,0
"xohkpx'dysuthkhgt",0,17,2,15,1
"enlevements",1,11,4,7,0
"assogram",0,8,3,5,0
"ypaorrcjpmqdtnamhhnqoehekmyrzi",0,30,7,23,0
"archimattergregnant",0,19,6,13,0
"caiacelicoulliade",0,17,10,7,0
"nonsubjectival",0,14,5,9,0
"dowsmosave",0,10,4,6,0
"whiskers",1,8,2,6,0
"prazosins",1,9,3,6,0
"guacate",0,7,4,3,0
"rebreeding",1,10,4,6,0
"joyless",1,7,2,5,0
"mpongergrealuontineteriskerolytenascatela",0,41,17,24,0
"nonnah",1,6,2,4,0
"rhvs",0,4,0,4,0
"hyropity",0,8,2,6,0
"giacobo",1,7,4,3,0
"storybook",1,9,3,6,0
"preparathyronises",0,17,6,11,0
"entish",0,6,2,4,0
"vardon",1,6,2,4,0
"trypanosomes",1,12,4,8,0
"atha",0,4,2,2,0
"ataung",0,6,3,3,0
"rschusep",0,8,2,6,0
"unsubstantialnesses",0,19,7,12,0
"morpinside",0,10,4,6,0
"coggliest",1,9,3,6,0
"wolving",1,7,2,5,0
"bussy",1,5,1,4,0
"newstail",0,8,3,5,0
"solsospeall",0,11,4,7,0
"znl'bbbxzfmqxrfatfjkd",0,21,1,20,1
"multitasks",1,10,3,7,0
"retise",0,6,3,3,0
"discriminated",1,13,5,8,0
"dialecticant",0,12,5,7,0
"bytgjwfstwdz",0,12,0,12,0
"brahambolyttle",0,14,4,10,0
"kraffest",0,8,2,6,0
"preministry",1,11,3,8,0
"enlutedly",0,9,3,6,0
"liqualay",0,8,4,4,0
"restaurations",1,13,6,7,0
"fuban",0,5,2,3,0
"hesperiid",1,9,4,5,0
"kkoye",0,5,2,3,0
"kstiedicetel",0,12,5,7,0
"repatterns",1,10,3,7,0
"seoieainanese",0,13,9,4,0
"myriapod",1,8,3,5,0
"endochorionic",1,13,6,7,0
"autoexposure",1,12,7,5,0
"aguxcfzyavkchftq",0,16,3,13,0
"promuscises",1,11,4,7,0
"countia",0,7,4,3,0
"creasol",1,7,3,4,0
"utediodonterbis",0,15,7,8,0
"aftercure",1,9,4,5,0
"aviator",1,7,4,3,0
"undiscipliness",0,14,5,9,0
"washmaid",1,8,3,5,0
"andese",0,6,3,3,0
"stormville",1,10,3,7,0
"cinchoninic",1,11,4,7,0
"umidlotrmosc",0,12,4,8,0
"niparoch",0,8,3,5,0
"mitokoromono",1,12,6,6,0
"ooconitnerivvyrmornisopactia",0,28,12,16,0
"meredithville",1,13,5,8,0
"cflwlfrszmuflgloip'k",0,20,3,17,1
"hippidion",1,9,4,5,0
"snaterita",0,9,4,5,0
"unshivering",1,11,4,7,0
"spermicide",1,10,4,6,0
"unprofunditorial",0,16,7,9,0
"unbewitched",1,11,4,7,0
"htcf'",0,5,0,5,1
"beaman",1,6,3,3,0
"precterce",0,9,3,6,0
"desantis",1,8,3,5,0
"activitalis",0,11,5,6,0
"cyl'nbglatlhq",0,13,1,12,1
"xfwtfxvjykgtuffyswdm'lzzkuis",0,28,3,25,1
"qa'kobqnxtic'ye",0,15,4,11,2
"spxpisgvx",0,9,1,8,0
"correctionville",1,15,6,9,0
"loqrmbwfeigbofgyz",0,17,4,13,0
"capitaling",1,10,4,6,0
"dyikm",0,5,1,4,0
"pedimental",1,10,4,6,0
"tummersault",0,11,4,7,0
"ellipsograph",1,12,4,8,0
"bahaistica",0,10,5,5,0
"pomato",1,6,3,3,0
"apocalypse",1,10,4,6,0
"mitee",0,5,3,2,0
"loulnzwzoqpj",0,12,3,9,0
"f'xoexgshfikgbhws'yexyhyjh",0,26,4,22,2
"endangiitis",1,11,5,6,0
"canoninae",0,9,5,4,0
"intermezzo",1,10,4,6,0
"reconflomaria",0,13,6,7,0
"unesishinakhae",0,14,7,7,0
"hewable",1,7,3,4,0
"circumfuse",1,10,4,6,0
"unbequeathalysite",0,17,8,9,0
"lacrothcbacenetchitinevermushoxationcese",0,40,16,24,0
"unbreediscosta",0,14,6,8,0
"palaeechingly",0,13,5,8,0
"und",0,3,1,2,0
"electal",0,7,3,4,0
"squisultanisms",0,14,5,9,0
"contemplate",1,11,4,7,0
"hytqbmqhorue",0,12,3,9,0
"xz'vujpnq'",0,10,1,9,2
"ypsilanti",1,9,3,6,0
"nonirritancy",1,12,4,8,0
"canisters",1,9,3,6,0
"monarchiannelid",0,15,6,9,0
"analyzer",0,8,3,5,0
"fanticards",0,10,3,7,0
"enragement",1,10,4,6,0
"ushiabasveripale",0,16,8,8,0
"bidons",1,6,2,4,0
"krameria",1,8,4,4,0
"molecularity",1,12,5,7,0
"pushinonbanters",0,15,5,10,0
"larcallativalfher",0,17,6,11,0
"fadnadoblenyerasted",0,19,7,12,0
"rotises",0,7,3,4,0
"reterminemake",0,13,6,7,0
"asapanaxims",0,11,5,6,0
"plugman",1,7,2,5,0
"anoist",0,6,3,3,0
"surnamers",1,9,3,6,0
"hallowedly",1,10,3,7,0
"tumming",0,7,2,5,0
"clemmons",1,8,2,6,0
"marygwhemelat",0,13,4,9,0
"'dms'cxiehs''mlggosuuxxmmtiot",0,29,7,22,4
"pedantocratically",0,17,6,11,0
"conflictively",0,13,4,9,0
"incienium",0,9,5,4,0
"apollonic",1,9,4,5,0
"perovskia",1,9,4,5,0
"androphore",1,10,4,6,0
"rehistricide",0,12,5,7,0
"bengal",1,6,2,4,0
"bdella",0,6,2,4,0
"trochiluli",1,10,4,6,0
"wkwrdnwixcqst",0,13,1,12,0
"eurebayens",0,10,5,5,0
"micrifies",1,9,4,5,0
"bratarius",0,9,4,5,0
"ptyalises",1,9,3,6,0
"mcgawed",0,7,2,5,0
"profundities",1,12,5,7,0
"yne",0,3,1,2,0
"misseats",1,8,3,5,0
"interdigital",1,12,5,7,0
"pedise",0,6,3,3,0
"qphldwnzyikw",0,12,1,11,0
"fabrillo",0,8,3,5,0
"panax",1,5,2,3,0
"coproteleonic",0,13,6,7,0
"undisprovidence",0,15,6,9,0
"steendosenfludootogingbo",0,24,10,14,0
"heralded",1,8,3,5,0
"cmxomqdshaw",0,11,2,9,0
"ves",0,3,1,2,0
"creatureling",1,12,5,7,0
"lazeangy",0,8,3,5,0
"improficients",0,13,5,8,0
"orthographer",1,12,4,8,0
"abassieh",1,8,4,4,0
"ustiegicophsiowhetet",0,20,9,11,0
"chronocarator",1,13,5,8,0
"interville",0,10,4,6,0
"astronavigators",1,15,6,9,0
"radiochromes",0,12,5,7,0
"occult",1,6,2,4,0
"belvedercircling",0,16,5,11,0
"hurloughs",0,9,3,6,0
"adenopharynx",0,12,4,8,0
"cacks",1,5,1,4,0
"lorales",0,7,3,4,0
"aleichem",1,8,4,4,0
"genetyllis",1,10,3,7,0
"autoerotism",1,11,6,5,0
"wn",0,2,0,2,0
"moralists",1,9,3,6,0
"fairnitickless",0,14,5,9,0
"lucrum",1,6,2,4,0
"neumatical",0,10,5,5,0
"rhabdoidal",1,10,4,6,0
"predynastic",1,11,3,8,0
"canising",0,8,3,5,0
"gvxj'jz",0,7,0,7,1
"broncobusters",1,13,4,9,0
"missileman",1,10,4,6,0
"richardsonia",1,12,5,7,0
"makeovers",1,9,4,5,0
"nering",0,6,2,4,0
"supersympathy",1,13,3,10,0
"ruffestinian",0,12,5,7,0
"broupet",0,7,3,4,0
"decomposability",1,15,6,9,0
"kistation",0,9,4,5,0
"rk'yspxz'ypj'bpmvqu",0,19,1,18,3
"comelantheednes",0,15,6,9,0
"heydrich",1,8,2,6,0
"tpvxn",0,5,0,5,0
"imposthume",1,10,4,6,0
"piezoelectroform",0,16,7,9,0
"bracip",0,6,2,4,0
"stitishlungfetterouver",0,22,8,14,0
"rzwgoerjhnd",0,11,2,9,0
"oversand",1,8,3,5,0
"nhs'wlufxqbhvg'xf",0,17,1,16,2
"palaeoclimatology",1,17,8,9,0
"thermopylae",1,11,4,7,0
"calcareosulphurous",1,18,8,10,0
"piste",1,5,2,3,0
"jzvxieuwkczyij",0,14,4,10,0
"masspriest",1,10,3,7,0
"internarial",1,11,5,6,0
"mount",1,5,2,3,0
"pallahs",1,7,2,5,0
"jcfvfkbctpp",0,11,0,11,0
"batiba",0,6,3,3,0
"alpoca",1,6,3,3,0
"pandurah",0,8,3,5,0
"catics",0,6,2,4,0
"tsarevna",1,8,3,5,0
"doless",1,6,2,4,0
"graforevich",0,11,4,7,0
"studderhood",0,11,4,7,0
"potboilers",1,10,4,6,0
"lec",1,3,1,2,0
"sanionistran",0,12,5,7,0
"topographical",1,13,5,8,0
"babyishly",1,9,2,7,0
"rhodic",1,6,2,4,0
"subscribbos",0,11,3,8,0
"ozzy",1,4,1,3,0
"agricolite",1,10,5,5,0
"mimesis",1,7,3,4,0
"frink",1,5,1,4,0
"psiloid",0,7,3,4,0
"grundying",0,9,2,7,0
"whiskerlike",1,11,4,7,0
"tapacura",1,8,4,4,0
"lyophilizer",1,11,4,7,0
"sweeping",1,8,3,5,0
"pradhana",1,8,3,5,0
"hyaenarctos",1,11,4,7,0
"apelequthsur",0,12,5,7,0
"chus",0,4,1,3,0
"microhymenoptera",1,16,6,10,0
"heredithian",0,11,5,6,0
"tzvsjyzidabhdiztol",0,18,4,14,0
"cloke",1,5,2,3,0
"phlebectasis",1,12,4,8,0
"reprecipitation",1,15,7,8,0
"gryphaea",1,8,3,5,0
"pseudopodium",1,12,6,6,0
"steenagonen",0,11,5,6,0
"mintitrawaliwing",0,16,6,10,0
"bushwhackers",1,12,3,9,0
"waldea",0,6,3,3,0
"goldfinnies",1,11,4,7,0
"ryxdgxvq",0,8,0,8,0
"impolished",1,10,4,6,0
"jandals",1,7,2,5,0
"pittering",1,9,3,6,0
"intratracheally",1,15,5,10,0
"ticinazeemonacoston",0,19,9,10,0
"surrenderer",1,11,4,7,0
"invades",1,7,3,4,0
"discolorations",1,14,6,8,0
"rassles",1,7,2,5,0
"hairweaver",1,10,5,5,0
"resistor",1,8,3,5,0
"westmeath",1,9,3,6,0
"marshalltown",1,12,3,9,0
"gannet",1,6,2,4,0
"reconceptualisation",1,19,9,10,0
"baycuru",1,7,3,4,0
"poxyhem",0,7,2,5,0
"wurley",0,6,2,4,0
"prdaylenichoves",0,15,5,10,0
"fragment",1,8,2,6,0
"abominableness",1,14,6,8,0
"ahor",0,4,2,2,0
"nobasts",0,7,2,5,0
"undrab",1,6,2,4,0
"romanic",1,7,3,4,0
"coalescency",1,11,4,7,0
"equipartition",1,13,7,6,0
"vering",0,6,2,4,0
"midzahhoi",0,9,4,5,0
"horseshiasio",0,12,6,6,0
"swastica",1,8,3,5,0
"caboceers",1,9,4,5,0
"sardonical",1,10,4,6,0
"unrum",0,5,2,3,0
"liew",1,4,2,2,0
"interbbred",1,10,3,7,0
"odghzpjfqltfokdmfoitdikq",0,24,5,19,0
"macers",1,6,2,4,0
"rota",1,4,2,2,0
"reconclusion",1,12,5,7,0
"precapitalist",1,13,5,8,0
"wayside",1,7,3,4,0
"lepjy",0,5,1,4,0
"backhoes",1,8,3,5,0
"nonsynonyms",0,11,2,9,0
"merphilinism",0,12,4,8,0
"gabriell",1,8,3,5,0
"ercakyxiabit",0,12,5,7,0
"subrigidly",1,10,3,7,0
"nizam",1,5,2,3,0
"nesxpwerdn",0,10,2,8,0
"xylinid",1,7,2,5,0
"gbesz",0,5,1,4,0
"unsmugness",1,10,3,7,0
"nonsynthesianised",0,17,6,11,0
"fouqu",1,5,3,2,0
"calif",1,5,2,3,0
"gomatolucifiatreness",0,20,9,11,0
"imo",1,3,2,1,0
"distingly",0,9,2,7,0
"talancalcidal",0,13,5,8,0
"undead",1,6,3,3,0
"vufj'lgoqgbdbjinnwxxmau",0,23,5,18,1
"unlettableness",0,14,5,9,0
"yfqdd'mwwhhadukedka",0,19,4,15,1
"scanialllelluenaielisa",0,22,11,11,0
"dangaleat",1,9,4,5,0
"cowbane",1,7,3,4,0
"anrecalmabillown",0,16,6,10,0
"chekan",1,6,2,4,0
"tariffing",1,9,3,6,0
"twalkatiently",0,13,4,9,0
"'yppsfzon'je",0,12,2,10,2
"unstroked",1,9,3,6,0
"assengeal",0,9,4,5,0
"unatseraxiabidle",0,16,8,8,0
"gluttonies",1,10,4,6,0
"xrbrcenftdczggntg'g'bnmhuxtp",0,28,2,26,2
"hwih'vvkmomvmleifdffka",0,22,5,17,1
"dombeathosisared",0,16,7,9,0
"pretist",0,7,2,5,0
"noncontranspiece",0,16,6,10,0
"gastroparesis",1,13,5,8,0
"moistless",1,9,3,6,0
"trisotropis",1,11,4,7,0
"chatti",1,6,2,4,0
"indulgential",1,12,5,7,0
"cheilosis",1,9,4,5,0
"radiotelegram",1,13,6,7,0
"elegancy",1,8,3,5,0
"scowntecaephotovaspandosntacarugstabancopoopphuitis",0,51,20,31,0
"snowslippy",0,10,2,8,0
"proexaminator",0,13,6,7,0
"viatopillarry",0,13,5,8,0
"veratrias",1,9,4,5,0
"corphera",0,8,3,5,0
"nasalism",1,8,3,5,0
"rljwxyxeeh",0,10,2,8,0
"portella",0,8,3,5,0
"headroominalism",0,15,7,8,0
"punnings",1,8,2,6,0
"tubman",1,6,2,4,0
"rowted",1,6,2,4,0
"nqurie",0,6,3,3,0
"etolitc",0,7,3,4,0
"subgraftocarrethocytiker",0,24,8,16,0
"semionotus",1,10,5,5,0
"calumny",1,7,2,5,0
"aquariist",1,9,5,4,0
"multidigitate",1,13,6,7,0
"ramadans",1,8,3,5,0
"sceduling",1,9,3,6,0
"numberplate",1,11,4,7,0
"dammanies",0,9,4,5,0
"mammifer",1,8,3,5,0
"ffbna'bpaprb'adafjhifutf",0,24,6,18,2
"enzymolytic",1,11,3,8,0
"baco",1,4,2,2,0
"appallman",0,9,3,6,0
"foremade",1,8,4,4,0
"lanosis",0,7,3,4,0
"poisonfully",1,11,4,7,0
"delineating",1,11,5,6,0
"bionditional",1,12,6,6,0
"dknmid",0,6,1,5,0
"mahapterdology",0,14,5,9,0
"brachiosaurus",1,13,6,7,0
"zmajppenzvayrqrfm",0,17,3,14,0
"gerik",1,5,2,3,0
"maypolite",0,9,4,5,0
"disporting",1,10,3,7,0
"underservice",1,12,5,7,0
"mispunctuation",1,14,6,8,0
"superstrikes",1,12,4,8,0
"mojave",1,6,3,3,0
"salvasses",0,9,3,6,0
"tidinesses",1,10,4,6,0
"adscript",1,8,2,6,0
"solvolyse",0,9,3,6,0
"endicter",0,8,3,5,0
"wedged",1,6,2,4,0
"hyperaphicness",0,14,4,10,0
"ijsu'chntzxstwozz",0,17,3,14,1
"pi",1,2,1,1,0
"drdoriaftistitipibentoche",0,25,10,15,0
"shritisation",0,12,5,7,0
"clericalism",1,11,4,7,0
"wayers",0,6,2,4,0
"isolationalists",1,15,7,8,0
"gyrostaccaceous",0,15,6,9,0
"reevership",0,10,4,6,0
"spiricization",0,13,6,7,0
"edr",0,3,1,2,0
"brids",0,5,1,4,0
"dempstealleniae",0,15,7,8,0
"sckus",0,5,1,4,0
"tramrernexand",0,13,4,9,0
"qualmyish",1,9,3,6,0
"dunfermline",1,11,4,7,0
"halazones",1,9,4,5,0
"sleying",1,7,2,5,0
"seclidysishatends",0,17,5,12,0
"vcppmr",0,6,0,6,0
"pollman",1,7,2,5,0
"creedite",1,8,4,4,0
"hypertherm",1,10,2,8,0
"freilker",0,8,3,5,0
"vintsspryrevedadncrinilis",0,25,7,18,0
"subimasque",0,10,5,5,0
"meratelelerless",0,15,6,9,0
"allopurinol",1,11,5,6,0
"unmind",1,6,2,4,0
"ozizolf",0,7,3,4,0
"attendee",1,8,4,4,0
"coryphenley",0,11,3,8,0
"opposes",1,7,3,4,0
"hinconiperonikochaloxgilie",0,26,12,14,0
"bersockeircascomoblimuggentethallubritubicopang",0,47,18,29,0
"tikitiki",1,8,4,4,0
"lgelhz'ipxlxopfcxoctq",0,21,4,17,1
"frontolyses",1,11,3,8,0
"rnpfcuim",0,8,2,6,0
"scagbichin",0,10,3,7,0
"calcutta",1,8,3,5,0
"tric",0,4,1,3,0
"outrageousnesses",1,16,8,8,0
"quidden",0,7,3,4,0
"cels",1,4,1,3,0
"trigly",1,6,1,5,0
"unfarming",1,9,3,6,0
"liquese",0,7,4,3,0
"fifth",1,5,1,4,0
"meshuggenehs",1,12,4,8,0
"chronologised",1,13,5,8,0
"torosanoid",0,10,5,5,0
"hanifite",1,8,4,4,0
"eijwbybudlkjilegqmacwobssdui",0,28,9,19,0
"jouysauromyxomasion",0,19,9,10,0
"labolt",1,6,2,4,0
"unpendant",1,9,3,6,0
"predefying",1,10,3,7,0
"bchar",1,5,1,4,0
"corticotropins",1,14,5,9,0
"hskutormydjazypkey",0,18,4,14,0
"oxhead",1,6,3,3,0
"syngly",0,6,0,6,0
"corrupters",1,10,3,7,0
"oxadiazole",1,10,6,4,0
"artinskian",1,10,4,6,0
"dsdrazyqcyziuanoewtaxc",0,22,7,15,0
"zzxnz'rnzmkntvzrj",0,17,0,17,1
"goody",1,5,2,3,0
"overpackaged",1,12,5,7,0
"unconfutative",1,13,6,7,0
"pille",0,5,2,3,0
"hypoxanthin",0,11,3,8,0
"basiglandular",1,13,5,8,0
"maytic",0,6,2,4,0
"jbakjyjdlennyhxjprg'njieaovzq",0,29,6,23,1
"cosystinka",0,10,3,7,0
"muiqfvrglpzrtzxgzn",0,18,2,16,0
"ns",0,2,0,2,0
"pweziolz",0,8,3,5,0
"ascared",1,7,3,4,0
"cohbert",1,7,2,5,0
"hazaki",1,6,3,3,0
"microdiagnostic",0,15,6,9,0
"psychyma",0,8,1,7,0
"byer",0,4,1,3,0
"kamuela",1,7,4,3,0
"damyankee",1,9,4,5,0
"otaycainvidetaaucrininstinckerorungly",0,37,15,22,0
"kgephsgfni",0,10,2,8,0
"acerates",1,8,4,4,0
"schos",0,5,1,4,0
"laymanship",1,10,3,7,0
"countercommercialist",0,20,8,12,0
"counterindentations",0,19,8,11,0
"bulliationalise",0,15,8,7,0
"robotesque",1,10,5,5,0
"dauru",0,5,3,2,0
"transversalt",0,12,3,9,0
"mawger",1,6,2,4,0
"pnowtome",0,8,3,5,0
"punakha",1,7,3,4,0
"semisidehornbrazingari",0,22,9,13,0
"allomeriastrountleous",0,21,10,11,0
"g'rmhchpxgsqjxbrrpinj",0,21,1,20,1
"chinoidecliproo",0,15,7,8,0
"szkdnydjwtxxlqjmpymby",0,21,0,21,0
"kundalini",1,9,4,5,0
"ctiveuers",0,9,4,5,0
"bz'uzfa'b'",0,10,2,8,3
"pentes",0,6,2,4,0
"sjqcsswuaipyqgq",0,15,3,12,0
"upblown",1,7,2,5,0
"uning",0,5,2,3,0
"spumone",1,7,3,4,0
"iqaluit",1,7,4,3,0
"ydnogwnfuy'appgj'nusaygnioshjp",0,30,7,23,2
"kowhai",1,6,3,3,0
"tunishness",0,10,3,7,0
"stempson",1,8,2,6,0
"glibbing",1,8,2,6,0
"femunnish",0,9,3,6,0
"comerio",1,7,4,3,0
"psaltie",0,7,3,4,0
"nonsuppression",1,14,5,9,0
"wxifaxxjgxaatgpikj",0,18,5,13,0
"repictureful",0,12,5,7,0
"walkylate",0,9,3,6,0
"voleries",1,8,4,4,0
"ligitcriacholierreaculthimessadiceightul",0,40,17,23,0
"piated",0,6,3,3,0
"malt",1,4,1,3,0
"kindre",0,6,2,4,0
"pvo",1,3,1,2,0
"stranesoraterel",0,15,6,9,0
"deaerate",1,8,5,3,0
"mhdcwrc",0,7,0,7,0
"carcinological",1,14,6,8,0
"audian",1,6,4,2,0
"bobadilian",1,10,5,5,0
"benz",1,4,1,3,0
"stigmatism",1,10,3,7,0
"cros",0,4,1,3,0
"kieselgur",1,9,4,5,0
"sphenographic",1,13,4,9,0
"stygian",1,7,2,5,0
"individuative",1,13,7,6,0
"burghbote",1,9,3,6,0
"auditives",1,9,5,4,0
"kingwood",1,8,3,5,0
"felten",1,6,2,4,0
"zoltiossostell",0,14,5,9,0
"ster",0,4,1,3,0
"rusag",0,5,2,3,0
"noncensoriously",1,15,6,9,0
"osirimoyer",0,10,5,5,0
"semisomnambulistic",1,18,7,11,0
"foxfeed",0,7,3,4,0
"subcircuit",1,10,4,6,0
"cathhoss",0,8,2,6,0
"ligner",0,6,2,4,0
"usiqdgkrqribdc'hmyjo",0,20,4,16,1
"bindeasprsten",0,13,4,9,0
"nonprohibitable",1,15,6,9,0
"dbzqftwjoumqpapnaewyhu'",0,23,6,17,1
"contradiscriminability",0,22,8,14,0
"teratogens",1,10,4,6,0
"korah",1,5,2,3,0
"kollwitz",1,8,2,6,0
"hypolycineticises",0,17,6,11,0
"cystoscopy",1,10,2,8,0
"zebeckia",0,8,4,4,0
"yippoters",0,9,3,6,0
"orcheitis",1,9,4,5,0
"shastan",1,7,2,5,0
"uxbvtsvpgf",0,10,1,9,0
"taiva",0,5,3,2,0
"teodorants",0,10,4,6,0
"holom",0,5,2,3,0
"baeonalids",0,10,5,5,0
"pcabjhdojl",0,10,2,8,0
"descence",0,8,3,5,0
"jotuns",1,6,2,4,0
"genispairweartner",0,17,7,10,0
"murkinje",0,8,3,5,0
"vandalisation",1,13,6,7,0
"ephrathite",1,10,4,6,0
"comitadjis",1,10,4,6,0
"batterie",1,8,4,4,0
"nuwmnhrgnkbp",0,12,1,11,0
"iotization",1,10,6,4,0
"unmistrustfully",1,15,4,11,0
"victorian",1,9,4,5,0
"procurvews",0,10,3,7,0
"nethium",0,7,3,4,0
"volumetrically",1,14,5,9,0
"zupltxezlmons",0,13,3,10,0
"sheiceptiving",0,13,5,8,0
"kie",1,3,2,1,0
"jdkecekcgdjtnzeeazlb",0,20,5,15,0
"acknowellsie",0,12,5,7,0
"murray",1,6,2,4,0
"uroid",0,5,3,2,0
"approves",1,8,3,5,0
"cered",1,5,2,3,0
"fhvraa",0,6,2,4,0
"narghiles",1,9,3,6,0
"permeggatuded",0,13,5,8,0
"denteraphatims",0,14,5,9,0
"foxton",1,6,2,4,0
"thigger",1,7,2,5,0
"spe",0,3,1,2,0
"nonrevolutionary",1,16,7,9,0
"jkckptcuvgqtfrmnsypedkb",0,23,2,21,0
"waistie",0,7,4,3,0
"cctoipaletak",0,12,5,7,0
"westborough",1,11,4,7,0
"uneudeceamis",0,12,7,5,0
"forritsome",1,10,4,6,0
"receiverships",1,13,5,8,0
"cholelithiasis",1,14,6,8,0
"raddha",0,6,2,4,0
"bshec",1,5,1,4,0
"feflacks",0,8,2,6,0
"lingence",1,8,3,5,0
"juaidosuliaerielinfovessarafeayterorizes",0,40,21,19,0
"hexanchipura",0,12,5,7,0
"warbled",1,7,2,5,0
"paynesville",1,11,4,7,0
"tognk",0,5,1,4,0
"candyce",1,7,2,5,0
"llyneridn",0,9,2,7,0
"blycus",0,6,1,5,0
"reminisces",1,10,4,6,0
"agneaux",1,7,4,3,0
"pinge",1,5,2,3,0
"compowerating",0,13,5,8,0
"misalter",1,8,3,5,0
"wayao",1,5,3,2,0
"holothuridea",1,12,6,6,0
"reconnetrauhquagariflushenered",0,30,13,17,0
"solaptes",0,8,3,5,0
"y'yqzzmxlmst",0,12,0,12,1
"dfie'emwivwegfwfsnsgzxbf",0,24,5,19,1
"rakers",1,6,2,4,0
"cordel",1,6,2,4,0
"farnswoggle",0,11,3,8,0
"strophuluses",1,12,4,8,0
"rngxsufxkhpb",0,12,1,11,0
"ascochyta",1,9,3,6,0
"poes",0,4,2,2,0
"kennerdell",1,10,3,7,0
"stepuncle",1,9,3,6,0
"trichidae",0,9,4,5,0
"tatterdomesticity",0,17,6,11,0
"exprobriation",0,13,6,7,0
"casatus",1,7,3,4,0
"pontiest",0,8,3,5,0
"copiers",1,7,3,4,0
"ramrods",1,7,2,5,0
"platyptera",1,10,3,7,0
"nemertea",1,8,4,4,0
"cristivomer",1,11,4,7,0
"circe",1,5,2,3,0
"bucculation",0,11,5,6,0
"triboelectropocaic",0,18,8,10,0
"grxhbqaaxsts'mcw",0,16,2,14,1
"elicatraggefilune",0,17,8,9,0
"unidism",0,7,3,4,0
"monomolecithal",0,14,6,8,0
"cordhous",0,8,3,5,0
"consultantships",1,15,4,11,0
"hyperventilation",1,16,6,10,0
"tilyer",1,6,2,4,0
"boised",0,6,3,3,0
"twarette",0,8,3,5,0
"exultance",1,9,4,5,0
"trimethoprim",1,12,4,8,0
"doghousevictoria",0,16,8,8,0
"'t",0,2,0,2,1
"ch",0,2,0,2,0
"firoph",0,6,2,4,0
"pallae",1,6,3,3,0
"empyreuma",1,9,4,5,0
"uwxol'wkvjb",0,11,2,9,1
"chiliaceously",0,13,6,7,0
"prosis",0,6,2,4,0
"models",1,6,2,4,0
"seminifical",1,11,5,6,0
"testor",1,6,2,4,0
"ulwed",0,5,2,3,0
"imminute",1,8,4,4,0
"gnqoyfxwitjelr'tfoor",0,20,5,15,1
"basilicalike",1,12,6,6,0
"decterwini",0,10,4,6,0
"msly",0,4,0,4,0
"proliferous",1,11,5,6,0
"folky",1,5,1,4,0
"t'htiewrkw",0,10,2,8,1
"mstyosettibleadbal",0,18,6,12,0
"dwnnaensl",0,9,2,7,0
"shockstall",1,10,2,8,0
"seamsters",1,9,3,6,0
"ribiers",1,7,3,4,0
"bbs",1,3,0,3,0
"godber",1,6,2,4,0
"darline",1,7,3,4,0
"unstandardisable",1,16,6,10,0
"arteritis",1,9,4,5,0
"prothyle",1,8,2,6,0
"sabbankson",0,10,3,7,0
"cafetal",1,7,3,4,0
"penavesesiontharcut",0,19,8,11,0
"homerist",1,8,3,5,0
"encephaloid",1,11,5,6,0
"murikers",0,8,3,5,0
"qxcflaiushbqjjbmgavkfyiu",0,24,6,18,0
"squintingly",1,11,3,8,0
"buttesties",0,10,4,6,0
"ctos",0,4,1,3,0
"authorgan",0,9,4,5,0
"zonli",0,5,2,3,0
"viversigmorantofozes",0,20,8,12,0
"dhaks",1,5,1,4,0
"alchemy",1,7,2,5,0
"allusions",1,9,4,5,0
"trustlessly",1,11,2,9,0
"aelohboupwtalos",0,15,7,8,0
"mous",0,4,2,2,0
"ginside",0,7,3,4,0
"sceptibly",1,9,2,7,0
"fullstops",1,9,2,7,0
"overdaringly",1,12,4,8,0
"bumperinesses",0,13,5,8,0
"ivzizrzggtrpzugsyyxdptto'mvi",0,28,5,23,1
"engenia",1,7,4,3,0
"bsnaftebk",0,9,2,7,0
"orchioscheocele",1,15,7,8,0
"swelterer",1,9,3,6,0
"olenta",1,6,3,3,0
"unsubduemblet",0,13,5,8,0
"partops",0,7,2,5,0
"checheherez",0,11,4,7,0
"agwic",0,5,2,3,0
"ganide",0,6,3,3,0
"stormer",1,7,2,5,0
"artaba",1,6,3,3,0
"dysteleologist",1,14,5,9,0
"cascadia",1,8,4,4,0
"jerm'p",0,6,1,5,1
"wateradocoriness",0,16,7,9,0
"overchillis",0,11,4,7,0
"boems",0,5,2,3,0
"audrillaborative",0,16,8,8,0
"rheoplankton",1,12,4,8,0
"dorsolateral",1,12,5,7,0
"gctgkfjddwwwxtjh",0,16,0,16,0
"harrisburg",1,10,3,7,0
"neminods",0,8,3,5,0
"bejade",1,6,3,3,0
"myrcinian",0,9,3,6,0
"unsterl",0,7,2,5,0
"ynes",1,4,1,3,0
"cathartidae",1,11,5,6,0
"rehabber",1,8,3,5,0
"hampshirite",1,11,4,7,0
"leptickenns",0,11,3,8,0
"phthodiodorias",0,14,6,8,0
"icctinepimoimmind",0,17,7,10,0
"unctalbalel",0,11,4,7,0
"enwreath",1,8,3,5,0
"jeffersonite",1,12,5,7,0
"gaol",1,4,2,2,0
"stoichiometric",1,14,6,8,0
"gilbart",1,7,2,5,0
"quaquaversal",1,12,6,6,0
"vyooozkflxzgyqtx'c",0,18,3,15,1
"unoscillography",0,15,5,10,0
"revaloressa",0,11,5,6,0
"subrectory",1,10,3,7,0
"moresques",1,9,4,5,0
"halemaumau",1,10,6,4,0
"bywaters",1,8,2,6,0
"isoosmosis",0,10,5,5,0
"ubilichonant",0,12,5,7,0
"meteratives",0,11,5,6,0
"insoluble",1,9,4,5,0
"itugesetlacreatutixtyn",0,22,9,13,0
"motored",1,7,3,4,0
"gaulinesses",0,11,5,6,0
"phobia",1,6,3,3,0
"vkqave'maxobnpcnqfopwrjri",0,25,6,19,1
"bzsxzlpfhtmpqoixzukqygopz",0,25,4,21,0
"joazqgoinctgoiqflq",0,18,6,12,0
"mistrist",1,8,2,6,0
"electrophenous",0,14,6,8,0
"witchazy",0,8,2,6,0
"conmeton",0,8,3,5,0
"pussywillow",1,11,3,8,0
"nuvxd'adlczd'bm'krawe",0,21,4,17,3
"cateesigograchateseinistiverva",0,30,14,16,0
"undial",0,6,3,3,0
"bistortionment",0,14,5,9,0
"tauriferous",1,11,6,5,0
"conclavist",1,10,3,7,0
"ribly",0,5,1,4,0
"sawlemncdj",0,10,2,8,0
"honorius",1,8,4,4,0
"finless",1,7,2,5,0
"uspyqjjstoohubehmygpzf",0,22,5,17,0
"altgeld",1,7,2,5,0
"branumishishti",0,14,5,9,0
"beneficienced",0,13,6,7,0
"jpzfccbfugteniivf",0,17,4,13,0
"antipapacy",1,10,4,6,0
"symparer",0,8,2,6,0
"zaialzzbjpygixsr",0,16,4,12,0
"evive",0,5,3,2,0
"uriartarbastchangrfuswadpsmphetewhezodi",0,39,13,26,0
"ispdsykmqi",0,10,2,8,0
"windsors",1,8,2,6,0
"phytoalexin",1,11,4,7,0
"yssutphoacqu",0,12,4,8,0
"againsay",1,8,4,4,0
"panicum",1,7,3,4,0
"cisinoxillkatiothidilifecleicillia",0,34,16,18,0
"alitangle",0,9,4,5,0
"troopmen",0,8,3,5,0
"nebaliidae",1,10,6,4,0
"unidolome",0,9,5,4,0
"impieties",1,9,5,4,0
"achromatisations",1,16,7,9,0
"paphoty",0,7,2,5,0
"yardwand",1,8,2,6,0
"carneying",1,9,3,6,0
"biochemist",1,10,4,6,0
"bearishnesses",1,13,5,8,0
"almuce",1,6,3,3,0
"unpatented",1,10,4,6,0
"counterritornelised",0,19,8,11,0
"ratchproofing",0,13,4,9,0
"stannel",1,7,2,5,0
"gancebe",0,7,3,4,0
"hurqqfbkajxoitry",0,16,4,12,0
"leanne",1,6,3,3,0
"hylothorax",0,10,3,7,0
"predentate",1,10,4,6,0
"pachouser",0,9,4,5,0
"bellyfull",1,9,2,7,0
"feudalic",0,8,4,4,0
"bol",0,3,1,2,0
"grantham",1,8,2,6,0
"caleazica",0,9,5,4,0
"translation",1,11,4,7,0
"cretogenesially",0,15,6,9,0
"knab",1,4,1,3,0
"inefficiency",1,12,5,7,0
"nxkrpztfvfkiebvkoga'v",0,21,4,17,1
"cognoscitive",1,12,5,7,0
"mcbzf'qo",0,8,1,7,1
"haterpred",0,9,3,6,0
"adau",0,4,3,1,0
"cosuffer",1,8,3,5,0
"astroduodenojejuna",0,18,9,9,0
"cobelligerent",1,13,5,8,0
"presex",0,6,2,4,0
"musugwlencabruzes",0,17,6,11,0
"drehearthus",0,11,4,7,0
"dependance",0,10,4,6,0
"solidificationally",0,18,8,10,0
"menaspis",1,8,3,5,0
"hansardization",1,14,6,8,0
"macaco",1,6,3,3,0
"chylose",0,7,2,5,0
"kalamazoo",1,9,5,4,0
"northvale",1,9,3,6,0
"remicated",0,9,4,5,0
"aglipaya",0,8,4,4,0
"paranyms",1,8,2,6,0
"zoninnutomotarnes",0,17,7,10,0
"fluoroboride",1,12,6,6,0
"palinode",1,8,4,4,0
"petratoservatic",0,15,6,9,0
"karse",0,5,2,3,0
"nartelike",0,9,4,5,0
"gunnybags",1,9,2,7,0
"surinamer",1,9,4,5,0
"codelinquent",1,12,5,7,0
"wendintorple",0,12,4,8,0
"incubinate",0,10,5,5,0
"semidurables",1,12,5,7,0
"routinisation",1,13,7,6,0
"vorlessness",0,11,3,8,0
"pnmkovrdtejj'zoyisvdgqz",0,23,4,19,1
"phainopepla",1,11,5,6,0
"prentiidae",0,10,5,5,0
"desales",0,7,3,4,0
"xema",1,4,2,2,0
"gjumblinderisine",0,16,6,10,0
"molegist",0,8,3,5,0
"cllluloshiakerajiovolowrobied",0,29,13,16,0
"demontoing",0,10,4,6,0
"ttj'y'",0,6,0,6,2
"archetto",1,8,3,5,0
"sandal",1,6,2,4,0
"kilted",1,6,2,4,0
"myljfncsqxthpskurtycdoc",0,23,2,21,0
"hyperhidrosis",1,13,4,9,0
"hanes",0,5,2,3,0
"chinkie",1,7,3,4,0
"selfpreservatively",0,18,6,12,0
"adaline",1,7,4,3,0
"dialkyl",1,7,2,5,0
"gndalicalld",0,11,3,8,0
"nataraja",1,8,4,4,0
"amithnaurs",0,10,4,6,0
"anthropogenic",1,13,5,8,0
"gly",0,3,0,3,0
"tomahawker",1,10,4,6,0
"pangane",1,7,3,4,0
"marity",0,6,2,4,0
"giscutbalerg",0,12,4,8,0
"mpqllnopeusllrf",0,15,3,12,0
"metatheological",0,15,7,8,0
"jagecondarforuntesma",0,20,8,12,0
"angioclast",1,10,4,6,0
"boursed",0,7,3,4,0
"bagonet",1,7,3,4,0
"pently",0,6,1,5,0
"outquote",0,8,5,3,0
"sparklinesses",0,13,4,9,0
"compressiveness",0,15,5,10,0
"biouchortocinonpaggenattlehluseattenliturathacouttirnfacharien",0,62,26,36,0
"epimeria",0,8,5,3,0
"bzybdzjmhnqxtjixocvb",0,20,2,18,0
"xksz",0,4,0,4,0
"patryptoh",0,9,2,7,0
"unhology",0,8,3,5,0
"throttlerages",0,13,4,9,0
"octogenies",0,10,5,5,0
"boobscalistly",0,13,4,9,0
"angelftwaildealladosco",0,22,9,13,0
"nonfavouraticals",0,16,7,9,0
"sciomachy",1,9,3,6,0
"e'klbzlqp'j'nl",0,14,1,13,3
"weiring",1,7,3,4,0
"iconise",1,7,4,3,0
"slummer",1,7,2,5,0
"fairburn",1,8,3,5,0
"tyrosine",1,8,3,5,0
"ethiopes",1,8,4,4,0
"undivertible",1,12,5,7,0
"bankeovivingsoblt",0,17,6,11,0
"atuntengnatr",0,12,4,8,0
"vaccio",0,6,3,3,0
"geraviltiss",0,11,4,7,0
"sortieing",1,9,4,5,0
"koppograded",0,11,4,7,0
"vrzqinnbhc'z",0,12,1,11,1
"antlion",1,7,3,4,0
"slaggability",1,12,4,8,0
"greasay",0,7,3,4,0
"cytotoxins",1,10,3,7,0
"oxowan",0,6,3,3,0
"sunscalds",1,9,2,7,0
"lessish",0,7,2,5,0
"abnormality",1,11,4,7,0
"chitinogenous",1,13,6,7,0
"transactinidiaceae",0,18,9,9,0
"madelle",1,7,3,4,0
"uncircuitously",1,14,6,8,0
"obivy",0,5,2,3,0
"engineering",1,11,5,6,0
"guisarme",1,8,4,4,0
"dokmarok",1,8,3,5,0
"tempestates",1,11,4,7,0
"hippocrenic",0,11,4,7,0
"vtr",1,3,0,3,0
"calamagrostemma",0,15,6,9,0
"retentivity",1,11,4,7,0
"jegpresaterts",0,13,4,9,0
"pharmacognostics",1,16,5,11,0
"stoecanopter",0,12,5,7,0
"tetrahydrofuran",1,15,5,10,0
"unobstruently",1,13,4,9,0
"moonraking",1,10,4,6,0
"nighhandednesses",0,16,5,11,0
"blt",0,3,0,3,0
"osmometries",1,11,5,6,0
"xkgqylktpogvadqskszuojvo",0,24,5,19,0
"underclub",1,9,3,6,0
"reinflaters",0,11,4,7,0
"deratings",1,9,3,6,0
"emenders",1,8,3,5,0
"mugwumpian",1,10,4,6,0
"tarogalvanometric",0,17,7,10,0
"pac",1,3,1,2,0
"nonconfined",1,11,4,7,0
"foolmonger",1,10,4,6,0
"noncommemorative",1,16,7,9,0
"uzara",1,5,3,2,0
"patriaceoid",0,11,6,5,0
"b'iuqopaoxpa",0,12,6,6,1
"theriot",1,7,3,4,0
"dmumicirenn",0,11,4,7,0
"preoffer",0,8,3,5,0
"asshilycanoret",0,14,5,9,0
"geraudairecreh",0,14,7,7,0
"elds",1,4,1,3,0
"kyasmyprpgrudgsnbzjjomtrj",0,25,3,22,0
"buchtel",1,7,2,5,0
"borane",1,6,3,3,0
"ectocuneiform",1,13,6,7,0
"sacked",1,6,2,4,0
"leaux",0,5,3,2,0
"plasmode",1,8,3,5,0
"prist",0,5,1,4,0
"yw",0,2,0,2,0
"assarion",1,8,4,4,0
"rochinefispovis",0,15,6,9,0
"soapstone",1,9,4,5,0
"affaite",1,7,4,3,0
"pental",0,6,2,4,0
"cursed",1,6,2,4,0
"patrich",1,7,2,5,0
"macumba",1,7,3,4,0
"icehood",0,7,4,3,0
"aneroidogeneses",0,15,8,7,0
"oledera",0,7,4,3,0
"forhooing",1,9,4,5,0
"dendone",0,7,3,4,0
"uncalctactineanomactticatorogless",0,33,13,20,0
"syndactylists",0,13,2,11,0
"franklinism",1,11,3,8,0
"recomiendist",0,12,5,7,0
"undercurrently",0,14,4,10,0
"blindfish",1,9,2,7,0
"forevalue",1,9,5,4,0
"kunkah",0,6,2,4,0
"antinoise",1,9,5,4,0
"entriked",0,8,3,5,0
"skios",1,5,2,3,0
"uniwhitterfied",0,14,6,8,0
"coachiate",0,9,5,4,0
"grunthing",0,9,2,7,0
"nagpur",1,6,2,4,0
"heltltr",0,7,1,6,0
"subjunctively",1,13,4,9,0
"anoplus",0,7,3,4,0
"slipcases",1,9,3,6,0
"tetrochstal",0,11,3,8,0
"inshelling",1,10,3,7,0
"xdjjbzg'rwguisuveishbcjjpcq",0,27,5,22,1
"schoolfell",0,10,3,7,0
"reclar",0,6,2,4,0
"exopteries",0,10,5,5,0
"santonate",1,9,4,5,0
"hagiographa",1,11,5,6,0
"jastscedeiaces",0,14,6,8,0
"boreades",1,8,4,4,0
"hckfeqcusjdelnlgk",0,17,3,14,0
"flambant",1,8,2,6,0
"bopskelianenea",0,14,7,7,0
"radiocratus",0,11,5,6,0
"qzcvft",0,6,0,6,0
"dynatrons",1,9,2,7,0
"dogmatisms",1,10,3,7,0
"pitic",0,5,2,3,0
"crepuscular",1,11,4,7,0
"quakeproofs",1,11,5,6,0
"hologised",0,9,4,5,0
"roindong",0,8,3,5,0
"chastiment",1,10,3,7,0
"igmitellomaved",0,14,6,8,0
"luella",1,6,3,3,0
"multurbaress",0,12,4,8,0
"blends",1,6,1,5,0
"keater",0,6,3,3,0
"compregents",0,11,3,8,0
"siggitiandeonimentingaramely",0,28,12,16,0
"hyoepiglottidean",1,16,7,9,0
"iaqvcekh",0,8,3,5,0
"tobaccanalians",1,14,6,8,0
"ewflzs'cvn",0,10,1,9,1
"drumler",1,7,2,5,0
"eumenes",1,7,4,3,0
"arbitrageurs",1,12,5,7,0
"precompensate",1,13,5,8,0
"acleriatllladog",0,15,6,9,0
"gorsolketioded",0,14,6,8,0
"winsted",1,7,2,5,0
"prommendably",0,12,3,9,0
"pluriparous",1,11,5,6,0
"ffwsct",0,6,0,6,0
"dillipionisuric",0,15,7,8,0
"reaplian",0,8,4,4,0
"shavery",1,7,2,5,0
"amelin",0,6,3,3,0
"kheationakingly",0,15,6,9,0
"snowboarder",1,11,4,7,0
"spubnnqjbzdacveiqmcw",0,20,4,16,0
"sican",0,5,2,3,0
"apocinchonine",1,13,6,7,0
"shrews'hares",0,12,3,9,1
"statianiss",0,10,4,6,0
"zhxhuowyvnnwawjerqbne",0,21,5,16,0
"palaeotherium",1,13,7,6,0
"receivals",1,9,4,5,0
"pisis",0,5,2,3,0
"ruscoparen",0,10,4,6,0
"cartroom",0,8,3,5,0
"parcoprolvates",0,14,5,9,0
"machin",1,6,2,4,0
"threshel",1,8,2,6,0
"ovey",0,4,2,2,0
"yuapin",1,6,3,3,0
"coronus",1,7,3,4,0
"groomish",1,8,3,5,0
"wpr",0,3,0,3,0
"xenomagnetic",0,12,5,7,0
"pliererinolockjawfieralists",0,27,11,16,0
"shardistefirybolaset",0,20,7,13,0
"ecstasy",1,7,2,5,0
"uncoagulable",1,12,6,6,0
"predistributory",0,15,5,10,0
"neurectomy",1,10,4,6,0
"vorfeld",1,7,2,5,0
"hopelessness",1,12,4,8,0
"oniousness",0,10,5,5,0
"stee",0,4,2,2,0
"insularities",1,12,6,6,0
"propercussorgsky",0,16,4,12,0
"apyonin",1,7,3,4,0
"qvfnlovusyvbizzheav",0,19,5,14,0
"clepe",1,5,2,3,0
"paucispiral",1,11,5,6,0
"adoptionism",1,11,5,6,0
"saggering",1,9,3,6,0
"nonfaddist",1,10,3,7,0
"voltaelectoration",0,17,8,9,0
"suckles",1,7,2,5,0
"gloiopeltis",1,11,5,6,0
"extrametropolitan",1,17,7,10,0
"metro",1,5,2,3,0
"aldrovanda",1,10,4,6,0
"nonfuturity",1,11,4,7,0
"cholangiogram",1,13,5,8,0
"scalawaggery",1,12,4,8,0
"oniscium",0,8,4,4,0
"ascomycetes",1,11,4,7,0
"lacallalagryris",0,15,5,10,0
"goldberg",1,8,2,6,0
"gregationalisation",0,18,9,9,0
"polybasicity",1,12,4,8,0
"jusserand",1,9,3,6,0
"inhouse",0,7,4,3,0
"subarborescent",1,14,5,9,0
"maihvzehgymlowvrpturutgnigf",0,27,7,20,0
"conial",0,6,3,3,0
"vwrugddjldmlw",0,13,1,12,0
"llano",1,5,2,3,0
"bluewoods",1,9,4,5,0
"dullama",0,7,3,4,0
"deffer",1,6,2,4,0
"plethrum",0,8,2,6,0
"lfkdbp",0,6,0,6,0
"thicky",1,6,1,5,0
"betided",1,7,3,4,0
"kioglptors",0,10,3,7,0
"overrestrainably",0,16,6,10,0
"aifl",0,4,2,2,0
"affectlessly",1,12,3,9,0
"stering",0,7,2,5,0
"tyers",1,5,1,4,0
"cogan",1,5,2,3,0
"sxeycxwwoy",0,10,2,8,0
"drecks",1,6,1,5,0
"pulture",1,7,3,4,0
"ckerule",0,7,3,4,0
"vocalise",1,8,4,4,0
"pha",0,3,1,2,0
"kiliwi",1,6,3,3,0
"syntheme",1,8,2,6,0
"analyst",1,7,2,5,0
"pedrero",1,7,3,4,0
"aig",0,3,2,1,0
"catanael",0,8,4,4,0
"agamidae",1,8,5,3,0
"maidservant",1,11,4,7,0
"repentant",1,9,3,6,0
"kowtowing",1,9,3,6,0
"ymxhekrozaerj",0,13,4,9,0
"heliststic",0,10,3,7,0
"pinkster",1,8,2,6,0
"indigestible",1,12,5,7,0
"hed",0,3,1,2,0
"chicomecoatl",1,12,5,7,0
"nebuchadnezzars",1,15,5,10,0
"ganitess",0,8,3,5,0
"zoonule",1,7,4,3,0
"meranghranenel",0,14,5,9,0
"arrivancy",1,9,3,6,0
"hedgers",1,7,2,5,0
"tiran",1,5,2,3,0
"rama",1,4,2,2,0
"veadars",1,7,3,4,0
"jussion",1,7,3,4,0
"ekstrom",1,7,2,5,0
"ronarmsher",0,10,3,7,0
"noses",1,5,2,3,0
"macrocephalic",1,13,5,8,0
"tedc'yewbdh'gg'xazpg",0,20,3,17,3
"conteke",1,7,3,4,0
"flncaews",0,8,2,6,0
"regarded",1,8,3,5,0
"unrecapranei",0,12,6,6,0
"maxerfil",0,8,3,5,0
"voorheesville",1,13,6,7,0
"nonfraternally",1,14,4,10,0
"mahra",1,5,2,3,0
"teradobinncaleticyola",0,21,9,12,0
"heather",1,7,3,4,0
"multinomial",1,11,5,6,0
"granulocytopenia",1,16,7,9,0
"enterectomy",1,11,4,7,0
"unconstellencieux",0,17,7,10,0
"chucking",1,8,2,6,0
"goldenmouthed",1,13,5,8,0
"solenostemonous",0,15,7,8,0
"schizomycetes",1,13,4,9,0
"trevah",1,6,2,4,0
"xymareblet",0,10,3,7,0
"geologer",1,8,4,4,0
"rellyng",0,7,1,6,0
"hearer",1,6,3,3,0
"archduxe",1,8,3,5,0
"dogribs",1,7,2,5,0
"biblicists",1,10,3,7,0
"toverkeraseskegs",0,16,6,10,0
"saccharimetry",1,13,4,9,0
"maurist",1,7,3,4,0
"feudalistic",1,11,5,6,0
"patriarchies",1,12,5,7,0
"ebnakerstful",0,12,4,8,0
"silish",0,6,2,4,0
"szkdsztzocd",0,11,1,10,0
"sandblastings",1,13,3,10,0
"ufepgnjnqdxctyqv",0,16,2,14,0
"inico",0,5,3,2,0
"atarismibaitroveys",0,18,8,10,0
"palazonternessiestrancid",0,24,9,15,0
"abalism",0,7,3,4,0
"cuticularia",0,11,6,5,0
"actionoph",0,9,4,5,0
"denae",1,5,3,2,0
"gorgemaking",0,11,4,7,0
"afterburners",1,12,4,8,0
"dsmintyor",0,9,2,7,0
"vietnam",1,7,3,4,0
"jalapic",1,7,3,4,0
"tasposbousnonweimitiveationce",0,29,14,15,0
"brads",1,5,1,4,0
"andirubine",0,10,5,5,0
"pleurobrachium",0,14,6,8,0
"dearansemetypechtomisackinaffs",0,30,11,19,0
"impentrontronguishnessorsenko",0,29,10,19,0
"dwatos",0,6,2,4,0
"ellisogormawin",0,14,6,8,0
"whitesville",1,11,4,7,0
"'wxj",0,4,0,4,1
"aestivate",1,9,5,4,0
"counterstimulation",1,18,8,10,0
"abilitherstuplodom",0,18,7,11,0
"parrocheyer",0,11,4,7,0
"pygaedomiths",0,12,4,8,0
"interplay",1,9,3,6,0
"branford",1,8,2,6,0
"eopocamiqaw",0,11,6,5,0
"norethindrones",1,14,5,9,0
"tetrameria",0,10,5,5,0
"coistrelsy",0,10,3,7,0
"vited",0,5,2,3,0
"simmesport",1,10,3,7,0
"borophyte",0,9,3,6,0
"premover",1,8,3,5,0
"sciotheric",1,10,4,6,0
"thingtosiseian",0,14,6,8,0
"overintensely",1,13,5,8,0
"merkle",1,6,2,4,0
"bbunt",0,5,1,4,0
"waiting",1,7,3,4,0
"alientahdynckv",0,14,4,10,0
"meropidan",1,9,4,5,0
"girondisms",1,10,3,7,0
"equibalancing",1,13,6,7,0
"genian",1,6,3,3,0
"osoewidrlnua",0,12,6,6,0
"wordably",1,8,2,6,0
"remixer",1,7,3,4,0
"tubism",0,6,2,4,0
"uncommandeered",0,14,6,8,0
"anacle",0,6,3,3,0
"jargoneer",1,9,4,5,0
"parachronism",1,12,4,8,0
"mjcb'cbcydpdohnwgb",0,18,1,17,1
"stiction",1,8,3,5,0
"perinsk",0,7,2,5,0
"moods",1,5,2,3,0
"arbalisters",1,11,4,7,0
"undisowning",1,11,4,7,0
"butcherlike",0,11,4,7,0
"hyperdelicateness",1,17,6,11,0
"nonproscriptural",0,16,5,11,0
"ffig",0,4,1,3,0
"hicorababawashe",0,15,7,8,0
"furnarius",1,9,4,5,0
"owlclaws",1,8,2,6,0
"eritudelamies",0,13,7,6,0
"lnfgolfiyccuzcccmxtgkiic",0,24,5,19,0
"finnocks",1,8,2,6,0
"defaulted",1,9,4,5,0
"craddock",1,8,2,6,0
"bepoguore",0,9,5,4,0
"connixationist",0,14,6,8,0
"zs",1,2,0,2,0
"latas",0,5,2,3,0
"avilion",1,7,4,3,0
"gonophysicalicuit",0,17,7,10,0
"herayed",0,7,3,4,0
"daisy",1,5,2,3,0
"alleculates",0,11,5,6,0
"primrosa",1,8,3,5,0
"itrania",0,7,4,3,0
"im'mgucmtvxu",0,12,3,9,1
"kirkby",1,6,1,5,0
"polypapilloma",1,13,5,8,0
"outrage",1,7,4,3,0
"enforming",1,9,3,6,0
"lewisites",1,9,4,5,0
"pneumoneritous",0,14,7,7,0
"unhoplaspeckeypondoungium",0,25,10,15,0
"mvqmtjchihipmgx",0,15,2,13,0
"ronellated",0,10,4,6,0
"bourg",1,5,2,3,0
"kweernobehfqtflmnjxrj",0,21,4,17,0
"niere",0,5,3,2,0
"pencillers",1,10,3,7,0
"mystagogues",1,11,4,7,0
"balloted",1,8,3,5,0
"imperforate",1,11,5,6,0
"cretcherichokalidiorshapelk",0,27,10,17,0
"capulatee",0,9,5,4,0
"objosed",0,7,3,4,0
"aivr",1,4,2,2,0
"noctua",1,6,3,3,0
"vyejwcjynyxsvtie",0,16,3,13,0
"pue",0,3,2,1,0
"stylaster",1,9,2,7,0
"tfenynjyamxlyfpxeb'oiwjqciwb",0,28,6,22,1
"amazonia",1,8,5,3,0
"sability",0,8,3,5,0
"brissotin",1,9,3,6,0
"ocreatae",1,8,5,3,0
"r'npatomppq'cgoipjzirmpiiemz",0,28,8,20,2
"bilton",0,6,2,4,0
"monodactylate",1,13,5,8,0
"lankin",1,6,2,4,0
"peptalking",1,10,3,7,0
"chellstalberbian",0,16,5,11,0
"porrapanchelirdertilogy",0,23,8,15,0
"ermin",1,5,2,3,0
"dringy",0,6,1,5,0
"bicbcmsnkgcxwmngplp",0,19,1,18,0
"basutra",0,7,3,4,0
"protoplasms",1,11,3,8,0
"assoilzied",1,10,5,5,0
"unposted",1,8,3,5,0
"bqslqzhbpqsxldxukblvc'apmvsmae",0,30,4,26,1
"vbavyjlent",0,10,2,8,0
"whatkin",0,7,2,5,0
"alxl'dmmghwtapo",0,15,3,12,1
"vpqhyc'av'td",0,12,1,11,2
"adetidocke",0,10,5,5,0
"dipterocarpaceae",1,16,8,8,0
"photostatis",0,11,4,7,0
"bulawayo",1,8,4,4,0
"suprative",0,9,4,5,0
"saleably",1,8,3,5,0
"cisicontoleidateresenatort",0,26,12,14,0
"leukaemons",0,10,5,5,0
"shopkeepery",1,11,4,7,0
"gabbert",1,7,2,5,0
"saxxgapdntfi'rrnk'zrtbsbvqj",0,27,3,24,2
"given",1,5,2,3,0
"drachino",0,8,3,5,0
"tezkererogresses",0,16,6,10,0
"benzoylated",1,11,4,7,0
"mareraerer",0,10,5,5,0
"saxcornet",1,9,3,6,0
"useneatolloptelicretis",0,22,10,12,0
"cupels",1,6,2,4,0
"teds",1,4,1,3,0
"springhouse",1,11,4,7,0
"hiniscisa",0,9,4,5,0
"falsifiers",1,10,4,6,0
"wanhap",1,6,2,4,0
"bedazzlers",0,10,3,7,0
"cvvvxs'zai",0,10,2,8,1
"premosaic",1,9,4,5,0
"paltongehabarons",0,16,6,10,0
"plusch",1,6,1,5,0
"gurging",0,7,2,5,0
"xenarthra",1,9,3,6,0
"mugeabilita",0,11,6,5,0
"robigo",1,6,3,3,0
"wils",0,4,1,3,0
"unt",0,3,1,2,0
"disrespectfully",1,15,4,11,0
"ischool",0,7,3,4,0
"legra",1,5,2,3,0
"papagay",1,7,3,4,0
"grippes",1,7,2,5,0
"maynard",1,7,2,5,0
"boubalungiorarwarg",0,18,8,10,0
"lendlers",1,8,2,6,0
"oppism",0,6,2,4,0
"baerentwidonbter",0,16,6,10,0
"nonvisualised",1,13,6,7,0
"rickwood",1,8,3,5,0
"disterer",0,8,3,5,0
"randomises",1,10,4,6,0
"scorza",1,6,2,4,0
"icitia",0,6,4,2,0
"demandable",1,10,4,6,0
"communichollywoodine",0,20,8,12,0
"copperbottom",1,12,4,8,0
"qtblcdevse'",0,11,2,9,1
"borstal",1,7,2,5,0
"walpurgating",0,12,4,8,0
"iaps",0,4,2,2,0
"acey",1,4,2,2,0
"untufted",1,8,3,5,0
"metamorphosian",1,14,6,8,0
"enclassificatories",0,18,8,10,0
"momyprildabenbsty",0,17,4,13,0
"tivacandaeresicyctrizetaloureeglongaral",0,39,17,22,0
"empassioned",1,11,5,6,0
"diospyros",1,9,3,6,0
"swatterings",0,11,3,8,0
"undetectably",1,12,4,8,0
"afolumjobuoh",0,12,6,6,0
"melee",1,5,3,2,0
"av'poqojkta",0,11,4,7,1
"cymbella",1,8,2,6,0
"zu'lkadah",1,9,3,6,1
"erdelanser",0,10,4,6,0
"ritivelon",0,9,4,5,0
"gologism",0,8,3,5,0
"accentristasis",0,14,5,9,0
"diani",0,5,3,2,0
"uninted",0,7,3,4,0
"sarcoping",0,9,3,6,0
"glossopode",1,10,4,6,0
"palaeichthyologists",1,19,7,12,0
"vanny",1,5,1,4,0
"estheses",0,8,3,5,0
"mtsqefgjfytqcoewuq'unmctrh",0,26,5,21,1
"momzers",1,7,2,5,0
"anisee",0,6,4,2,0
"kalmitic",0,8,3,5,0
"nigenianlike",0,12,6,6,0
"superinsanitating",0,17,7,10,0
"thbullynaralmencellulaynnallater",0,32,10,22,0
"lempirism",0,9,3,6,0
"basinet",1,7,3,4,0
"'loych",0,6,1,5,1
"beothetl",0,8,3,5,0
"tayside",1,7,3,4,0
"forzando",1,8,3,5,0
"minifloppies",1,12,5,7,0
"naturaled",0,9,4,5,0
"esodrayerichonwome",0,18,8,10,0
"obumeingeconrictehorsciequridinprararadiatte",0,44,20,24,0
"muscavada",1,9,4,5,0
"vqogoqwliptcdkwurcwo",0,20,5,15,0
"fthgxwz",0,7,0,7,0
"mistreadings",1,12,4,8,0
"madeiras",1,8,4,4,0
"toluyls",1,7,2,5,0
"enfeverous",0,10,5,5,0
"vlcaxodvhg",0,10,2,8,0
"undetected",1,10,4,6,0
"prenesses",0,9,3,6,0
"phucetithulexinernutestoplllymbontis",0,36,12,24,0
"vbmvkmjmbtlpriqe'djfey",0,22,3,19,1
"lsyuixgf'ghotmy'dggyv'aage",0,26,6,20,3
"jlrjogoelkndffhs''txlchiwblrva",0,30,5,25,2
"seie",0,4,3,1,0
"ccbqkssadazwqcwkhuuisa'pln",0,26,6,20,1
"goedichiable",0,12,6,6,0
"caudally",1,8,3,5,0
"boscessh",0,8,2,6,0
"mifen",0,5,2,3,0
"bozzaris",1,8,3,5,0
"nephometically",0,14,5,9,0
"heuchera",1,8,4,4,0
"cristine",1,8,3,5,0
"nostarnatordemionegly",0,21,8,13,0
"canthitis",1,9,3,6,0
"glucosidase",1,11,5,6,0
"nontoplastinopin",0,16,6,10,0
"usherer",1,7,3,4,0
"leniate",1,7,4,3,0
"mariswlurores",0,13,5,8,0
"shopbreaker",1,11,4,7,0
"ordemfratistabina",0,17,7,10,0
"overpermissibility",0,18,7,11,0
"borrichiases",0,12,5,7,0
"hexanichomepacked",0,17,7,10,0
"scaphander",1,10,3,7,0
"mnnatherescuss",0,14,4,10,0
"deuteronomistic",1,15,7,8,0
"indersion",0,9,4,5,0
"gqki'mehutmkoqqqulpzlkhfudfa",0,28,7,21,1
"'xyn",0,4,0,4,1
"tsail",0,5,2,3,0
"shookidae",0,9,5,4,0
"cellaria",0,8,4,4,0
"stropstrogelli",0,14,4,10,0
"chmetricony",0,11,3,8,0
"featherbedded",1,13,5,8,0
"probat",0,6,2,4,0
"properustic",0,11,4,7,0
"dodmeating",0,10,4,6,0
"ministership",1,12,4,8,0
"lauconjuncturatinenced",0,22,9,13,0
"unobjectified",1,13,6,7,0
"smqbh'jvswgtf",0,13,0,13,1
"grerc",0,5,1,4,0
"reintroducing",1,13,5,8,0
"preposterousness",1,16,6,10,0
"gunsmithings",1,12,3,9,0
"oqqdlfzjjy",0,10,1,9,0
"slifter",1,7,2,5,0
"unitions",1,8,4,4,0
"semanns",0,7,2,5,0
"tragmakin",0,9,3,6,0
"pfalz",1,5,1,4,0
"diapsida",1,8,4,4,0
"scalemom",0,8,3,5,0
"calyptrimorpha",0,14,4,10,0
"defes",0,5,2,3,0
"ly",1,2,0,2,0
"arosaguntacook",1,14,7,7,0
"plowwitten",0,10,3,7,0
"finiptyg",0,8,2,6,0
"wiivpxjaslrduww",0,15,4,11,0
"ropyidast",0,9,3,6,0
"racemations",1,11,5,6,0
"limbmeal",1,8,3,5,0
"energeticness",1,13,5,8,0
"phthalocyanine",1,14,5,9,0
"epvkhodprvkknuwrhb",0,18,3,15,0
"lisarcod",0,8,3,5,0
"surfacemaker",0,12,5,7,0
"adiscocestogarobangulionos",0,26,12,14,0
"inded",0,5,2,3,0
"scelests",0,8,2,6,0
"inet",0,4,2,2,0
"elaugglot",0,9,4,5,0
"groundling",1,10,3,7,0
"mariastein",1,10,5,5,0
"uneffableness",0,13,5,8,0
"bunghole",1,8,3,5,0
"groning",1,7,2,5,0
"lowerathenjudy",0,14,5,9,0
"amidofluoride",1,13,7,6,0
"weogufka",1,8,4,4,0
"deside",0,6,3,3,0
"overdesses",0,10,4,6,0
"torlyititror",0,12,4,8,0
"claustrophilia",1,14,6,8,0
"earuliverregmamondggrn",0,22,8,14,0
"mauvein",1,7,4,3,0
"sitella",1,7,3,4,0
"magnetotransmitter",1,18,6,12,0
"noncensurableness",1,17,6,11,0
"comapy",0,6,2,4,0
"winded",1,6,2,4,0
"iompgbjmd",0,9,2,7,0
"deoxyrrhotic",0,12,4,8,0
"glucine",1,7,3,4,0
"unchettologicality",0,18,7,11,0
"iat",0,3,2,1,0
"dzfazipvwsmymhyyxibkxgectky",0,27,4,23,0
"ula",1,3,2,1,0
"cheka",1,5,2,3,0
"daisy",1,5,2,3,0
"petitioning",1,11,5,6,0
"sumas",1,5,2,3,0
"tarente",1,7,3,4,0
"endorsayersvillested",0,20,7,13,0
"port",1,4,1,3,0
"protector",1,9,3,6,0
"cayce",1,5,2,3,0
"potiguara",1,9,5,4,0
"hamoderlaters",0,13,5,8,0
"righteousnesses",1,15,6,9,0
"lowriglycercourties",0,19,7,12,0
"complian",0,8,3,5,0
"ericetal",1,8,4,4,0
"ishtar",1,6,2,4,0
"ebh'pe'xmgcseftzsjz'tk",0,22,3,19,3
"resump",0,6,2,4,0
"expressures",1,11,4,7,0
"barmskin",1,8,2,6,0
"scientiarum",1,11,5,6,0
"squalization",0,12,6,6,0
"pretended",1,9,3,6,0
"vophdawuoocpegx",0,15,6,9,0
"fugened",0,7,3,4,0
"nbfb'dspdpesjfyqqj'nkfqe",0,24,2,22,2
"scarfish",1,8,2,6,0
"skryabinsk",0,10,2,8,0
"mencenobtifel",0,13,5,8,0
"pancreatomy",1,11,4,7,0
"lipans",1,6,2,4,0
"cebridalty",0,10,3,7,0
"bleagelvanontestenstae",0,22,9,13,0
"scouted",1,7,3,4,0
"phenocain",1,9,4,5,0
"unatesant",0,9,4,5,0
"kefauver",1,8,4,4,0
"hindusen",0,8,3,5,0
"anatifa",1,7,4,3,0
"hegari",1,6,3,3,0
"linguini",1,8,4,4,0
"celtish",1,7,2,5,0
"beyle",1,5,2,3,0
"qqphupcgxszfoqk'dddgmszh",0,24,2,22,1
"oblammonga",0,10,4,6,0
"haematinics",1,11,5,6,0
"vocality",1,8,3,5,0
"intones",1,7,3,4,0
"mccurdy",1,7,1,6,0
"fuggi",0,5,2,3,0
"roopit",1,6,3,3,0
"misentrails",0,11,4,7,0
"ealingoge",0,9,5,4,0
"matavince",0,9,4,5,0
"brwsweafnhahjlgrf",0,17,3,14,0
"unspinsterdom",0,13,4,9,0
"anticle",0,7,3,4,0
"mortification",1,13,6,7,0
"atenissm",0,8,3,5,0
"hima",1,4,2,2,0
"orterde",1,7,3,4,0
"trypanosomiasis",1,15,6,9,0
"unsparse",1,8,3,5,0
"goltry",1,6,1,5,0
"bogarisunbemaldonn",0,18,7,11,0
"polariostaging",0,14,6,8,0
"expurg",0,6,2,4,0
"deasils",1,7,3,4,0
"phyllome",1,8,2,6,0
"shamanistically",0,15,5,10,0
"eowogblfhx",0,10,3,7,0
"epionychium",1,11,5,6,0
"accormatothreaceae",0,18,9,9,0
"inhomogeneously",1,15,7,8,0
"cxoxfjoniuqfirszcxcvuf",0,22,6,16,0
"noradabi",0,8,4,4,0
"cdss",0,4,0,4,0
"subworkmen",0,10,3,7,0
"gckdisph'iimoajsrn",0,18,5,13,1
"undermented",0,11,4,7,0
"ptolemaean",1,10,5,5,0
"penhuans",0,8,3,5,0
"scc",1,3,0,3,0
"phenomenology",1,13,5,8,0
"amomeleased",0,11,6,5,0
"biogen",1,6,3,3,0
"grivoise",1,8,4,4,0
"pourpoint",1,9,4,5,0
"pbus'fm'c'aupvec",0,16,4,12,3
"flouncey",1,8,3,5,0
"ameers",1,6,3,3,0
"vcmyphqvlumkrv",0,14,1,13,0
"rampanctaber",0,12,4,8,0
"rotr",0,4,1,3,0
"vermountainous",0,14,7,7,0
"mowbray",1,7,2,5,0
"unquestionably",1,14,6,8,0
"incineramic",0,11,5,6,0
"unfrete",0,7,3,4,0
"diaphanie",1,9,5,4,0
"aquila",1,6,4,2,0
"collophanite",1,12,5,7,0
"hemerobiidae",1,12,7,5,0
"ments",0,5,1,4,0
"kmevjwdkqib",0,11,2,9,0
"participator",1,12,5,7,0
"bumens",0,6,2,4,0
"anglim",1,6,2,4,0
"quirked",1,7,3,4,0
"unstingingly",1,12,3,9,0
"emir",1,4,2,2,0
"classifically",1,13,4,9,0
"odontidae",0,9,5,4,0
"grocerdom",1,9,3,6,0
"armband",1,7,2,5,0
"lnxguxpcdnre",0,12,2,10,0
"raudespoder",0,11,5,6,0
"cinalilfos",0,10,4,6,0
"dentinoblastoma",0,15,6,9,0
"flinn",1,5,1,4,0
"plate",1,5,2,3,0
"backwort",1,8,2,6,0
"neglenestic",0,11,4,7,0
"noninferentially",1,16,6,10,0
"blacktree",1,9,3,6,0
"jutyd",0,5,1,4,0
"vasodilatoriness",0,16,7,9,0
"pedie",0,5,3,2,0
"dropflower",1,10,3,7,0
"stevenage",1,9,4,5,0
"gymnasias",0,9,3,6,0
"autearss",0,8,4,4,0
"sponsien",0,8,3,5,0
"stewers",1,7,2,5,0
"preacquisitively",1,16,7,9,0
"smbiceordurolarknaithy",0,22,8,14,0
"epithelioblastoma",1,17,8,9,0
"adrome",0,6,3,3,0
"poromess",0,8,3,5,0
"hyztbkdolplhpgmpynawxyacux",0,26,4,22,0
"qrnsg'vljnpqozqdvtmhiimpnsg",0,27,3,24,1
"whitepots",1,9,3,6,0
"procatory",0,9,3,6,0
"remercied",1,9,4,5,0
"bount",0,5,2,3,0
"wapjxkqiissyofvvdxe'",0,20,5,15,1
"osteology",1,9,4,5,0
"paediluviating",0,14,7,7,0
"randed",1,6,2,4,0
"hoodlumism",1,10,4,6,0
"gajnbotqzpri",0,12,3,9,0
"phatoblbedere",0,13,5,8,0
"tuberculeate",0,12,6,6,0
"sonous",0,6,3,3,0
"trum",0,4,1,3,0
"germanophils",1,12,4,8,0
"sacring",1,7,2,5,0
"thering",0,7,2,5,0
"photohemopyrrole",0,16,6,10,0
"unphilosophised",1,15,6,9,0
"unadmissible",1,12,5,7,0
"codiaeum",1,8,5,3,0
"skeuomorphic",1,12,5,7,0
"kellihenry",0,10,3,7,0
"tionikoney",0,10,5,5,0
"endorse",1,7,3,4,0
"libidinously",1,12,5,7,0
"kutzer",1,6,2,4,0
"gnetacentroph",0,13,4,9,0
"crunt",1,5,1,4,0
"rikelpha",0,8,3,5,0
"fairon",0,6,3,3,0
"irckuhqngvwttxjjqzskkv",0,22,2,20,0
"whoopsie",1,8,4,4,0
"snooking",1,8,3,5,0
"haema",0,5,3,2,0
"alterity",1,8,3,5,0
"roidrosionewists",0,16,7,9,0
"olare",0,5,3,2,0
"payability",1,10,4,6,0
"stretchberry",1,12,2,10,0
"imytrsthons",0,11,2,9,0
"nitringnessaspinglyprily",0,24,6,18,0
"invertor",1,8,3,5,0
"aubers",0,6,3,3,0
"nurses",1,6,2,4,0
"pangality",0,9,3,6,0
"charlesworth",1,12,3,9,0
"enolater",0,8,4,4,0
"evelyn",1,6,2,4,0
"hisambal",0,8,3,5,0
"functus",1,7,2,5,0
"hystereste",0,10,3,7,0
"evoy",1,4,2,2,0
"excoriator",1,10,5,5,0
"antipragmatisms",0,15,5,10,0
"earthquaken",1,11,5,6,0
"myzostoma",1,9,3,6,0
"predestined",1,11,4,7,0
"balisaurs",1,9,4,5,0
"deopyle",1,7,3,4,0
"catfight",1,8,2,6,0
"untoxicophysicographic",0,22,8,14,0
"tjad",0,4,1,3,0
"monity",0,6,2,4,0
"illeriornersifically",0,20,8,12,0
"viceronia",0,9,5,4,0
"lattlecal",0,9,3,6,0
"nodosariia",0,10,6,4,0
"canapina",1,8,4,4,0
"pricid",0,6,2,4,0
"mgu",0,3,1,2,0
"pennyworts",1,10,2,8,0
"ner",0,3,1,2,0
"genealogies",1,11,6,5,0
"squadder",1,8,3,5,0
"fishhook",1,8,3,5,0
"grappeachenshable",0,17,6,11,0
"nxqnbhmtarfl'cruwydm",0,20,2,18,1
"irretractable",1,13,5,8,0
"auburnt",0,7,3,4,0
"universalist",1,12,5,7,0
"symphoniousness",0,15,5,10,0
"marifrangiotelephone",0,20,9,11,0
"senzer",1,6,2,4,0
"premiscoplanomisress",0,20,7,13,0
"gillet",1,6,2,4,0
"cheliphalones",0,13,5,8,0
"subdititious",1,12,6,6,0
"nonconya",0,8,3,5,0
"dassins",0,7,2,5,0
"herlasm",0,7,2,5,0
"pushpin",1,7,2,5,0
"rengeat",0,7,3,4,0
"chimneybreasts",1,14,4,10,0
"braun",1,5,2,3,0
"blepharosynechia",1,16,6,10,0
"moogrosymphobollerminitryo",0,26,9,17,0
"goosey",1,6,3,3,0
"counterlocutory",0,15,6,9,0
"thurrock",1,8,2,6,0
"phytenpictetizvelilsieraph",0,26,9,17,0
"airbursts",1,9,3,6,0
"baddyprophadioan",0,16,6,10,0
"flatto",1,6,2,4,0
"mannie",1,6,3,3,0
"infaicalvoks",0,12,5,7,0
"furner",0,6,2,4,0
"tjdiqixpfbm",0,11,2,9,0
"thyroidisms",0,11,3,8,0
"whodestivemaipanncalyarid",0,25,10,15,0
"teleutherners",0,13,5,8,0
"songles",0,7,2,5,0
"oxjtsljymnu'c",0,13,2,11,1
"counterattestation",1,18,8,10,0
"undesiri",0,8,4,4,0
"gopher",1,6,2,4,0
"phetacalcide",0,12,5,7,0
"oarite",0,6,4,2,0
"postholer",0,9,3,6,0
"porkling",1,8,2,6,0
"reinstalments",1,13,4,9,0
"megahertzes",1,11,4,7,0
"atheise",1,7,4,3,0
"dichotricus",0,11,4,7,0
"blals",0,5,1,4,0
"backstarting",1,12,3,9,0
"dista",0,5,2,3,0
"spinoperipheral",1,15,6,9,0
"reic",0,4,2,2,0
"hammerbird",1,10,3,7,0
"snivellements",0,13,4,9,0
"braggings",1,9,2,7,0
"neuterist",0,9,4,5,0
"hundi",1,5,2,3,0
"nonism",0,6,2,4,0
"wxdoxkknatichzwrilkpd",0,21,4,17,0
"hyposis",0,7,2,5,0
"eludicatory",1,11,5,6,0
"ehlke",1,5,2,3,0
"auff",0,4,2,2,0
"lemonnier",1,9,4,5,0
"aiguelle",1,8,5,3,0
"elstonetobtaging",0,16,6,10,0
"maoritanga",1,10,5,5,0
"vassimosgench",0,13,4,9,0
"hexastillaries",0,14,6,8,0
"dryopithetosity",0,15,5,10,0
"angusels",0,8,3,5,0
"villote",1,7,3,4,0
"wyvjngfcitdgua",0,14,3,11,0
"anionmitae",0,10,6,4,0
"matagorda",1,9,4,5,0
"inting",0,6,2,4,0
"proofs",1,6,2,4,0
"xzxbredmpmmdnwjbbdxhaffkuupi",0,28,5,23,0
"vs'votsjgc",0,10,1,9,1
"glgwqxglxgexmy",0,14,1,13,0
"reverexpreseizure",0,17,8,9,0
"organization",0,12,6,6,0
"cagn",1,4,1,3,0
"larprogruss",0,11,3,8,0
"pipets",1,6,2,4,0
"grooming",1,8,3,5,0
"scaldberry",0,10,2,8,0
"iancath",0,7,3,4,0
"agnates",1,7,3,4,0
"babbeyance",0,10,4,6,0
"nucleonics",1,10,4,6,0
"sivvyyines",0,10,3,7,0
"zonure",1,6,3,3,0
"shote",1,5,2,3,0
"discotshipsyllophisms",0,21,5,16,0
"swithers",1,8,2,6,0
"saphar",1,6,2,4,0
"hoffnung",1,8,2,6,0
"n'plit",0,6,1,5,1
"musnud",1,6,2,4,0
"liga",0,4,2,2,0
"megalohepatia",1,13,7,6,0
"ritthizolat",0,11,4,7,0
"bagpiece",0,8,4,4,0
"supramechanical",1,15,6,9,0
"boac",1,4,2,2,0
"teleg",1,5,2,3,0
"handax",1,6,2,4,0
"martinson",1,9,3,6,0
"icebox",1,6,3,3,0
"lacrymations",1,12,4,8,0
"euryalean",1,9,5,4,0
"framboesia",1,10,5,5,0
"bigam",1,5,2,3,0
"eezpajq",0,7,3,4,0
"snuffing",1,8,2,6,0
"degradation",1,11,5,6,0
"carnalism",1,9,3,6,0
"wylma",1,5,1,4,0
"petiolatry",0,10,4,6,0
"burgee",1,6,3,3,0
"archielazygotics",0,16,6,10,0
"jbq'cvvggnupgbbigbvtpixwwk",0,26,3,23,1
"libertarian",1,11,5,6,0
"hypochlorura",0,12,4,8,0
"teagle",1,6,3,3,0
"picotaponombiseronnde",0,21,9,12,0
"pteraspid",1,9,3,6,0
"storewide",1,9,4,5,0
"cuite",0,5,3,2,0
"ambiguousness",1,13,6,7,0
"'ct'as'jklxjb",0,13,1,12,3
"lieutenandt",0,11,5,6,0
"q'ph'gqzwpwy",0,12,0,12,2
"prepubl",0,7,2,5,0
"unbranicipidireston",0,19,8,11,0
"janitress",1,9,3,6,0
"impersonate",1,11,5,6,0
"chaselectrifectant",0,18,6,12,0
"assekhwanging",0,13,4,9,0
"pseudosomen",0,11,5,6,0
"uricetsh",0,8,3,5,0
"pective",0,7,3,4,0
"omay",0,4,2,2,0
"kehkmgexxcwsbrep",0,16,3,13,0
"personalist",1,11,4,7,0
"phyllanthes",0,11,2,9,0
"enhjan",0,6,2,4,0
"rger",0,4,1,3,0
"preha",0,5,2,3,0
"rieale",0,6,4,2,0
"laccolitic",1,10,4,6,0
"altisonant",1,10,4,6,0
"heterotype",1,10,4,6,0
"sonorrkoping",0,12,4,8,0
"atenist",1,7,3,4,0
"harbourer",1,9,4,5,0
"fumiferana",1,10,5,5,0
"favorable",0,9,4,5,0
"brassate",1,8,3,5,0
"arnuad",1,6,3,3,0
"bewrays",1,7,2,5,0
"overstrewing",1,12,4,8,0
"barbaker",0,8,3,5,0
"impactual",1,9,4,5,0
"robiessed",0,9,4,5,0
"nannofossil",1,11,4,7,0
"bremen",1,6,2,4,0
"templeville",1,11,4,7,0
"gibberoses",0,10,4,6,0
"blivit",1,6,2,4,0
"worst",1,5,1,4,0
"cade",1,4,2,2,0
"sargasso",1,8,3,5,0
"mirthsome",1,9,3,6,0
"parabolanus",1,11,5,6,0
"gqvcjpfvzxs",0,11,0,11,0
"prolinmilly",0,11,3,8,0
"dredianolied",0,12,6,6,0
"gameless",1,8,3,5,0
"siltlb",0,6,1,5,0
"carates",1,7,3,4,0
"chalcographer",1,13,4,9,0
"polyphore",1,9,3,6,0
"mermatics",0,9,3,6,0
"icomkhxdijrqztktgdfutpc",0,23,4,19,0
"pentathionic",1,12,5,7,0
"phildbankt",0,10,2,8,0
"yokelry",1,7,2,5,0
"asweenon",0,8,4,4,0
"predestiness",0,12,4,8,0
"monembryonary",0,13,4,9,0
"bulblets",1,8,2,6,0
"brasser",1,7,2,5,0
"fumigatories",1,12,6,6,0
"gabriele",1,8,4,4,0
"invariance",1,10,5,5,0
"scoricals",0,9,3,6,0
"microfiches",1,11,4,7,0
"xekzisbiftq'ouvfid",0,18,6,12,1
"ogcsjmaqvhforrpbqrgyz'dqgos",0,27,4,23,1
"betulant",0,8,3,5,0
"gravelling",1,10,3,7,0
"phmos",0,5,1,4,0
"anachoret",1,9,4,5,0
"tztblpazkcutmjoeonqegtsivxp",0,27,7,20,0
"kcdomydqflu",0,11,2,9,0
"denaturalises",1,13,6,7,0
"lalo",1,4,2,2,0
"brolounsfagarjois",0,17,7,10,0
"porphilists",0,11,3,8,0
"misbelievingly",1,14,5,9,0
"unenvyingklunky",0,15,4,11,0
"overwheed",0,9,4,5,0
"blrvchejntypgsmf",0,16,1,15,0
"cornfactor",1,10,3,7,0
"ruscher",1,7,2,5,0
"sks'wjkktgftz",0,13,0,13,1
"leftfield",1,9,3,6,0
"axemasterdom",0,12,5,7,0
"min",1,3,1,2,0
"hydroponist",1,11,3,8,0
"apetalaceae",0,11,7,4,0
"allegan",1,7,3,4,0
"thrall",1,6,1,5,0
"cisc",1,4,1,3,0
"aventures",1,9,4,5,0
"hvunyyxp",0,8,1,7,0
"undeteriorated",1,14,7,7,0
"antistalling",1,12,4,8,0
"retrievings",1,11,4,7,0
"diest",0,5,2,3,0
"milla",1,5,2,3,0
"hosta",1,5,2,3,0
"faint",1,5,2,3,0
"bortypretrprerstaurs",0,20,5,15,0
"becramp",1,7,2,5,0
"pareiasauri",1,11,7,4,0
"'douqkczzfffrwtukxssj",0,21,3,18,1
"swaliest",1,8,3,5,0
"electrofused",1,12,5,7,0
"dhaulagiri",1,10,5,5,0
"handboard",0,9,3,6,0
"nyind",0,5,1,4,0
"restrism",0,8,2,6,0
"aevite",0,6,4,2,0
"qgt'xkzyelftpn",0,14,1,13,1
"upslangracioster",0,16,6,10,0
"quando",1,6,3,3,0
"accordancy",1,10,3,7,0
"bers",0,4,1,3,0
"disgustfulness",0,14,4,10,0
"hontie",0,6,3,3,0
"phytochemicals",1,14,4,10,0
"polychromatophilia",1,18,7,11,0
"unicornid",0,9,4,5,0
"pertusariaceae",1,14,8,6,0
"denayed",1,7,3,4,0
"pedalos",1,7,3,4,0
"piebald",1,7,3,4,0
"dlasktwfqatpkwech",0,17,3,14,0
"twaddlement",1,11,3,8,0
"fulnesswombielepig",0,18,7,11,0
"styloidy",0,8,2,6,0
"yareta",1,6,3,3,0
"bafta",1,5,2,3,0
"indulgencing",1,12,4,8,0
"demulsify",1,9,3,6,0
"lae",1,3,2,1,0
"touns",1,5,2,3,0
"mism",0,4,1,3,0
"sacrificialisms",0,15,6,9,0
"pseudoan",0,8,4,4,0
"assertative",1,11,5,6,0
"lic",0,3,1,2,0
"unallergic",1,10,4,6,0
"slain",0,5,2,3,0
"youthworth",0,10,3,7,0
"osphygmomancy",0,13,3,10,0
"batilda",1,7,3,4,0
"creaser",1,7,3,4,0
"wabbsts",0,7,1,6,0
"balarama",1,8,4,4,0
"novatory",1,8,3,5,0
"subb",0,4,1,3,0
"dearliness",0,10,4,6,0
"vocimantially",0,13,5,8,0
"nonwetted",1,9,3,6,0
"kalamkaris",1,10,4,6,0
"'robqksznzijsjbtbnlfopyhva",0,26,4,22,1
"vesuvians",1,9,4,5,0
"luxembourg",1,10,4,6,0
"shakopee",1,8,4,4,0
"arammicalthizallecha",0,20,8,12,0
"granulary",1,9,3,6,0
"classicisms",1,11,3,8,0
"vamphorn",1,8,2,6,0
"outechoirs",0,10,5,5,0
"lipsone",0,7,3,4,0
"poockerulliellyoin",0,18,8,10,0
"serosanguineous",1,15,8,7,0
"nonpassionate",1,13,6,7,0
"iomi",0,4,3,1,0
"trea",0,4,2,2,0
"leafletting",1,11,4,7,0
"subprief",0,8,3,5,0
"firistraclawbircationnialle",0,27,11,16,0
"deodar",1,6,3,3,0
"tetrain",0,7,3,4,0
"pycnidium",1,9,3,6,0
"ndeng",0,5,1,4,0
"libiyjejtpxc",0,12,3,9,0
"estafetted",1,10,4,6,0
"nonabdication",1,13,6,7,0
"friand",1,6,2,4,0
"decompensated",1,13,5,8,0
"dedramatical",0,12,5,7,0
"unfrequented",1,12,5,7,0
"countercry",1,10,3,7,0
"grary",0,5,1,4,0
"topsyturvification",1,18,7,11,0
"avitic",1,6,3,3,0
"distrates",0,9,3,6,0
"hyalitises",1,10,4,6,0
"mootmen",1,7,3,4,0
"ardhamagadhi",1,12,5,7,0
"baats",0,5,2,3,0
"compkerius",0,10,4,6,0
"jsdmki",0,6,1,5,0
"forcienetahageniasespatel",0,25,12,13,0
"pyrazoles",1,9,3,6,0
"juvenolatry",0,11,4,7,0
"haplochlamydeous",1,16,6,10,0
"mutts",1,5,1,4,0
"lakers",1,6,2,4,0
"izzard",1,6,2,4,0
"scalpless",1,9,2,7,0
"esuen",0,5,3,2,0
"pleryenounut",0,12,5,7,0
"melts",1,5,1,4,0
"huari",1,5,3,2,0
"braggadocian",0,12,5,7,0
"gramophora",0,10,4,6,0
"counday",0,7,3,4,0
"aram",1,4,2,2,0
"ensnarements",1,12,4,8,0
"rescuable",1,9,4,5,0
"choddy",0,6,1,5,0
"consolatory",1,11,4,7,0
"trepan",1,6,2,4,0
"zurrhduaafwloevpcxuoyl",0,22,8,14,0
"cedarlane",1,9,4,5,0
"rogeographian",0,13,6,7,0
"ringness",0,8,2,6,0
"overvalued",1,10,5,5,0
"adrostral",1,9,3,6,0
"tieric",0,6,3,3,0
"hypersophist",0,12,3,9,0
"sodomitish",1,10,4,6,0
"ropishness",1,10,3,7,0
"idzucryitiytrhgkuxadqjkv",0,24,6,18,0
"fenneedlecretical",0,17,7,10,0
"rhumb",1,5,1,4,0
"stammers",1,8,2,6,0
"miyasawa",1,8,4,4,0
"salpingitis",1,11,4,7,0
"macrot",0,6,2,4,0
"hyperver",0,8,2,6,0
"cieore",0,6,4,2,0
"bleacheries",1,11,5,6,0
"jolloped",1,8,3,5,0
"proatheistic",1,12,5,7,0
"dsjcxjuxcfpq",0,12,1,11,0
"byronicum",0,9,3,6,0
"mudloggers",1,10,3,7,0
"kylessestrook",0,13,4,9,0
"slockdolagers",1,13,4,9,0
"thoracostracan",1,14,5,9,0
"hypercholested",0,14,4,10,0
"rededicate",1,10,5,5,0
"voetinae",0,8,5,3,0
"bai",1,3,2,1,0
"itymipeseaeanesquracarides",0,26,13,13,0
"oztdwuqjdcukhaolfpxx",0,20,5,15,0
"reediest",1,8,4,4,0
"minoa",1,5,3,2,0
"scarck",0,6,1,5,0
"outpried",1,8,4,4,0
"rzfchcbftlampufthtto'biay",0,25,5,20,1
"vmjlosvkao'eajlctr'",0,19,5,14,2
"iodate",1,6,4,2,0
"misosophist",1,11,4,7,0
"whiners",1,7,2,5,0
"arvier",0,6,3,3,0
"ehulqn''amswcgkns",0,17,3,14,2
"fwhm",1,4,0,4,0
"lmxpyulfizfz",0,12,2,10,0
"leucocythaemias",1,15,7,8,0
"cuinechadecentaterary",0,21,9,12,0
"intercommuned",1,13,5,8,0
"newsweek",1,8,3,5,0
"reaterdereobersensuscallinet",0,28,12,16,0
"yeyecodndpg",0,11,3,8,0
"borgeson",1,8,3,5,0
"linchet",1,7,2,5,0
"parky",1,5,1,4,0
"brididactionworking",0,19,7,12,0
"franking",1,8,2,6,0
"suppression",1,11,4,7,0
"maryland",1,8,2,6,0
"schoolmasterhood",1,16,6,10,0
"presol",0,6,2,4,0
"displenishes",1,12,4,8,0
"tropidoleptus",1,13,5,8,0
"ingurgitation",1,13,6,7,0
"polyanhydipelashebtech",0,22,7,15,0
"anhaematoma",0,11,6,5,0
"ablegating",0,10,4,6,0
"irresolutions",1,13,6,7,0
"hypsistarian",1,12,4,8,0
"hydrow",0,6,1,5,0
"greatish",1,8,3,5,0
"ulturg",0,6,2,4,0
"wingedness",1,10,3,7,0
"w'nmgxxrjrtviabqyrha",0,20,3,17,1
"supernation",1,11,5,6,0
"cuckie",0,6,3,3,0
"meshuggener",1,11,4,7,0
"bearbines",1,9,4,5,0
"dorchester",1,10,3,7,0
"noncollusion",1,12,5,7,0
"sarches",0,7,2,5,0
"ypz'otvzomjevhnpdx",0,18,3,15,1
"upleg",1,5,2,3,0
"bbourvis",0,8,3,5,0
"stylograph",1,10,2,8,0
"compoer",1,7,3,4,0
"variewed",0,8,4,4,0
"dichromism",1,10,3,7,0
"extendibility",1,13,5,8,0
"monerenc",0,8,3,5,0
"freelfts",0,8,2,6,0
"slewer",1,6,2,4,0
"sargapehatitinanthr",0,19,7,12,0
"rearers",1,7,3,4,0
"wisping",1,7,2,5,0
"paboimpasi",0,10,5,5,0
"chprenoxybin",0,12,3,9,0
"pl",1,2,0,2,0
"bannotarulians",0,14,6,8,0
"stabilises",1,10,4,6,0
"cemetery",1,8,3,5,0
"zzt",1,3,0,3,0
"walkingsticks",1,13,3,10,0
"walf",0,4,1,3,0
"neuromusculature",1,16,8,8,0
"immersions",1,10,4,6,0
"susists",0,7,2,5,0
"fissioninae",0,11,6,5,0
"undecretariat",0,13,6,7,0
"gl'oswbrnxhs",0,12,1,11,1
"saccharoceptor",1,14,5,9,0
"dissave",1,7,3,4,0
"holnelica",0,9,4,5,0
"chemicophysical",1,15,5,10,0
"stubrunner",1,10,3,7,0
"matorbootelboacos",0,17,8,9,0
"rev",1,3,1,2,0
"profite",0,7,3,4,0
"chilogist",0,9,3,6,0
"huguenotisms",1,12,5,7,0
"eucyclic",1,8,3,5,0
"joelism",0,7,3,4,0
"guest",1,5,2,3,0
"pedestalling",1,12,4,8,0
"kryolitions",0,11,4,7,0
"merrin",0,6,2,4,0
"abisid",0,6,3,3,0
"ideans",0,6,3,3,0
"enplaned",1,8,3,5,0
"riakityseachrs",0,14,5,9,0
"abulfeda",1,8,4,4,0
"clathrina",1,9,3,6,0
"gulfhammonology",0,15,5,10,0
"carouser",1,8,4,4,0
"komupatioracesydogiorors",0,24,11,13,0
"misentitle",1,10,4,6,0
"trinitrotoluene",1,15,7,8,0
"tarabar",1,7,3,4,0
"inlaced",1,7,3,4,0
"heminals",0,8,3,5,0
"location",1,8,4,4,0
"pseleberium",0,11,5,6,0
"cornite",0,7,3,4,0
"outgrowth",1,9,3,6,0
"sardist",0,7,2,5,0
"mifinlltorchencheblicediripotene",0,32,12,20,0
"coups",1,5,2,3,0
"ficomendramilly",0,15,5,10,0
"stres",0,5,1,4,0
"nervosanguineous",1,16,8,8,0
"antensephesweinglaraeni",0,23,10,13,0
"edwarmbrutage",0,13,5,8,0
"elderly",1,7,2,5,0
"hortyard",1,8,2,6,0
"affeares",1,8,4,4,0
"thuswise",1,8,3,5,0
"gingelli",1,8,3,5,0
"joysome",1,7,3,4,0
"adagy",1,5,2,3,0
"gunzian",1,7,3,4,0
"posewhist",0,9,3,6,0
"caqueteuses",1,11,6,5,0
"polier",0,6,3,3,0
"argyroneta",1,10,4,6,0
"procta",0,6,2,4,0
"microtechnic",1,12,4,8,0
"clootirditidorus",0,16,7,9,0
"zbkxhrerrhszct",0,14,1,13,0
"histotrophy",1,11,3,8,0
"ddgattctvhzprdgixe'ze",0,21,4,17,1
"deans",1,5,2,3,0
"nonpenitent",1,11,4,7,0
"ruessish",0,8,3,5,0
"bestincket",0,10,3,7,0
"pdcqr",0,5,0,5,0
"mul",0,3,1,2,0
"renarese",0,8,4,4,0
"undrilion",0,9,4,5,0
"deflatis",0,8,3,5,0
"hyoplasty",0,9,2,7,0
"eucoxcoricalnekts",0,17,7,10,0
"garrat",1,6,2,4,0
"telotaxis",1,9,4,5,0
"fluolisatingly",0,14,5,9,0
"herefordshire",1,13,5,8,0
"flavanthrone",1,12,4,8,0
"ealcoessophown",0,14,6,8,0
"plutonomic",0,10,4,6,0
"glabelmouthielsvilletta",0,23,9,14,0
"ranomarring",0,11,4,7,0
"indehiscences",1,13,5,8,0
"fluorimetries",1,13,6,7,0
"avokpjbbvygpvnllieutb",0,21,5,16,0
"ellipticities",1,13,6,7,0
"crenella",1,8,3,5,0
"gurmukhi",1,8,3,5,0
"couspupered",0,11,5,6,0
"mrujnefgrgnpfs",0,14,2,12,0
"wetkint",0,7,2,5,0
"luppdwkukyjimrbt'kaqasza",0,24,6,18,1
"larner",1,6,2,4,0
"cavitically",0,11,4,7,0
"sfuluver",0,8,3,5,0
"olich",0,5,2,3,0
"'yuyjw",0,6,1,5,1
"polysyllabi",0,11,3,8,0
"prednisone",1,10,4,6,0
"scoureetteran",0,13,6,7,0
"excipula",1,8,4,4,0
"emmity",0,6,2,4,0
"gloater",1,7,3,4,0
"mismaker",0,8,3,5,0
"oeillades",1,9,5,4,0
"quinnipiac",1,10,5,5,0
"osselets",1,8,3,5,0
"stist",0,5,1,4,0
"opy",0,3,1,2,0
"neur",0,4,2,2,0
"contendance",0,11,4,7,0
"facturable",0,10,4,6,0
"birdcatcher",1,11,3,8,0
"clayhole",1,8,3,5,0
"calisedumkaryopittes",0,20,8,12,0
"hoydenisms",1,10,3,7,0
"pindaric",1,8,3,5,0
"laric",0,5,2,3,0
"obsidence",0,9,4,5,0
"millines",1,8,3,5,0
"archaemisationturalists",0,23,10,13,0
"clingletinites",0,14,5,9,0
"tiding",1,6,2,4,0
"palaverer",1,9,4,5,0
"exscisse",0,8,3,5,0
"subconical",1,10,4,6,0
"anior",0,5,3,2,0
"uneffusion",0,10,5,5,0
"yamaskino",0,9,4,5,0
"calgon",1,6,2,4,0
"aparance",0,8,4,4,0
"yeoqvoeo''x'",0,12,5,7,3
"zolaesque",1,9,5,4,0
"catiephen",0,9,4,5,0
"cotemporaries",1,13,6,7,0
"glaverer",0,8,3,5,0
"orphipcherathiater",0,18,7,11,0
"isogamy",1,7,3,4,0
"severcombia",0,11,5,6,0
"bracillocognes",0,14,5,9,0
"shipranzans",0,11,3,8,0
"misalleging",1,11,4,7,0
"jookerincocklest",0,16,6,10,0
"drollishness",1,12,3,9,0
"rhrafogerhhoanoprifas",0,21,8,13,0
"sheepfaced",1,10,4,6,0
"cadecapamoubsirerudn",0,20,9,11,0
"esmaria",1,7,4,3,0
"nonbelligerency",1,15,5,10,0
"poreticess",0,10,4,6,0
"inductile",1,9,4,5,0
"prioress",1,8,3,5,0
"feneyanariandearloy",0,19,9,10,0
"cxnrwplxuzqn'w",0,14,1,13,1
"bjnuwcb",0,7,1,6,0
"hairlike",1,8,4,4,0
"dbhp'tmdkjbsdouuecxxddxdsuxt",0,28,5,23,1
"aite",0,4,3,1,0
"adaptings",0,9,3,6,0
"zxprcqic",0,8,1,7,0
"gkzhqfdrsmzgpdtphbkl",0,20,0,20,0
"kim'xnkvust",0,11,2,9,1
"mecdcfgbangtbjzukgevhqzseuzapy",0,30,7,23,0
"silctdkcdvmvjbsgrssdjepqqv",0,26,2,24,0
"trityles",0,8,2,6,0
"jaspis",1,6,2,4,0
"demibarren",0,10,4,6,0
"wsbvn",0,5,0,5,0
"sxiwpwiyfnayyupkjfujwyzdqrs",0,27,5,22,0
"testicardines",1,13,5,8,0
"subclauch",0,9,3,6,0
"bastic",0,6,2,4,0
"dustcart",1,8,2,6,0
"bachella",0,8,3,5,0
"oriana",1,6,4,2,0
"mastodont",1,9,3,6,0
"sunae",0,5,3,2,0
"herenainontrfileilid",0,20,9,11,0
"ankingraver",0,11,4,7,0
"mesonemertini",1,13,6,7,0
"zjlxypffer",0,10,1,9,0
"sinisteries",0,11,5,6,0
"carnifies",1,9,4,5,0
"porphyrogenitism",1,16,5,11,0
"nasute",1,6,3,3,0
"isgwpywb",0,8,1,7,0
"combinative",1,11,5,6,0
"soolera",0,7,4,3,0
"nwkuobdeedk",0,11,4,7,0
"prudells",0,8,2,6,0
"mohabidowozares",0,15,7,8,0
"transposing",1,11,3,8,0
"dallogenoncombries",0,18,7,11,0
"nidium",0,6,3,3,0
"messan",1,6,2,4,0
"yahvistically",0,13,4,9,0
"chylocaulously",1,14,5,9,0
"bioactive",1,9,5,4,0
"sac",1,3,1,2,0
"ukokqltchuam",0,12,4,8,0
"opportunisms",1,12,4,8,0
"blaitially",0,10,4,6,0
"diphthongised",1,13,4,9,0
"whighilltbleraesucaupe",0,22,9,13,0
"scanel",0,6,2,4,0
"slended",0,7,2,5,0
"acean",0,5,3,2,0
"halimot",1,7,3,4,0
"noisiness",1,9,4,5,0
"raptorious",1,10,5,5,0
"smootisericately",0,16,7,9,0
"uninstanced",1,11,4,7,0
"mulaprakriti",1,12,5,7,0
"evols",0,5,2,3,0
"sawsetter",1,9,3,6,0
"wited",1,5,2,3,0
"cumingtrus",0,10,3,7,0
"egbeaution",0,10,6,4,0
"zainer",0,6,3,3,0
"melioratively",1,13,6,7,0
"coprosma",1,8,3,5,0
"qanaes",0,6,3,3,0
"adendrium",0,9,4,5,0
"chroman",0,7,2,5,0
"poima",0,5,3,2,0
"unliturgist",0,11,4,7,0
"dwnd",0,4,0,4,0
"gnvpon",0,6,1,5,0
"mpedistisane",0,12,5,7,0
"unoratown",0,9,4,5,0
"ferrateen",1,9,4,5,0
"cabernets",1,9,3,6,0
"hermetamen",0,10,4,6,0
"alienation",1,10,6,4,0
"hekhsher",1,8,2,6,0
"dise",0,4,2,2,0
"collely",0,7,2,5,0
"ibcba",0,5,2,3,0
"ssoterldaninfis",0,15,5,10,0
"magnums",1,7,2,5,0
"almanontateney",0,14,6,8,0
"polyganglionic",1,14,5,9,0
"unenhanced",1,10,4,6,0
"auditoria",1,9,6,3,0
"allocryptic",1,11,3,8,0
"drabetted",0,9,3,6,0
"waylandscape",0,12,4,8,0
"upupa",1,5,3,2,0
"sallenerermhitaraxcouinecoanttanead",0,35,16,19,0
"bedell",1,6,2,4,0
"intersealingual",0,15,7,8,0
"mortificator",0,12,5,7,0
"povs",0,4,1,3,0
"photodecomposition",1,18,8,10,0
"lianatiaracilorinchedy",0,22,10,12,0
"deophoniest",0,11,5,6,0
"barklice",1,8,3,5,0
"unimpresumpster",0,15,5,10,0
"sothonganius",0,12,5,7,0
"weteriaes",0,9,5,4,0
"retreatant",1,10,4,6,0
"airfreight",1,10,4,6,0
"thermostatting",1,14,4,10,0
"weigel",1,6,3,3,0
"effluenzali",0,11,5,6,0
"jesuitisms",1,10,4,6,0
"reces",0,5,2,3,0
"truthlessness",0,13,3,10,0
"headwards",1,9,3,6,0
"synaphea",1,8,3,5,0
"'lgzjstrvskpobtpiskdeebcq",0,25,4,21,1
"houdifid",0,8,4,4,0
"muk",0,3,1,2,0
"argyroteologist",0,15,6,9,0
"flexography",1,11,3,8,0
"olouansupoghe",0,13,7,6,0
"thugging",1,8,2,6,0
"cottekill",1,9,3,6,0
"sinclairville",1,13,5,8,0
"playton",0,7,2,5,0
"'gvogv",0,6,1,5,1
"nictitant",1,9,3,6,0
"songbook",1,8,3,5,0
"perjuring",1,9,3,6,0
"stiones",0,7,3,4,0
"scoplandaal",0,11,4,7,0
"hidean",0,6,3,3,0
"hissings",1,8,2,6,0
"ttadachaeblabishets",0,19,7,12,0
"schbergera",0,10,3,7,0
"metropolises",1,12,5,7,0
"wznmgfrddnfekbvycccxg",0,21,1,20,0
"purcellville",1,12,4,8,0
"cyanoguanins",0,12,5,7,0
"pamphletizing",1,13,4,9,0
"corporealists",1,13,5,8,0
"tetic",0,5,2,3,0
"chalic",0,6,2,4,0
"notectric",0,9,3,6,0
"mserongledonoourawr",0,19,8,11,0
"extravisceral",1,13,5,8,0
"respringer",0,10,3,7,0
"mont",1,4,1,3,0
"ogare",0,5,3,2,0
"cowfuledinatinirimaygenanmuetwkeonne",0,36,16,20,0
"rastles",1,7,2,5,0
"willo",0,5,2,3,0
"succulence",1,10,4,6,0
"ultun",1,5,2,3,0
"brckme",0,6,1,5,0
"badgerwet",0,9,3,6,0
"prognostically",1,14,4,10,0
"espressos",1,9,3,6,0
"toko",1,4,2,2,0
"sterna",1,6,2,4,0
"mylotyphalenosities",0,19,7,12,0
"craryville",1,10,3,7,0
"catholidae",0,10,5,5,0
"lethyphidaininstircnaralteass",0,29,10,19,0
"examiner",1,8,4,4,0
"settablenesses",0,14,5,9,0
"noniness",0,8,3,5,0
"ungenuine",1,9,5,4,0
"kacgmq'hdjbvxlfn",0,16,1,15,1
"waygooses",1,9,4,5,0
"bionuntapelaciffele",0,19,9,10,0
"barognosis",1,10,4,6,0
"mavin",1,5,2,3,0
"terwar",0,6,2,4,0
"illine",0,6,3,3,0
"qsrhnvgesjdqvnjh",0,16,1,15,0
"reests",1,6,2,4,0
"aliber",1,6,3,3,0
"allisan",1,7,3,4,0
"scins",0,5,1,4,0
"leavisite",1,9,5,4,0
"ambushments",1,11,3,8,0
"cephalus",1,8,3,5,0
"pheshanonactobit",0,16,6,10,0
"diffuser",1,8,3,5,0
"dupuis",1,6,3,3,0
"gidweq",0,6,2,4,0
"saburration",1,11,5,6,0
"sarcosmeteest",0,13,5,8,0
"chrylioleaxicalatind",0,20,8,12,0
"overfertilise",0,13,6,7,0
"preimbursednesses",0,17,6,11,0
"goie",0,4,3,1,0
"bridarmantlist",0,14,4,10,0
"pyg",0,3,0,3,0
"accitotred",0,10,4,6,0
"anomas",0,6,3,3,0
"hyperostographic",0,16,5,11,0
"excesse",0,7,3,4,0
"thumby",1,6,1,5,0
"brockiele",0,9,4,5,0
"retried",1,7,3,4,0
"aptjryucungqyirecxwwnigi",0,24,7,17,0
"mpequphatiatricorilloas",0,23,10,13,0
"plashingly",1,10,2,8,0
"stical",0,6,2,4,0
"acousiness",0,10,5,5,0
"fisiae",0,6,4,2,0
"langite",1,7,3,4,0
"lizzie",1,6,3,3,0
"matthau",1,7,3,4,0
"oligochronin",0,12,5,7,0
"attanerrizethd",0,14,5,9,0
"helios",1,6,3,3,0
"unstarting",1,10,3,7,0
"overses",0,7,3,4,0
"sensualists",1,11,4,7,0
"foulletta",0,9,4,5,0
"intemethid",0,10,4,6,0
"gisharogetaplylontecly",0,22,7,15,0
"dictator",1,8,3,5,0
"qtksqxpcicgkqkfdzfkrxands",0,25,2,23,0
"fudder",1,6,2,4,0
"megatheriid",1,11,5,6,0
"jctn",1,4,0,4,0
"sutherland",1,10,3,7,0
"waverable",1,9,4,5,0
"noyyietubgyykfsf",0,16,4,12,0
"thogister",0,9,3,6,0
"manity",1,6,2,4,0
"hjerpe",1,6,2,4,0
"private",1,7,3,4,0
"dodgements",0,10,3,7,0
"mfnchuring",0,10,2,8,0
"stagists",0,8,2,6,0
"epicleidium",1,11,6,5,0
"gersample",0,9,3,6,0
"espn",1,4,1,3,0
"borde",1,5,2,3,0
"presulphumpetishbaca",0,20,7,13,0
"expedes",0,7,3,4,0
"dintrics",0,8,2,6,0
"alloxanate",1,10,5,5,0
"leasingness",0,11,4,7,0
"libril",0,6,2,4,0
"dise",0,4,2,2,0
"daler",1,5,2,3,0
"lacis",1,5,2,3,0
"idioticon",1,9,5,4,0
"tacites",0,7,3,4,0
"genova",1,6,3,3,0
"febris",1,6,2,4,0
"godspeeds",1,9,3,6,0
"mangouste",1,9,4,5,0
"elytrospace",0,11,4,7,0
"gyeste",0,6,2,4,0
"whitweek",1,8,3,5,0
"emmetry",0,7,2,5,0
"bivittate",1,9,4,5,0
"hepatitis",1,9,4,5,0
"porian",0,6,3,3,0
"xhosan",1,6,2,4,0
"oxidic",1,6,3,3,0
"lexigraphies",1,12,5,7,0
"gybkpxw",0,7,0,7,0
"maintainable",1,12,6,6,0
"merrimagua",0,10,5,5,0
"hittagiustibicolour",0,19,9,10,0
"antislave",0,9,4,5,0
"nonlawyerliken",0,14,5,9,0
"punthuntomathenirrecraminisers",0,30,11,19,0
"photomy",0,7,2,5,0
"coalson",0,7,3,4,0
"o'rourke",1,8,4,4,1
"kastry",0,6,1,5,0
"nourisher",1,9,4,5,0
"darraines",1,9,4,5,0
"regelations",1,11,5,6,0
"fusileers",1,9,4,5,0
"diastimeter",1,11,5,6,0
"nw'ioebfgkv",0,11,3,8,1
"langerhans",1,10,3,7,0
"bigod",1,5,2,3,0
"versace",1,7,3,4,0
"riboflavobacter",0,15,6,9,0
"applicant",1,9,3,6,0
"withdrawnnesses",1,15,4,11,0
"hockedgentreps",0,14,4,10,0
"t'nka''idrm",0,11,2,9,3
"coautotillosishly",0,17,7,10,0
"cspbvrn'd'jh",0,12,0,12,2
"brontophobia",1,12,5,7,0
"etesian",1,7,4,3,0
"neel",1,4,2,2,0
"awarn",1,5,2,3,0
"amphigonous",1,11,5,6,0
"paraphragmacy",0,13,4,9,0
"livapoing",0,9,4,5,0
"unfeverish",1,10,4,6,0
"sores",1,5,2,3,0
"midyear",1,7,3,4,0
"outpolitic",0,10,5,5,0
"cervicographies",1,15,6,9,0
"operatenesses",0,13,6,7,0
"archill",0,7,2,5,0
"acuity",1,6,3,3,0
"wrottesley",1,10,3,7,0
"proiddles",0,9,3,6,0
"notumers",0,8,3,5,0
"hrijljzl'jietrxudgjeskajhrl",0,27,6,21,1
"vent",1,4,1,3,0
"bilharziasis",1,12,5,7,0
"dulbert",1,7,2,5,0
"presign",1,7,2,5,0
"ispas",0,5,2,3,0
"prodromus",1,9,3,6,0
"radiopharmeceutical",1,19,9,10,0
"skelm",1,5,1,4,0
"overturn",1,8,3,5,0
"beguilement",1,11,5,6,0
"preim",0,5,2,3,0
"organities",1,10,5,5,0
"agirvictere",0,11,5,6,0
"wartworts",1,9,2,7,0
"patricksburg",1,12,3,9,0
"anthidiales",0,11,5,6,0
"doyenned",0,8,3,5,0
"lucretenegardhos",0,16,6,10,0
"potifer",1,7,3,4,0
"callows",1,7,2,5,0
"tubtail",1,7,3,4,0
"ddenoturinoctelinhongat",0,23,9,14,0
"austrogaea",1,10,6,4,0
"malacostracan",1,13,5,8,0
"smescis",0,7,2,5,0
"idrryflttrhk",0,12,1,11,0
"poltophagists",0,13,4,9,0
"noverrellbene",0,13,5,8,0
"ezar",1,4,2,2,0
"purchases",1,9,3,6,0
"proviso",1,7,3,4,0
"strix",1,5,1,4,0
"aramanta",1,8,4,4,0
"quintilis",1,9,4,5,0
"rikargentaliness",0,16,6,10,0
"unpendulousness",1,15,6,9,0
"demise",1,6,3,3,0
"emplasterstone",0,14,5,9,0
"brodie",1,6,3,3,0
"scenium",0,7,3,4,0
"spergia",0,7,3,4,0
"diploplacula",1,12,5,7,0
"zuzzes",1,6,2,4,0
"parently",0,8,2,6,0
"nonparielle",0,11,5,6,0
"demihigh",1,8,3,5,0
"disillude",1,9,4,5,0
"alkahe",0,6,3,3,0
"homoclinal",1,10,4,6,0
"gallinaginous",1,13,6,7,0
"laggery",0,7,2,5,0
"paedotribe",1,10,5,5,0
"pemeesinmayulomoknouste",0,23,11,12,0
"liquidogenous",1,13,7,6,0
"alca",1,4,2,2,0
"speakingness",1,12,4,8,0
"cogalicrgoubole",0,15,7,8,0
"mgucbidvcmro",0,12,3,9,0
"subseverimmego",0,14,6,8,0
"plantling",1,9,2,7,0
"hipbaths",1,8,2,6,0
"peai",1,4,3,1,0
"wejdi",0,5,2,3,0
"transferential",1,14,5,9,0
"jacobson",1,8,3,5,0
"roughishly",1,10,3,7,0
"ronglytomollins",0,15,4,11,0
"unclesfordan",0,12,4,8,0
"braunite",1,8,4,4,0
"edman",1,5,2,3,0
"procreant",1,9,3,6,0
"carnim",0,6,2,4,0
"pizzelle",1,8,3,5,0
"monickers",1,9,3,6,0
"okean",1,5,3,2,0
"undauntable",1,11,5,6,0
"surfing",1,7,2,5,0
"moleproofing",0,12,5,7,0
"dimock",1,6,2,4,0
"reachy",1,6,2,4,0
"pachs",0,5,1,4,0
"hszbxujjtztwqal'",0,16,2,14,1
"codelights",0,10,3,7,0
"octantal",1,8,3,5,0
"berginization",1,13,6,7,0
"lunsford",1,8,2,6,0
"carpaccios",1,10,4,6,0
"stark",1,5,1,4,0
"slickery",1,8,2,6,0
"bethinks",1,8,2,6,0
"puffinus",1,8,3,5,0
"quinaquina",1,10,6,4,0
"pappadams",1,9,3,6,0
"pseudotetrameral",1,16,7,9,0
"resoll",0,6,2,4,0
"telitars",0,8,3,5,0
"bitie",0,5,3,2,0
"unquantified",1,12,6,6,0
"fvozsnbwjmcdiwlnrqzacl",0,22,3,19,0
"wyn",1,3,0,3,0
"jerrymandering",1,14,4,10,0
"sliddering",1,10,3,7,0
"acquiets",0,8,4,4,0
"blunter",1,7,2,5,0
"pentally",0,8,2,6,0
"flypapers",1,9,2,7,0
"durning",1,7,2,5,0
"faucets",1,7,3,4,0
"fautors",1,7,3,4,0
"barra",1,5,2,3,0
"uncoprographottersic",0,20,7,13,0
"relapse",1,7,3,4,0
"atabrins",1,8,3,5,0
"fubar",1,5,2,3,0
"ypwkawcksxrtqouqkypcickdrs",0,26,4,22,0
"neuringer",0,9,4,5,0
"rigbane",1,7,3,4,0
"tapur",0,5,2,3,0
"lnweob",0,6,2,4,0
"mwowyh",0,6,1,5,0
"hounderlaud",0,11,5,6,0
"magism",1,6,2,4,0
"sequence",1,8,4,4,0
"tetracadactylity",1,16,5,11,0
"prgsmity",0,8,1,7,0
"arrhizal",1,8,3,5,0
"womanlike",1,9,4,5,0
"tagerper",0,8,3,5,0
"saganas",0,7,3,4,0
"polyzoa",1,7,3,4,0
"unbreweinshipsies",0,17,7,10,0
"ogumus",0,6,3,3,0
"bestiped",0,8,3,5,0
"reppliers",0,9,3,6,0
"transnationalism",1,16,6,10,0
"di'vmyjaickavquu",0,16,6,10,1
"fleapit",1,7,3,4,0
"autoharps",1,9,4,5,0
"pactolian",1,9,4,5,0
"inkness",0,7,2,5,0
"philomelian",1,11,5,6,0
"sensitor",0,8,3,5,0
"beiges",1,6,3,3,0
"together",0,8,3,5,0
"metallists",1,10,3,7,0
"centonikuctozetrbar",0,19,7,12,0
"nonluster",1,9,3,6,0
"etymonic",1,8,3,5,0
"tomines",1,7,3,4,0
"disbosoms",1,9,3,6,0
"hjniuflwsoae'uibywuovcv",0,23,9,14,1
"rotovates",1,9,4,5,0
"vatmen",1,6,2,4,0
"plantad",1,7,2,5,0
"unebekaa",0,8,5,3,0
"antarateshudialiplacoulupunege",0,30,15,15,0
"reuptakes",1,9,4,5,0
"weatin",0,6,3,3,0
"xbaeuaqockblktjnctdvk",0,21,5,16,0
"traceries",1,9,4,5,0
"nonescram",0,9,3,6,0
"alerdlowle",0,10,4,6,0
"ajax",1,4,2,2,0
"mr''qhgyxeizevmdcdcb",0,20,3,17,2
"synapshood",0,10,3,7,0
"incog",1,5,2,3,0
"scal",0,4,1,3,0
"illiveratropyrient",0,18,7,11,0
"pungencies",1,10,4,6,0
"regmallit",0,9,3,6,0
"choreally",0,9,3,6,0
"cocrustat",0,9,3,6,0
"wadis",1,5,2,3,0
"xtbiijlhcudexulinzbuczocqpnm",0,28,8,20,0
"wendal",0,6,2,4,0
"cumberment",1,10,3,7,0
"overplots",1,9,3,6,0
"halting",1,7,2,5,0
"qulingnntonbuernkims",0,20,6,14,0
"bluebuck",1,8,3,5,0
"tailorbird",1,10,4,6,0
"fwomqknpwc",0,10,1,9,0
"cariyo",1,6,3,3,0
"cglcqmfxyrbsm",0,13,0,13,0
"rammerman",0,9,3,6,0
"polyspermy",1,10,2,8,0
"iyownve'l",0,9,3,6,1
"qunetesonabah",0,13,6,7,0
"deusdediting",0,12,5,7,0
"nonbibliographic",1,16,6,10,0
"oncopo",0,6,3,3,0
"sawfaavvnnnnsswzlnuvw",0,21,4,17,0
"otfkpavsnll",0,11,2,9,0
"lamar",1,5,2,3,0
"preade",0,6,3,3,0
"zoopartition",0,12,6,6,0
"eluted",1,6,3,3,0
"culverkey",1,9,3,6,0
"cauking",1,7,3,4,0
"prudgemas",0,9,3,6,0
"raymento",0,8,3,5,0
"vasodilation",1,12,6,6,0
"orphanise",1,9,4,5,0
"nuttery",1,7,2,5,0
"semicommunists",0,14,5,9,0
"clouters",1,8,3,5,0
"pyrolysate",1,10,3,7,0
"hadvitavicoconcepothrillic",0,26,10,16,0
"lyginvetus",0,10,3,7,0
"dollingers",0,10,3,7,0
"fsh",1,3,0,3,0
"ozaznjmlocgkki'npn",0,18,4,14,1
"unsaurus",0,8,4,4,0
"brazzaville",1,11,4,7,0
"eaceworm",1,8,4,4,0
"eg'ilrqxpabwvgk",0,15,3,12,1
"heriobubllun",0,12,5,7,0
"wlfrlfxz",0,8,0,8,0
"skol",1,4,1,3,0
"pappea",1,6,3,3,0
"connusable",1,10,4,6,0
"nondistributional",1,17,7,10,0
"vqsnzn'dty",0,10,0,10,1
"ungrownup",0,9,3,6,0
"penecontemporariness",0,20,8,12,0
"lathea",0,6,3,3,0
"faithful",1,8,3,5,0
"plebianism",1,10,4,6,0
"apodal",1,6,3,3,0
"psilotic",1,8,3,5,0
"unashamedness",1,13,5,8,0
"holacputbrococ",0,14,5,9,0
"reproduction",1,12,5,7,0
"glooscap",1,8,3,5,0
"right",1,5,1,4,0
"senecaville",1,11,5,6,0
"blephilia",1,9,4,5,0
"chargentamehet",0,14,5,9,0
"hiplingeses",0,11,4,7,0
"enlaceous",0,9,5,4,0
"rehearing",1,9,4,5,0
"bashlessly",0,10,2,8,0
"repunisotheteronetraodontoid",0,28,13,15,0
"schoolless",1,10,3,7,0
"amphibattersionarcolpigombergemishly",0,36,13,23,0
"jjjiv",0,5,1,4,0
"foregleams",1,10,4,6,0
"huzhsbppbjpjor",0,14,2,12,0
"palotty",0,7,2,5,0
"carnacles",0,9,3,6,0
"lighthouses",1,11,4,7,0
"catogen",0,7,3,4,0
"trinest",0,7,2,5,0
"basisolute",1,10,5,5,0
"perissodactylous",1,16,6,10,0
"punji",1,5,2,3,0
"ascc",1,4,1,3,0
"wanthill",1,8,2,6,0
"cotto",0,5,2,3,0
"antiperidromy",0,13,5,8,0
"diathermometer",1,14,6,8,0
"nynor",0,5,1,4,0
"protestantines",0,14,5,9,0
"disclost",1,8,2,6,0
"anthropus",0,9,3,6,0
"end",1,3,1,2,0
"planny",0,6,1,5,0
"marcation",0,9,4,5,0
"jaoxrnepeao",0,11,6,5,0
"nonvibranchia",0,13,5,8,0
"pawnbrokery",0,11,3,8,0
"blebrunequaciatinke",0,19,9,10,0
"precept",1,7,2,5,0
"meatering",0,9,4,5,0
"seekoa",0,6,4,2,0
"berkhamsted",1,11,3,8,0
"mudwrestlessness",0,16,4,12,0
"subgenera",1,9,4,5,0
"benzopyrazolone",1,15,6,9,0
"verthip",0,7,2,5,0
"recyclist",1,9,2,7,0
"semi",1,4,2,2,0
"memorisations",1,13,6,7,0
"endocrinologism",0,15,6,9,0
"disenchantress",1,14,4,10,0
"incoherentific",1,14,6,8,0
"lovirus",0,7,3,4,0
"latif",1,5,2,3,0
"thermometrographs",1,17,5,12,0
"eletica",0,7,4,3,0
"costativeness",0,13,5,8,0
"matteufr",0,8,3,5,0
"vepfhffjcjup",0,12,2,10,0
"idahoans",1,8,4,4,0
"ulmint",0,6,2,4,0
"pericardian",1,11,5,6,0
"sacchariferous",1,14,6,8,0
"tiorokufowstun",0,14,6,8,0
"larvacea",1,8,4,4,0
"endmatcher",1,10,3,7,0
"saccadically",1,12,4,8,0
"discerpibleness",1,15,5,10,0
"gneticism",0,9,3,6,0
"twalterous",0,10,4,6,0
"forisfamiliated",1,15,7,8,0
"entomopause",0,11,6,5,0
"spirochaetales",1,14,6,8,0
"emmenagogue",1,11,6,5,0
"sketcher",1,8,2,6,0
"amicizarentripuls",0,17,7,10,0
"coralligerous",1,13,6,7,0
"stringhalt",1,10,2,8,0
"uqorqcfyvnsrxic",0,15,3,12,0
"monsibeia",0,9,5,4,0
"bruang",1,6,2,4,0
"oldsquawberrying",0,16,5,11,0
"misconductor",0,12,4,8,0
"siverise",0,8,4,4,0
"prously",0,7,2,5,0
"yirds",1,5,1,4,0
"frivolling",1,10,3,7,0
"ennoic",1,6,3,3,0
"ostracoideas",0,12,6,6,0
"barbwire",1,8,3,5,0
"dismantlers",1,11,3,8,0
"hdowzzoulick",0,12,4,8,0
"sabble",0,6,2,4,0
"ipod",1,4,2,2,0
"subadanthrompostrical",0,21,7,14,0
"ultrafidianism",1,14,6,8,0
"elephanticide",0,13,6,7,0
"yahganan",1,8,3,5,0
"pelton",1,6,2,4,0
"tortileness",0,11,4,7,0
"oenophily",1,9,4,5,0
"lateens",1,7,3,4,0
"backslidden",1,11,3,8,0
"lacoiffliend",0,12,5,7,0
"unprofessionalness",1,18,7,11,0
"cribla",1,6,2,4,0
"arctiidae",1,9,5,4,0
"ydbxukxrqfph",0,12,1,11,0
"staree",1,6,3,3,0
"nonhereditably",1,14,5,9,0
"baldacchino",0,11,4,7,0
"uthitriniounzelia",0,17,9,8,0
"pisidium",1,8,4,4,0
"basicranial",1,11,5,6,0
"flunders",0,8,2,6,0
"tritchrytimemaniairks",0,21,7,14,0
"hydromorphism",0,13,3,10,0
"aletau",0,6,4,2,0
"chondrichthys",0,13,2,11,0
"yuf",0,3,1,2,0
"bantry",1,6,1,5,0
"nocki",0,5,2,3,0
"vulpicides",1,10,4,6,0
"misappreciates",1,14,6,8,0
"fetichlike",1,10,4,6,0
"buted",0,5,2,3,0
"phecticios",0,10,4,6,0
"carbaration",0,11,5,6,0
"subtorrid",1,9,3,6,0
"meatintinomoods",0,15,7,8,0
"balaton",1,7,3,4,0
"cnidos",0,6,2,4,0
"tholader",0,8,3,5,0
"accine",0,6,3,3,0
"thirteenfold",1,12,4,8,0
"neurohypophysicobiologies",0,25,11,14,0
"qgumtjzkvlui",0,12,3,9,0
"owatonna",1,8,4,4,0
"hermy",1,5,1,4,0
"uzbek",1,5,2,3,0
"lication",0,8,4,4,0
"jaeg",0,4,2,2,0
"springtail",1,10,3,7,0
"semiosis",1,8,4,4,0
"volunteerism",1,12,5,7,0
"generatively",1,12,5,7,0
"ampullariidae",1,13,7,6,0
"hudson",1,6,2,4,0
"thrower",1,7,2,5,0
"cactus",1,6,2,4,0
"thondemnism",0,11,3,8,0
"podispativerway",0,15,6,9,0
"flacoldboacepyliracefuctivele",0,29,12,17,0
"fundamentalisms",1,15,5,10,0
"inatteneral",0,11,5,6,0
"fillian",1,7,3,4,0
"pezant",1,6,2,4,0
"slcxrkvkfafpajow",0,16,3,13,0
"beresthyrgrotrerield",0,20,6,14,0
"clactone",0,8,3,5,0
"preinducean",0,11,5,6,0
"grapilforaceae",0,14,7,7,0
"teadish",1,7,3,4,0
"editorialisation",1,16,9,7,0
"outthink",1,8,3,5,0
"peregrine",1,9,4,5,0
"ratyes",0,6,2,4,0
"bjornson",1,8,2,6,0
"realos",1,6,3,3,0
"interlarger",0,11,4,7,0
"fishable",1,8,3,5,0
"judenberg",1,9,3,6,0
"promite",0,7,3,4,0
"freechurchism",1,13,4,9,0
"nonconsolable",1,13,5,8,0
"squintersaw",0,11,4,7,0
"endotheriidae",0,13,7,6,0
"asperging",1,9,3,6,0
"denigrated",1,10,4,6,0
"queenlier",1,9,5,4,0
"overexcepties",0,13,6,7,0
"intergallergic",0,14,5,9,0
"queechin",0,8,4,4,0
"larimer",1,7,3,4,0
"cnidophobia",1,11,5,6,0
"nonpending",1,10,3,7,0
"misfying",0,8,2,6,0
"gonite",0,6,3,3,0
"temptation",1,10,4,6,0
"ahishar",1,7,3,4,0
"locality",1,8,3,5,0
"photoplaywright",1,15,4,11,0
"tagilite",1,8,4,4,0
"vidames",1,7,3,4,0
"swatchbook",1,10,3,7,0
"bhnx",0,4,0,4,0
"rescindeers",0,11,4,7,0
"gastrular",1,9,3,6,0
"applaudians",0,11,5,6,0
"triamid",1,7,3,4,0
"accaradood",0,10,5,5,0
"procons",0,7,2,5,0
"bespreads",1,9,3,6,0
"pheneandreameritrinier",0,22,10,12,0
"demographist",1,12,4,8,0
"coxitti",0,7,3,4,0
"brucellosis",1,11,4,7,0
"oudnticfvjurlso",0,15,5,10,0
"reascertainable",0,15,7,8,0
"bywood",0,6,2,4,0
"fengtien",1,8,3,5,0
"densntnces",0,10,2,8,0
"hypernatural",1,12,4,8,0
"faletusky",0,9,3,6,0
"hialeah",1,7,4,3,0
"ptynderbird",0,11,2,9,0
"villote",1,7,3,4,0
"necturidae",1,10,5,5,0
"nonlethargy",0,11,3,8,0
"stripe",1,6,2,4,0
"columnutation",0,13,6,7,0
"inequipolitis",0,13,7,6,0
"accessoriness",1,13,5,8,0
"channovocabemonkin",0,18,7,11,0
"charkhas",1,8,2,6,0
"kover",0,5,2,3,0
"nonsubtlety",1,11,3,8,0
"coachdog",1,8,3,5,0
"parsings",1,8,2,6,0
"anvet'iowxugmu",0,14,6,8,1
"mulcher",1,7,2,5,0
"emnobbark",0,9,3,6,0
"prenenorocod",0,12,5,7,0
"semiglaze",1,9,4,5,0
"conce",0,5,2,3,0
"bonny",1,5,1,4,0
"gratrnem",0,8,2,6,0
"cloacanonimpetitiest",0,20,9,11,0
"hurrygraph",1,10,2,8,0
"quayage",1,7,4,3,0
"scruncherseeds",0,14,4,10,0
"ebughuglycea",0,12,5,7,0
"derencephala",0,12,5,7,0
"perilously",1,10,4,6,0
"precommandoman",0,14,5,9,0
"aevvthfuqldduzxea'jrxnwev",0,25,7,18,1
"bestuds",1,7,2,5,0
"spus",0,4,1,3,0
"ayvntd",0,6,1,5,0
"flaggers",1,8,2,6,0
"donkey",1,6,2,4,0
"hyolarerelia",0,12,6,6,0
"captivate",1,9,4,5,0
"bombilating",1,11,4,7,0
"cardons",1,7,2,5,0
"nonneedled",0,10,4,6,0
"fatiguedom",0,10,5,5,0
"toiletted",1,9,4,5,0
"schmalzy",1,8,1,7,0
"salamarines",0,11,5,6,0
"dinitrobacteriacids",0,19,8,11,0
"apneusis",1,8,4,4,0
"smocks",1,6,1,5,0
"encased",1,7,3,4,0
"hypertext",1,9,2,7,0
"horbrasparn",0,11,3,8,0
"tang",1,4,1,3,0
"gorillians",1,10,4,6,0
"willet",1,6,2,4,0
"euphausids",1,10,5,5,0
"microinches",1,11,4,7,0
"mesentery",1,9,3,6,0
"koko",1,4,2,2,0
"merin",0,5,2,3,0
"rhamnaceae",1,10,5,5,0
"bellmanship",1,11,3,8,0
"koussevitzky",1,12,4,8,0
"saggides",0,8,3,5,0
"prefiedly",0,9,3,6,0
"champa",1,6,2,4,0
"rhidet",0,6,2,4,0
"nonauthoritative",1,16,8,8,0
"seely",1,5,2,3,0
"pranginesses",0,12,4,8,0
"katawa",0,6,3,3,0
"ghouls",1,6,2,4,0
"hoodgradii",0,10,5,5,0
"beslobbered",1,11,4,7,0
"spriggers",1,9,2,7,0
"boothmaker",0,10,4,6,0
"chrositchemoch",0,14,4,10,0
"punosp",0,6,2,4,0
"carrew",1,6,2,4,0
"geubzesr",0,8,3,5,0
"dishabilitating",1,15,6,9,0
"cancel",1,6,2,4,0
"parnas",1,6,2,4,0
"panon",0,5,2,3,0
"metpprppfy'vvxxiy'lwussjc",0,25,3,22,2
"enguarded",1,9,4,5,0
"hypermarkets",1,12,3,9,0
"saucobs",0,7,3,4,0
"chemoratymimere",0,15,6,9,0
"frangonal",0,9,3,6,0
"reformingly",1,11,3,8,0
"bobkerry",0,8,2,6,0
"bothe",1,5,2,3,0
"reounot",0,7,4,3,0
"etymologists",1,12,4,8,0
"clubbinesses",1,12,4,8,0
"unlaundered",1,11,5,6,0
"uugshgi",0,7,3,4,0
"quenchings",1,10,3,7,0
"cantoro",0,7,3,4,0
"fogramities",1,11,5,6,0
"gabrielrache",1,12,5,7,0
"equilibrationist",0,16,8,8,0
"quesited",1,8,4,4,0
"gljxwnldnmcmq'",0,14,0,14,1
"conservatrixes",1,14,5,9,0
"pread",0,5,2,3,0
"scaffle",1,7,2,5,0
"amigenesses",0,11,5,6,0
"saddredilly",0,11,3,8,0
"toadrushes",1,10,4,6,0
"jyrt'bgyro",0,10,1,9,1
"nidor",1,5,2,3,0
"difisshotranoty",0,15,5,10,0
"nichus",0,6,2,4,0
"pseudopregnancies",1,17,7,10,0
"blqkvbcnblpinbyz",0,16,1,15,0
"baalp",0,5,2,3,0
"triching",0,8,2,6,0
"nonintellectual",1,15,6,9,0
"hallmouth",0,9,3,6,0
"padma",1,5,2,3,0
"beent",1,5,2,3,0
"vaselines",1,9,4,5,0
"nocorimbrumilitertinable",0,24,10,14,0
"whirlbone",1,9,3,6,0
"moretalictoongipesisten",0,23,10,13,0
"average",1,7,4,3,0
"tennessean",1,10,4,6,0
"horper",0,6,2,4,0
"feviog",0,6,3,3,0
"disoperation",1,12,6,6,0
"unpropateness",0,13,5,8,0
"futural",1,7,3,4,0
"waterid",0,7,3,4,0
"swardaic",0,8,3,5,0
"excremes",0,8,3,5,0
"unweinematology",0,15,7,8,0
"harmsworth",1,10,2,8,0
"rahed",1,5,2,3,0
"unswine",0,7,3,4,0
"calinog",1,7,3,4,0
"clavicornia",1,11,5,6,0
"togg",0,4,1,3,0
"moriche",1,7,3,4,0
"retically",0,9,3,6,0
"dinghies",1,8,3,5,0
"stin",0,4,1,3,0
"maliks",1,6,2,4,0
"blanca",1,6,2,4,0
"exculpations",1,12,5,7,0
"vflpnbdulozprjbeuhinzyg'd",0,25,5,20,1
"pentachords",1,11,3,8,0
"tipster",1,7,2,5,0
"bewaitered",1,10,5,5,0
"moum",0,4,2,2,0
"amazonia",1,8,5,3,0
"acanthodes",1,10,4,6,0
"reactionisms",0,12,5,7,0
"renhionise",0,10,5,5,0
"hamartiologist",0,14,6,8,0
"snbopogiledngegeres",0,19,7,12,0
"huffings",0,8,2,6,0
"onuptxr'uyupukttq",0,17,5,12,1
"synecticity",1,11,3,8,0
"supravaginal",1,12,5,7,0
"unquailingly",1,12,5,7,0
"rikisha",1,7,3,4,0
"terlist",0,7,2,5,0
"trochleariform",1,14,5,9,0
"macing",1,6,2,4,0
"n'pdqvwhwppd'cfja",0,17,1,16,2
"sphyxia",0,7,2,5,0
"vq",0,2,0,2,0
"feter",0,5,2,3,0
"zkmy",0,4,0,4,0
"carlots",1,7,2,5,0
"auripunctuates",0,14,7,7,0
"filber",0,6,2,4,0
"codeclination",1,13,6,7,0
"skolly",1,6,1,5,0
"rountes",0,7,3,4,0
"rfswifflr",0,9,1,8,0
"subschp",0,7,1,6,0
"kayakers",1,8,3,5,0
"prefixtures",1,11,4,7,0
"bajardo",1,7,3,4,0
"thesium",1,7,3,4,0
"somlo",1,5,2,3,0
"vapourishness",1,13,5,8,0
"unwieceriety",0,12,6,6,0
"dolde",0,5,2,3,0
"columinancelluretishness",0,24,9,15,0
"cristry",0,7,1,6,0
"crossfishes",1,11,3,8,0
"lobulifeguards",0,14,6,8,0
"starboard",1,9,3,6,0
"suidine",0,7,4,3,0
"chaptreck",0,9,2,7,0
"quadrienniumutile",1,17,9,8,0
"sggz",0,4,0,4,0
"whitneyite",1,10,4,6,0
"nematelmia",1,10,5,5,0
"coypou",1,6,3,3,0
"tankbusters",1,11,3,8,0
"cubencies",0,9,4,5,0
"fartled",0,7,2,5,0
"eurasianism",1,11,6,5,0
"praesphenoidal",0,14,6,8,0
"rosations",0,9,4,5,0
"cenobies",1,8,4,4,0
"unmolten",1,8,3,5,0
"noibwornness",0,12,4,8,0
"amabel",1,6,3,3,0
"pluggerrenal",0,12,4,8,0
"terrough",0,8,3,5,0
"subprecoalfishhoods",0,19,7,12,0
"nomand",0,6,2,4,0
"luxury",1,6,2,4,0
"whipstaff",1,9,2,7,0
"blackhearted",1,12,4,8,0
"astrophysicist",1,14,4,10,0
"sporophyte",1,10,3,7,0
"pendulation",1,11,5,6,0
"superdecorated",1,14,6,8,0
"coenthrones",0,11,4,7,0
"uztdkqmvconptu'x",0,16,3,13,1
"gni",0,3,1,2,0
"mplatypicuieorgimapalecoucca",0,28,13,15,0
"eugeosynclines",1,14,6,8,0
"ineber",0,6,3,3,0
"mptid",0,5,1,4,0
"pilows",1,6,2,4,0
"semiclose",1,9,4,5,0
"faminstranger",0,13,4,9,0
"lentner",1,7,2,5,0
"permalloys",1,10,3,7,0
"foreroyal",1,9,4,5,0
"jag",1,3,1,2,0
"aquifoux",0,8,5,3,0
"telnet",1,6,2,4,0
"spheriest",1,9,3,6,0
"interlaboratory",1,15,6,9,0
"astulidae",0,9,5,4,0
"prestreptive",0,12,4,8,0
"igniting",1,8,3,5,0
"abusee",1,6,4,2,0
"omb",1,3,1,2,0
"screenman",1,9,3,6,0
"militaryment",1,12,4,8,0
"innumerablenesses",1,17,7,10,0
"conepate",1,8,4,4,0
"antimeter",1,9,4,5,0
"despiritualizing",1,16,7,9,0
"weipping",0,8,3,5,0
"cuirassier",1,10,5,5,0
"ewbqmyvxjxicxzeovegwdmlw",0,24,5,19,0
"rothe",0,5,2,3,0
"surebutted",1,10,4,6,0
"drosera",1,7,3,4,0
"altify",1,6,2,4,0
"worman",0,6,2,4,0
"rycararbe",0,9,3,6,0
"finlander",1,9,3,6,0
"coud",0,4,2,2,0
"bonum",1,5,2,3,0
"lychnomancy",1,11,2,9,0
"nfrtayisoq",0,10,3,7,0
"gaper",1,5,2,3,0
"kebed",0,5,2,3,0
"overgrossness",1,13,4,9,0
"thwartness",1,10,2,8,0
"hoaxer",1,6,3,3,0
"enamellers",1,10,4,6,0
"sibucao",1,7,4,3,0
"basanita",0,8,4,4,0
"hyperostosis",1,12,4,8,0
"ssuede",0,6,3,3,0
"bleshiness",0,10,3,7,0
"qytxviunldnap",0,13,3,10,0
"nwobeotinerbwetaytt",0,19,7,12,0
"txkjfedetprjzpcbrzqnobib'uz",0,27,5,22,1
"intemporalise",0,13,6,7,0
"naquin",1,6,3,3,0
"biophotor",0,9,4,5,0
"mva",1,3,1,2,0
"equibblive",0,10,5,5,0
"pygostyle",1,9,2,7,0
"disputacity",1,11,4,7,0
"meretrices",1,10,4,6,0
"hapology",0,8,3,5,0
"hiphymus",0,8,2,6,0
"triethylamine",1,13,5,8,0
"massinissa",1,10,4,6,0
"doyst",1,5,1,4,0
"vetkoeksotenontotorism",0,22,9,13,0
"gluthenist",0,10,3,7,0
"xmztgijnfcs",0,11,1,10,0
"subnatural",1,10,4,6,0
"outreach",1,8,4,4,0
"ensign",1,6,2,4,0
"solitaires",1,10,5,5,0
"willyt",1,6,1,5,0
"quixotry",1,8,3,5,0
"asiatized",0,9,5,4,0
"codeia",1,6,4,2,0
"'aioobrlgvg'wvok",0,16,5,11,2
"phytochemicals",1,14,4,10,0
"o'ndfmfoooqp'ebxpldavckinoc",0,27,8,19,2
"dkoxavsbcrut",0,12,3,9,0
"nlrvnafgkoghzsswbmlvpfxg",0,24,2,22,0
"bocynthromy",0,11,2,9,0
"steganopodes",1,12,5,7,0
"nana",1,4,2,2,0
"piezoelectrically",1,17,7,10,0
"xeroprivataranch",0,16,6,10,0
"dmodgxjkgals",0,12,2,10,0
"ttinzeivaurtsbabrerchavabris",0,28,10,18,0
"mahiranits",0,10,4,6,0
"postgame",1,8,3,5,0
"cumuli",1,6,3,3,0
"gastrous",0,8,3,5,0
"millionist",0,10,4,6,0
"seropositivity",1,14,6,8,0
"solokwic",0,8,3,5,0
"hunkey",1,6,2,4,0
"superocubicund",0,14,6,8,0
"surrogateship",1,13,5,8,0
"unwist",1,6,2,4,0
"enculturated",1,12,5,7,0
"passmenting",1,11,3,8,0
"copolary",0,8,3,5,0
"furnishinomiya",0,14,6,8,0
"arthrotomy",1,10,3,7,0
"skutterudite",1,12,5,7,0
"phaenogenetic",1,13,6,7,0
"fosterosities",0,13,6,7,0
"libnah",1,6,2,4,0
"arachnid",1,8,3,5,0
"duncaton",0,8,3,5,0
"aatech",1,6,3,3,0
"reistier",1,8,4,4,0
"demia",0,5,3,2,0
"splash",1,6,1,5,0
"jorvavoces",0,10,4,6,0
"demiwivern",1,10,4,6,0
"okx'cvwslbvsplm",0,15,1,14,1
"poplilia",1,8,4,4,0
"exsert",1,6,2,4,0
"dendrolongmires",0,15,5,10,0
"ancyrean",1,8,3,5,0
"kkyra",1,5,1,4,0
"ctenostomata",1,12,5,7,0
"officiously",1,11,5,6,0
"linyu",1,5,2,3,0
"salian",1,6,3,3,0
"dometricities",0,13,6,7,0
"aculat",0,6,3,3,0
"telesmanesthesia",0,16,7,9,0
"uninus",0,6,3,3,0
"bsheredukeliseaguisinaticate",0,28,14,14,0
"promonarchicalness",1,18,6,12,0
"deorientalize",1,13,7,6,0
"monicidi",0,8,4,4,0
"nonisise",0,8,4,4,0
"nonprescriber",1,13,4,9,0
"convulgarring",0,13,4,9,0
"gration",0,7,3,4,0
"illucidated",0,11,5,6,0
"guilefulness",1,12,5,7,0
"colugos",1,7,3,4,0
"yplmdjcsfo",0,10,1,9,0
"hewes",1,5,2,3,0
"helluo",0,6,3,3,0
"speaking",1,8,3,5,0
"bhre",0,4,1,3,0
"sonorific",1,9,4,5,0
"rachelor",0,8,3,5,0
"profarchieldom",0,14,5,9,0
"curiositions",0,12,6,6,0
"jeroma",1,6,3,3,0
"permissibility",1,14,5,9,0
"colluvium",1,9,4,5,0
"smenzanammurna",0,14,5,9,0
"chutmensemathilphae",0,19,7,12,0
"bvoerxxl'cdqjszwt",0,17,2,15,1
"venedotian",1,10,5,5,0
"grangeability",0,13,5,8,0
"a'dbilunt'''vzp",0,15,3,12,4
"atmometer",1,9,4,5,0
"tralira",1,7,3,4,0
"traditionings",0,13,5,8,0
"retriser",0,8,3,5,0
"pseudoarchaecrania",0,18,9,9,0
"wirelike",1,8,4,4,0
"ampinct",0,7,2,5,0
"mansioneer",1,10,5,5,0
"stylohyoidean",1,13,5,8,0
"sxzsybp'",0,8,0,8,1
"doggrel",1,7,2,5,0
"tfyuoluuonwbfgktvqpgh",0,21,5,16,0
"rwslmxhwi",0,9,1,8,0
"homerology",1,10,4,6,0
"blindfolded",1,11,3,8,0
"abiogeogram",0,11,6,5,0
"guese",0,5,3,2,0
"cragsmen",1,8,2,6,0
"unfish",0,6,2,4,0
"louverte",0,8,4,4,0
"derib",1,5,2,3,0
"myfh'c'g'zlizkcfvfwvpflrgh'o",0,28,2,26,4
"puf",0,3,1,2,0
"canadianism",1,11,5,6,0
"mudpuppylike",0,12,4,8,0
"naas",1,4,2,2,0
"infed",0,5,2,3,0
"unzip",1,5,2,3,0
"tlkgfliulstederearmapocatoneconane",0,34,14,20,0
"orthoepy",1,8,3,5,0
"xfcmtb'h'nyjk",0,13,0,13,2
"ciout",0,5,3,2,0
"feldt",1,5,1,4,0
"sperischele",0,11,4,7,0
"reapprehension",1,14,6,8,0
"hophorn",0,7,2,5,0
"unseminared",1,11,5,6,0
"schnabelkanne",1,13,4,9,0
"outflash",1,8,3,5,0
"sprunny",1,7,1,6,0
"rqp'vohqfkpdljbyvgewlkcfq",0,25,2,23,1
"incivilization",1,14,7,7,0
"mats",1,4,1,3,0
"nkhmor",0,6,1,5,0
"miabr",0,5,2,3,0
"vlwpts'gzpkwot",0,14,1,13,1
"lerons",0,6,2,4,0
"ginhouses",1,9,4,5,0
"tasselled",1,9,3,6,0
"mairily",0,7,3,4,0
"tunel",0,5,2,3,0
"coloureds",1,9,4,5,0
"cavorter",1,8,3,5,0
"sictpeveitallexpenchianotriam",0,29,12,17,0
"vistrypron",0,10,2,8,0
"syzxdijegxqdifqcpf",0,18,3,15,0
"jmldxuefzyckkdesegzhzgdtilne",0,28,6,22,0
"periscopise",0,11,5,6,0
"upbraided",1,9,4,5,0
"underfarmer",1,11,4,7,0
"villsama",0,8,3,5,0
"preadmirer",1,10,4,6,0
"astrophysical",1,13,4,9,0
"oline",0,5,3,2,0
"cpilhamo'w",0,10,3,7,1
"luanne",1,6,3,3,0
"smitarerrieawheuribencomatushyseronlamiqungasi",0,46,20,26,0
"retarsuses",0,10,4,6,0
"faccybal",0,8,2,6,0
"borofluoromethane",0,17,8,9,0
"dury",0,4,1,3,0
"biotome",1,7,4,3,0
"rousant",1,7,3,4,0
"hemfologitionflic",0,17,7,10,0
"stier",1,5,2,3,0
"unpriestherium",0,14,6,8,0
"nursable",1,8,3,5,0
"biddies",1,7,3,4,0
"parochites",0,10,4,6,0
"codesigning",1,11,4,7,0
"kolkhozniks",1,11,3,8,0
"subfreshen",0,10,3,7,0
"rbczlaxwqjvfypmhu''p",0,20,2,18,2
"phziixxyomvekeshkhgidunut",0,25,8,17,0
"cordierstuben",0,13,5,8,0
"overdrainability",0,16,7,9,0
"playedlesses",0,12,4,8,0
"laud",1,4,2,2,0
"edictum",1,7,3,4,0
"overbrushlessness",0,17,5,12,0
"angeromyck",0,10,3,7,0
"goosegobs",1,9,4,5,0
"coiffeurs",1,9,4,5,0
"conourisher",0,11,5,6,0
"presxzjftdo",0,11,2,9,0
"maeterlinck",1,11,4,7,0
"esere",1,5,3,2,0
"apas",0,4,2,2,0
"tampion",1,7,3,4,0
"unoblockishly",0,13,4,9,0
"hallegomuti",0,11,5,6,0
"dospalos",1,8,3,5,0
"unthronic",0,9,3,6,0
"unclouds",1,8,3,5,0
"alphabet",1,8,3,5,0
"theobromatites",0,14,6,8,0
"unputridness",1,12,4,8,0
"fantastrychnisms",0,16,3,13,0
"workstation",1,11,4,7,0
"synclinically",0,13,3,10,0
"waukesha",1,8,4,4,0
"lynchromer",0,10,2,8,0
"tdgbtezedxjx'g'gadxtql",0,22,3,19,2
"icamananiplile",0,14,7,7,0
"unconcernino",0,12,5,7,0
"thereaway",1,9,4,5,0
"eticied",0,7,4,3,0
"blise",0,5,2,3,0
"ultrationalia",0,13,7,6,0
"ktkjckhj''",0,10,0,10,2
"vaws",1,4,1,3,0
"ankeyiedenes",0,12,6,6,0
"matricarinate",0,13,6,7,0
"treponemata",1,11,5,6,0
"normentiner",0,11,4,7,0
"q'tcqlhxai'cjpwgpg",0,18,2,16,2
"unautomated",1,11,6,5,0
"misadvise",1,9,4,5,0
"unforgeability",1,14,6,8,0
"zapupe",1,6,3,3,0
"utci'qborqyhm'burmabviuf",0,24,7,17,2
"hystionselldene",0,15,5,10,0
"lauretan",0,8,4,4,0
"hemotherapeutics",1,16,7,9,0
"counterefficiency",1,17,7,10,0
"krwsupaguzej",0,12,4,8,0
"irchismatipo",0,12,5,7,0
"polyonymal",1,10,3,7,0
"homoeomerae",1,11,7,4,0
"conclusive",1,10,4,6,0
"monoglycaemia",0,13,6,7,0
"kbonctes",0,8,2,6,0
"skeweepetskysanaconed",0,21,8,13,0
"gualty",0,6,2,4,0
"jjgqdhutlugyqqeymqn",0,19,3,16,0
"miswording",1,10,3,7,0
"laydown",1,7,2,5,0
"peterisk",0,8,3,5,0
"andkeel",0,7,3,4,0
"crawahamler",0,11,4,7,0
"fbiynhtmiqbifqkjprtxelo",0,23,5,18,0
"parostotis",1,10,4,6,0
"cozad",1,5,2,3,0
"obile",0,5,3,2,0
"motozintlec",1,11,4,7,0
"reapportions",1,12,5,7,0
"tether",1,6,2,4,0
"enteroischiocele",1,16,8,8,0
"dss",0,3,0,3,0
"nonequivocally",1,14,6,8,0
"bittner",1,7,2,5,0
"occipitoscapular",1,16,7,9,0
"krinthos",1,8,2,6,0
"negrophobia",1,11,5,6,0
"swedeborg",1,9,3,6,0
"azotic",1,6,3,3,0
"chargement",0,10,3,7,0
"uzwwlcfivd",0,10,2,8,0
"unpainful",1,9,4,5,0
"nimbed",1,6,2,4,0
"preshower",0,9,3,6,0
"uybpddtzrhnopqfrn",0,17,2,15,0
"deinotheres",1,11,5,6,0
"kurtistown",1,10,3,7,0
"chupeeronsichomolarbed",0,22,9,13,0
"noncuriously",1,12,5,7,0
"har",0,3,1,2,0
"linse",0,5,2,3,0
"pisopabirranulatre",0,18,8,10,0
"mis",1,3,1,2,0
"pierpont",1,8,3,5,0
"wyandottes",1,10,3,7,0
"strawn",1,6,1,5,0
"cocote",0,6,3,3,0
"sneakishnesses",1,14,5,9,0
"dedvaracarntienolessomar",0,24,10,14,0
"restorer",1,8,3,5,0
"dsss",0,4,0,4,0
"jilomine",0,8,4,4,0
"predraectincensurpitines",0,24,9,15,0
"sermonised",1,10,4,6,0
"uleipronnticoiph",0,16,7,9,0
"spinefinned",1,11,4,7,0
"arbitron",1,8,3,5,0
"superabundant",1,13,5,8,0
"bipronger",0,9,3,6,0
"lubroous",0,8,4,4,0
"trestling",1,9,2,7,0
"polytrichum",1,11,3,8,0
"leurheadlan",0,11,5,6,0
"vachel",1,6,2,4,0
"eva",1,3,2,1,0
"irdes",0,5,2,3,0
"identia",0,7,4,3,0
"oversalneols",0,12,5,7,0
"gyrostatics",1,11,3,8,0
"hexadactylous",1,13,5,8,0
"pienaar",1,7,4,3,0
"lunchpails",1,10,3,7,0
"delopingraphagua",0,16,7,9,0
"phrygianism",0,11,3,8,0
"suberiform",1,10,4,6,0
"nonpermitudings",0,15,5,10,0
"polysulfides",1,12,4,8,0
"adaptate",0,8,4,4,0
"huntedly",1,8,2,6,0
"l'e",0,3,1,2,1
"aulerizy",0,8,4,4,0
"sweeds",0,6,2,4,0
"denote",1,6,3,3,0
"nsvrstfuknxarwdeqtpcjdsstb",0,26,3,23,0
"tantrisms",1,9,2,7,0
"scrouns",0,7,2,5,0
"charmeuse",1,9,4,5,0
"hypocrater",1,10,3,7,0
"douar",1,5,3,2,0
"'vhhsizf",0,8,1,7,1
"lindly",1,6,1,5,0
"unfarmed",1,8,3,5,0
"fianchetti",1,10,4,6,0
"meningococcocci",1,15,6,9,0
"electrothermic",1,14,5,9,0
"uhrpafwmw",0,9,2,7,0
"brachillaboric",0,14,5,9,0
"postado",0,7,3,4,0
"bradycrotic",0,11,3,8,0
"thromata",0,8,3,5,0
"begored",1,7,3,4,0
"drephyroinstrarere",0,18,6,12,0
"genetika",1,8,4,4,0
"uf",0,2,1,1,0
"glim",1,4,1,3,0
"mbwjudxtlatiwgrg",0,16,3,13,0
"lfiny",0,5,1,4,0
"undercurrents",1,13,4,9,0
"timbuktu",1,8,3,5,0
"allees",1,6,3,3,0
"annarbor",1,8,3,5,0
"procalcarrations",0,16,6,10,0
"adventuring",1,11,4,7,0
"euder",0,5,3,2,0
"eyeholes",1,8,4,4,0
"scyllidae",1,9,3,6,0
"morristels",0,10,3,7,0
"enterobacterium",1,15,7,8,0
"declassification",1,16,7,9,0
"deerflies",1,9,4,5,0
"cherynchrocrorhot",0,17,4,13,0
"prohydrotechnofear",0,18,6,12,0
"murmuremediencydloperaxa",0,24,10,14,0
"venderface",0,10,4,6,0
"bepastured",1,10,4,6,0
"basilian",1,8,4,4,0
"acmontrephallidae",0,17,7,10,0
"virement",1,8,3,5,0
"gloversville",1,12,4,8,0
"limingler",0,9,3,6,0
"fanaticising",1,12,5,7,0
"clewgarnet",1,10,3,7,0
"rayleness",0,9,3,6,0
"iur",0,3,2,1,0
"egocerus",1,8,4,4,0
"channate",0,8,3,5,0
"ucrgrtierochoncull",0,18,6,12,0
"efatese",1,7,4,3,0
"endocrinous",1,11,5,6,0
"rhynes",1,6,1,5,0
"acontium",1,8,4,4,0
"dazhppfgeoltlion",0,16,5,11,0
"reinterparts",0,12,4,8,0
"grodiest",1,8,3,5,0
"vedism",1,6,2,4,0
"cratokenchee",0,12,5,7,0
"plthuvcpzlyafxplwodsejai",0,24,6,18,0
"arustle",1,7,3,4,0
"galla",1,5,2,3,0
"chefounhamopeckstatistro",0,24,9,15,0
"councillors",1,11,4,7,0
"saks",1,4,1,3,0
"bamicorshan",0,11,4,7,0
"pheazars",1,8,3,5,0
"riettest",0,8,3,5,0
"nazificatorisms",0,15,6,9,0
"coryl",1,5,1,4,0
"leckrone",1,8,3,5,0
"brassageway",0,11,4,7,0
"terelic",0,7,3,4,0
"coprojector",1,11,4,7,0
"dwalkalist",0,10,3,7,0
"valence",1,7,3,4,0
"mqwyrrisgbrgscht",0,16,1,15,0
"anrvingitsudmyla",0,16,5,11,0
"patwari",1,7,3,4,0
"pupmalcwrpbw'mm",0,15,2,13,1
"colli",0,5,2,3,0
"erythrophilous",1,14,5,9,0
"reagingalisations",0,17,8,9,0
"donchat",0,7,2,5,0
"unluckier",1,9,4,5,0
"hyperodontogeny",1,15,5,10,0
"stitrigynkesinneschirstopstegrorulmoo",0,37,12,25,0
"cill",1,4,1,3,0
"eeninepatis",0,11,6,5,0
"protelytron",0,11,3,8,0
"perukier",1,8,4,4,0
"pigswill",1,8,2,6,0
"wilone",1,6,3,3,0
"kjs",0,3,0,3,0
"exofeieniang",0,12,7,5,0
"xipharmonsburg",0,14,4,10,0
"carryon",1,7,2,5,0
"profiteering",1,12,5,7,0
"docuddermatospective",0,20,8,12,0
"luxembourgeoisie",0,16,9,7,0
"gautaoicwqdwsujmsfbs",0,20,6,14,0
"avekfquus",0,9,4,5,0
"jyorqlecyc'wmztgbxud",0,20,3,17,1
"gol",1,3,1,2,0
"chuvash",1,7,2,5,0
"admeasured",1,10,5,5,0
"trif",0,4,1,3,0
"btyyp",0,5,0,5,0
"plasexuarbutchoy",0,16,6,10,0
"phaemiak",0,8,4,4,0
"ladroitures",0,11,5,6,0
"warly",1,5,1,4,0
"prers",0,5,1,4,0
"hydrocyanogenetic",0,17,6,11,0
"nodon",0,5,2,3,0
"mielnau'iyugljtsbc",0,18,6,12,1
"harvel",1,6,2,4,0
"preseafcakick",0,13,5,8,0
"superjumbo",1,10,4,6,0
"masutralism",0,11,4,7,0
"toggizzlenure",0,13,5,8,0
"californio",1,10,5,5,0
"parvati",1,7,3,4,0
"threshing",1,9,2,7,0
"dendrium",1,8,3,5,0
"vxrpcothfrgw'",0,13,1,12,1
"sectorshing",0,11,3,8,0
"girondelicitly",0,14,5,9,0
"braisintegyptogamic",0,19,7,12,0
"wrain",0,5,2,3,0
"gurgical",0,8,3,5,0
"scaberulous",1,11,5,6,0
"hicasslosed",0,11,4,7,0
"asixafas",0,8,4,4,0
"onixagydwovr",0,12,4,8,0
"datos",1,5,2,3,0
"euglenophyta",1,12,5,7,0
"proscamaianchaloinceasigarconiagizes",0,36,17,19,0
"mischaracterises",1,16,6,10,0
"subtrend",1,8,2,6,0
"hiroko",1,6,3,3,0
"misima",1,6,3,3,0
"ustiand",0,7,3,4,0
"butteviounopalafesamognoneytialoxiokinaiatinedanus",0,50,26,24,0
"moderniece",0,10,5,5,0
"sakaise",0,7,4,3,0
"hidomenidnean",0,13,6,7,0
"entangledly",1,11,3,8,0
"fanciers",1,8,3,5,0
"unstewardlike",1,13,5,8,0
"reticness",0,9,3,6,0
"amoralisms",1,10,4,6,0
"nonfederatae",0,12,6,6,0
"policellersysgranist",0,20,6,14,0
"hitobesa",0,8,4,4,0
"kgswjkbxmn",0,10,0,10,0
"overtopper",0,10,4,6,0
"woopie",1,6,4,2,0
"disarme",0,7,3,4,0
"aloggodinasisses",0,16,7,9,0
"tarkiesque",0,10,5,5,0
"nabalisation",0,12,6,6,0
"peskier",1,7,3,4,0
"groundcloth",1,11,3,8,0
"yqtblyacv",0,9,1,8,0
"boris",1,5,2,3,0
"reciprocatio",0,12,6,6,0
"sirrah",1,6,2,4,0
"blownds",0,7,1,6,0
"bistipulate",1,11,5,6,0
"zoopaschistonia",0,15,7,8,0
"shonistomanians",0,15,6,9,0
"halous",0,6,3,3,0
"pleurotus",1,9,4,5,0
"semirefined",1,11,5,6,0
"organogenesis",1,13,6,7,0
"tzg",0,3,0,3,0
"ticapialurgeska",0,15,7,8,0
"sanguineovascular",1,17,8,9,0
"unr",0,3,1,2,0
"paddymelon",1,10,3,7,0
"boverrilla",0,10,4,6,0
"podiceps",1,8,3,5,0
"talon",1,5,2,3,0
"mirabilis",1,9,4,5,0
"dodontusia",0,10,5,5,0
"estanciero",1,10,5,5,0
"nonsubcompositiously",0,20,8,12,0
"assoriums",0,9,4,5,0
"devonport",1,9,3,6,0
"dollaeuomutecsson",0,17,8,9,0
"unembezzled",1,11,4,7,0
"strepitantly",1,12,3,9,0
"mitrogotranoteritrravohedenacomume",0,34,15,19,0
"austenoscope",0,12,6,6,0
"loudishness",0,11,4,7,0
"ribbah",0,6,2,4,0
"hexade",1,6,3,3,0
"mardizertilembbinetennmipisidrcgirs",0,35,12,23,0
"medflies",1,8,3,5,0
"cardiospermum",1,13,5,8,0
"usolosluarcutrmanedeer",0,22,10,12,0
"incred",0,6,2,4,0
"misderivating",0,13,5,8,0
"coscloolus",0,10,4,6,0
"tongueflower",1,12,5,7,0
"martaker",0,8,3,5,0
"chuckholts",0,10,2,8,0
"eqqmysdqnvcrmgioifmnxevwte",0,26,6,20,0
"catagmatic",1,10,4,6,0
"prockin",0,7,2,5,0
"dinglernamegars",0,15,5,10,0
"lepte",0,5,2,3,0
"ataghans",1,8,3,5,0
"pipylepear",0,10,4,6,0
"fastinkleform",0,13,4,9,0
"urer",0,4,2,2,0
"demandativeness",0,15,6,9,0
"tailifical",0,10,5,5,0
"winkier",0,7,3,4,0
"gwenni",1,6,2,4,0
"coastwaiter",1,11,5,6,0
"schisms",1,7,1,6,0
"leuconosed",0,10,5,5,0
"aghlabite",1,9,4,5,0
"adroituricchio",0,14,7,7,0
"rshyozxmxxnlsrllkagdpzphxzbqn",0,29,2,27,0
"footpostsis",0,11,4,7,0
"sylvabishead",0,12,4,8,0
"ditzier",1,7,3,4,0
"swarthoughts",0,12,3,9,0
"ellicottville",1,13,5,8,0
"dqkobzxjjuqppxnpgucxuhsm",0,24,4,20,0
"pterylae",1,8,3,5,0
"overconquerspreattribunitiate",0,29,13,16,0
"dedy",0,4,1,3,0
"psyle",0,5,1,4,0
"syngman",1,7,1,6,0
"tl",1,2,0,2,0
"jiffs",1,5,1,4,0
"irogerre",0,8,4,4,0
"ftuiegaduwiyawkepwwlc",0,21,8,13,0
"hyperacidity",1,12,4,8,0
"lupe",1,4,2,2,0
"pownding",1,8,2,6,0
"poninc",0,6,2,4,0
"pseudocumyl",1,11,4,7,0
"protopteris",0,11,4,7,0
"ochorabstin",0,11,4,7,0
"oilla",1,5,3,2,0
"maragy",0,6,2,4,0
"oncolporteni",0,12,5,7,0
"commensal",1,9,3,6,0
"vertibility",1,11,4,7,0
"trustlessness",1,13,3,10,0
"lorrayne",1,8,3,5,0
"vocabularia",0,11,6,5,0
"mation",0,6,3,3,0
"unilamellar",1,11,5,6,0
"amalia",1,6,4,2,0
"argumentalise",0,13,6,7,0
"criophore",1,9,4,5,0
"debeaker",1,8,4,4,0
"tsam",0,4,1,3,0
"cremos",0,6,2,4,0
"jstyfvksfpbj",0,12,0,12,0
"evectedness",0,11,4,7,0
"mhhqhwsaqduodkbqwbi",0,19,4,15,0
"heptangular",1,11,4,7,0
"phrygian",1,8,2,6,0
"presumers",1,9,3,6,0
"dreadlocks",1,10,3,7,0
"uninucleated",1,12,6,6,0
"lakhs",1,5,1,4,0
"davidinetopmen",0,14,6,8,0
"sosabilarentrant",0,16,6,10,0
"chancinees",0,10,4,6,0
"importunates",1,12,5,7,0
"maigre",1,6,3,3,0
"vailefying",0,10,4,6,0
"flabilities",0,11,5,6,0
"mamery",0,6,2,4,0
"acalnes",0,7,3,4,0
"itolas",0,6,3,3,0
"compreemighterpiologitutanadvers",0,32,13,19,0
"kraurauiaceae",0,13,9,4,0
"danelage",1,8,4,4,0
"unlesoman",0,9,4,5,0
"swakara",1,7,3,4,0
"baidar",1,6,3,3,0
"occasionate",1,11,6,5,0
"particina",0,9,4,5,0
"retreatant",1,10,4,6,0
"prographicago",0,13,5,8,0
"refully",0,7,2,5,0
"catholiatical",0,13,6,7,0
"onug",0,4,2,2,0
"bicameralist",1,12,5,7,0
"dedness",0,7,2,5,0
"monsignori",1,10,4,6,0
"squirrelsstagnate",1,17,6,11,0
"neidhardt",1,9,3,6,0
"potherbs",1,8,2,6,0
"oscillar",0,8,3,5,0
"obstructionary",0,14,5,9,0
"spectroheliogram",1,16,6,10,0
"protext",1,7,2,5,0
"isolvolete",0,10,5,5,0
"unstridulating",1,14,5,9,0
"beasess",0,7,3,4,0
"creoles",1,7,3,4,0
"ficus",1,5,2,3,0
"virginville",1,11,4,7,0
"megropondroverin",0,16,6,10,0
"mieiterycankieootumimeermesuciomiteiomiraeferat",0,47,26,21,0
"lienopancreatic",1,15,7,8,0
"discommunity",1,12,4,8,0
"relets",1,6,2,4,0
"naemorhedinae",1,13,7,6,0
"isativelyragran",0,15,6,9,0
"hazeless",1,8,3,5,0
"eilat",1,5,3,2,0
"nostalgia",1,9,4,5,0
"sludginess",1,10,3,7,0
"chew",1,4,1,3,0
"readestainomochoclate",0,21,10,11,0
"croctsoredi",0,11,4,7,0
"sarine",1,6,3,3,0
"recurvature",1,11,5,6,0
"qsbxmgfvwvbhoj",0,14,1,13,0
"kethidisensities",0,16,7,9,0
"sweetner",0,8,3,5,0
"tiresomeness",1,12,5,7,0
"unfined",1,7,3,4,0
"uigurian",1,8,5,3,0
"sayoner",0,7,3,4,0
"bimmeler",1,8,3,5,0
"ed'zmj",0,6,1,5,1
"upcounty",0,8,3,5,0
"ricardiac",0,9,4,5,0
"ridiory",0,7,3,4,0
"unamusement",1,11,5,6,0
"hyperconcentrations",1,19,6,13,0
"isabellas",1,9,4,5,0
"uge",0,3,2,1,0
"logocracies",0,11,5,6,0
"strick",1,6,1,5,0
"stenandioturabliephtily",0,23,9,14,0
"noncompetences",0,14,5,9,0
"exposurfboardee",0,15,7,8,0
"debt",1,4,1,3,0
"regumechent",0,11,4,7,0
"nanhai",1,6,3,3,0
"chiko",0,5,2,3,0
"heteronical",0,11,5,6,0
"virologist",1,10,4,6,0
"fineer",0,6,3,3,0
"fiddliest",1,9,3,6,0
"proggies",0,8,3,5,0
"piuuq'kazzhvhuja",0,16,6,10,1
"echal",0,5,2,3,0
"yznvzdhp'dies",0,13,2,11,1
"tacsonia",1,8,4,4,0
"thatch",1,6,1,5,0
"phycoerythrin",1,13,3,10,0
"submittable",1,11,4,7,0
"fragmentative",0,13,5,8,0
"submortgagee",0,12,5,7,0
"pharmacopolist",1,14,5,9,0
"colascioni",1,10,5,5,0
"enewetak",1,8,4,4,0
"klastiongtomicathyllastatanistalipplettarcotte",0,46,16,30,0
"complacentesis",0,14,5,9,0
"carcane",0,7,3,4,0
"taea",0,4,3,1,0
"misrecite",1,9,4,5,0
"fascists",1,8,2,6,0
"dindon",1,6,2,4,0
"whosociophophenope",0,18,8,10,0
"pisemiternour",0,13,6,7,0
"upejyehuklb",0,11,4,7,0
"yamalka",1,7,3,4,0
"nenonrapocchoponetatorontafly",0,29,11,18,0
"alternateness",1,13,5,8,0
"adisebrope",0,10,5,5,0
"crewcuts",1,8,2,6,0
"tsaritsa",1,8,3,5,0
"hackberry",1,9,2,7,0
"vasoreflex",1,10,4,6,0
"oiwqkcgkqgtyrqfftfefebxpwwwxj",0,29,4,25,0
"canln",0,5,1,4,0
"methylene",1,9,3,6,0
"saprocercoolhalia",0,17,8,9,0
"cophetencrourebosms",0,19,7,12,0
"preemlapirthinicidadjurg",0,24,9,15,0
"pinetums",0,8,3,5,0
"forsakes",1,8,3,5,0
"giaourt",0,7,4,3,0
"parvirostrate",1,13,5,8,0
"biracialist",0,11,5,6,0
"phillosalpart",0,13,4,9,0
"unsalutz",0,8,3,5,0
"overconstructed",1,15,5,10,0
"pedicled",1,8,3,5,0
"susy",1,4,1,3,0
"frand",0,5,1,4,0
"expuggedani",0,11,5,6,0
"murled",1,6,2,4,0
"unsuppression",1,13,5,8,0
"coaxiderthonitis",0,16,7,9,0
"ombkiadolsrreijduvdio",0,21,9,12,0
"kusha",1,5,2,3,0
"mestizos",1,8,3,5,0
"wjms",0,4,0,4,0
"cholecystectasia",1,16,6,10,0
"anderdrailloch",0,14,5,9,0
"hedonianism",0,11,5,6,0
"atacoscopeptibleness",0,20,8,12,0
"resive",0,6,3,3,0
"ukrainian",1,9,5,4,0
"aldolatry",0,9,3,6,0
"gpinguwncid",0,11,3,8,0
"stancracarm",0,11,3,8,0
"perognathus",1,11,4,7,0
"reflecasurvinivelchora",0,22,9,13,0
"speelings",0,9,3,6,0
"gojbfpth",0,8,1,7,0
"bjxarf'rfkinu",0,13,3,10,1
"millerstown",1,11,3,8,0
"emilie",1,6,4,2,0
"gentler",1,7,2,5,0
"haudoovarretimersation",0,22,11,11,0
"macromidiculting",0,16,6,10,0
"demonstrately",0,13,4,9,0
"nonexcitative",1,13,6,7,0
"ctlsheaiphiloubacsphacoblliveress",0,33,12,21,0
"rhavenia",0,8,4,4,0
"uribi",0,5,3,2,0
"caromel",1,7,3,4,0
"beaux",1,5,3,2,0
"escrol",1,6,2,4,0
"cochinae",0,8,4,4,0
"chalkstone",1,10,3,7,0
"culgee",1,6,3,3,0
"gi'p",0,4,1,3,1
"bundistulative",0,14,6,8,0
"unclassify",1,10,3,7,0
"dissonance",1,10,4,6,0
"beduckings",0,10,3,7,0
"estren",1,6,2,4,0
"euthrasene",0,10,5,5,0
"rugger",1,6,2,4,0
"awabakal",1,8,4,4,0
"dzb'jrdnunrd",0,12,1,11,1
"ideoglyph",1,9,3,6,0
"conflagrates",1,12,4,8,0
"tommie",1,6,3,3,0
"physalian",1,9,3,6,0
"blouboks",1,8,3,5,0
"turkeys",1,7,2,5,0
"colorimetry",1,11,4,7,0
"lqbybdmvrru'crdobwnbkhzq",0,24,2,22,1
"'ukhpgxdvz",0,10,1,9,1
"tassie",1,6,3,3,0
"clausal",1,7,3,4,0
"kqbniixrivzbcwtfvgt",0,19,3,16,0
"possible",1,8,3,5,0
"aoln",0,4,2,2,0
"bambino",1,7,3,4,0
"agnexpine",0,9,4,5,0
"angiohyalinosis",1,15,7,8,0
"swink",1,5,1,4,0
"snytllzhgivw'zgjhtn",0,19,1,18,1
"tadashi",1,7,3,4,0
"mellaticata",0,11,5,6,0
"astylosporous",0,13,5,8,0
"hemoerythrin",1,12,4,8,0
"unequivocalness",1,15,7,8,0
"reindoctrinate",1,14,6,8,0
"imus",1,4,2,2,0
"overexpanded",1,12,5,7,0
"efrsh'esprwa'",0,13,3,10,2
"pythilociployddamorpenton",0,25,8,17,0
"dissector",1,9,3,6,0
"coppelia",1,8,4,4,0
"etomqxwguhylqe't",0,16,4,12,1
"fuirena",1,7,4,3,0
"fritfulness",0,11,3,8,0
"bordylar",0,8,2,6,0
"lenche",0,6,2,4,0
"deliberative",1,12,6,6,0
"sacchitah",0,9,3,6,0
"d'hihinplfucuqprhnregrqtmkdg",0,28,5,23,1
"omadhaun",1,8,4,4,0
"slaticifiralatasempu",0,20,9,11,0
"evenhanded",1,10,4,6,0
"coreign",1,7,3,4,0
"kellysville",1,11,3,8,0
"overspeedy",1,10,4,6,0
"intitussism",0,11,4,7,0
"monophyllous",1,12,4,8,0
"ychoriletrtoaoomimelcanamerolenenisocas",0,39,18,21,0
"muz",0,3,1,2,0
"clui",0,4,2,2,0
"repadding",1,9,3,6,0
"lotase",1,6,3,3,0
"pavlovian",1,9,4,5,0
"pkqcvhgyzbprhfkkftuzn",0,21,1,20,0
"violinosing",0,11,5,6,0
"turnpin",1,7,2,5,0
"mucopolysaccum",0,14,5,9,0
"cavaed",0,6,3,3,0
"photogram",1,9,3,6,0
"virt",0,4,1,3,0
"governall",1,9,3,6,0
"'uvsa'obidicgfzzwjofm",0,21,6,15,2
"todends",0,7,2,5,0
"hollister",1,9,3,6,0
"undural",0,7,3,4,0
"unperfumed",1,10,4,6,0
"fluing",1,6,2,4,0
"bgsnawk",0,7,1,6,0
"tarlton",1,7,2,5,0
"vicatingis",0,10,4,6,0
"hecatonchires",1,13,5,8,0
"arcantolerel",0,12,5,7,0
"karolynne",0,9,3,6,0
"mussinesses",1,11,4,7,0
"kwnolmocafuismmangs",0,19,6,13,0
"linkier",1,7,3,4,0
"dragonroot",1,10,4,6,0
"palindromes",1,11,4,7,0
"slaglessness",1,12,3,9,0
"clasp",1,5,1,4,0
"gremial",1,7,3,4,0
"ovangangela",1,11,5,6,0
"superream",0,9,4,5,0
"vghz",0,4,0,4,0
"rebesiege",1,9,5,4,0
"houghtlies",0,10,4,6,0
"tripodic",1,8,3,5,0
"corwin",1,6,2,4,0
"attrits",1,7,2,5,0
"prement",0,7,2,5,0
"duped",1,5,2,3,0
"ck",0,2,0,2,0
"ycejkgwe'cy",0,11,2,9,1
"trinette",1,8,3,5,0
"triphammer",1,10,3,7,0
"shited",1,6,2,4,0
"polypomorpha",1,12,4,8,0
"horyanus",0,8,3,5,0
"compeers",1,8,3,5,0
"groupies",1,8,4,4,0
"seak",0,4,2,2,0
"thoracotomy",1,11,4,7,0
"reparations",1,11,5,6,0
"cacafugo",1,8,4,4,0
"psente",0,6,2,4,0
"se",1,2,1,1,0
"delible",1,7,3,4,0
"wwf'rsnuvgoclcua",0,16,4,12,1
"juns",0,4,1,3,0
"cooccurs",1,8,3,5,0
"kols",0,4,1,3,0
"mf'baedfrzzlfaspxmdipovjmyz",0,27,5,22,1
"incumbents",1,10,3,7,0
"simiidae",1,8,5,3,0
"unfold",1,6,2,4,0
"sayeds",1,6,2,4,0
"limusdjtb",0,9,2,7,0
"anguinidae",1,10,6,4,0
"multiciliate",1,12,6,6,0
"olyzel",0,6,2,4,0
"tovementablenesis",0,17,7,10,0
"snailery",1,8,3,5,0
"pachyderma",1,10,3,7,0
"diffusioninesses",0,16,7,9,0
"brunellia",1,9,4,5,0
"qmlzbrlilnmi'eqcr",0,17,3,14,1
"franza",1,6,2,4,0
"tsarina",1,7,3,4,0
"laconia",1,7,4,3,0
"bobbish",1,7,2,5,0
"souths",1,6,2,4,0
"skups",0,5,1,4,0
"waratess",0,8,3,5,0
"prostacyclin",1,12,3,9,0
"jovinianistic",1,13,6,7,0
"pandating",0,9,3,6,0
"flinty",1,6,1,5,0
"uninferable",1,11,5,6,0
"unmentampwormalay",0,17,6,11,0
"bergamot",1,8,3,5,0
"photochordateau",0,15,7,8,0
"esbay",1,5,2,3,0
"iodinium",1,8,5,3,0
"farmelo",1,7,3,4,0
"cerebralise",1,11,5,6,0
"stoeber",1,7,3,4,0
"nondiscriminates",0,16,6,10,0
"oaf",1,3,2,1,0
"ciliosciophite",0,14,7,7,0
"hawkweed",1,8,3,5,0
"amidoazobenzene",1,15,8,7,0
"oxysulfide",1,10,4,6,0
"plowfdeplk'",0,11,2,9,1
"anilopyrin",1,10,4,6,0
"n'",0,2,0,2,1
"motyperinateremo",0,16,7,9,0
"ablepharia",1,10,5,5,0
"outstat",0,7,3,4,0
"consolversion",0,13,5,8,0
"liddiard",1,8,3,5,0
"priced",1,6,2,4,0
"fing",0,4,1,3,0
"dialogised",1,10,5,5,0
"tomeevilasclermatiptardrypenify",0,31,11,20,0
"venenate",1,8,4,4,0
"hyperpanegyric",1,14,4,10,0
"coappearing",1,11,5,6,0
"pakhtun",1,7,2,5,0
"nonderite",0,9,4,5,0
"embeaub",0,7,4,3,0
"snibberyearly",0,13,4,9,0
"lcobtenadhancobsachizzzebai",0,27,10,17,0
"concernments",1,12,3,9,0
"unbosoming",1,10,4,6,0
"corrugatorily",0,13,5,8,0
"amplitude",1,9,4,5,0
"disnesting",1,10,3,7,0
"unwarrantably",1,13,4,9,0
"'zbqfuzlrnwe'wvvbydjjqa",0,23,3,20,2
"excoryishwist",0,13,4,9,0
"snuffboxes",1,10,3,7,0
"dereliction",1,11,5,6,0
"mckean",1,6,2,4,0
"ttfqzh'zlzvp'vzmz'tibiw'hqoneg",0,30,4,26,4
"charterist",1,10,3,7,0
"seepansudanelopilines",0,21,10,11,0
"chiser",0,6,2,4,0
"devalorises",1,11,5,6,0
"sortableness",0,12,4,8,0
"otides",1,6,3,3,0
"scrutineer",1,10,4,6,0
"thevenot",1,8,3,5,0
"codia",0,5,3,2,0
"heterozeted",0,11,5,6,0
"grjxnhgdfivui",0,13,3,10,0
"stestic",0,7,2,5,0
"isuridae",1,8,5,3,0
"aphs",0,4,1,3,0
"propic",0,6,2,4,0
"spint",0,5,1,4,0
"astop",0,5,2,3,0
"janglings",1,9,2,7,0
"fibs",1,4,1,3,0
"kissogram",1,9,3,6,0
"fieriness",1,9,4,5,0
"cerogenae",0,9,5,4,0
"spotling",0,8,2,6,0
"sparring",1,8,2,6,0
"hetictionemationspher",0,21,9,12,0
"romantic",1,8,3,5,0
"cassandra",1,9,3,6,0
"xrf",0,3,0,3,0
"schlumps",1,8,1,7,0
"irefully",1,8,3,5,0
"wimpikewskisits",0,15,5,10,0
"outsatisfied",1,12,6,6,0
"lappels",1,7,2,5,0
"belsky",1,6,1,5,0
"tarp",1,4,1,3,0
"blatherskites",1,13,4,9,0
"peeve",1,5,3,2,0
"acetoucan",0,9,5,4,0
"tanzine",1,7,3,4,0
"oldstein",0,8,3,5,0
"counderming",0,11,4,7,0
"lability",1,8,3,5,0
"altmanid",0,8,3,5,0
"brufsky",1,7,1,6,0
"costlew",1,7,2,5,0
"depiedmontize",1,13,6,7,0
"plautine",1,8,4,4,0
"cn'vzpw'urvonaf",0,15,3,12,2
"plenisher",0,9,3,6,0
"nonsilicious",1,12,6,6,0
"photoporotrichery",0,17,6,11,0
"foreslows",1,9,3,6,0
"strummers",1,9,2,7,0
"imption",0,7,3,4,0
"myosins",1,7,2,5,0
"yqjiion",0,7,3,4,0
"adiathetic",1,10,5,5,0
"hume",1,4,2,2,0
"jellos",1,6,2,4,0
"cyclosis",1,8,2,6,0
"lenchioncychillum",0,17,5,12,0
"searlesperedeniames",0,19,9,10,0
"linkwork",1,8,2,6,0
"footeuvepemafumore",0,18,10,8,0
"arsmea",0,6,3,3,0
"phuly",0,5,1,4,0
"hypnum",1,6,1,5,0
"nouranodermaries",0,16,8,8,0
"geanine",1,7,4,3,0
"tilting",1,7,2,5,0
"grutitzaly",0,10,3,7,0
"stacisms",0,8,2,6,0
"uanis",0,5,3,2,0
"crumenian",0,9,4,5,0
"cake",1,4,2,2,0
"pinards",1,7,2,5,0
"mlbbobfxbdqjdjoxnvmwrdja",0,24,3,21,0
"preindisposition",1,16,7,9,0
"liaison",1,7,4,3,0
"unclimbablenesses",1,17,6,11,0
"summonsing",1,10,3,7,0
"alypsylike",0,10,3,7,0
"montestatic",0,11,4,7,0
"cheesebox",1,9,4,5,0
"jakob",1,5,2,3,0
"myxochondromas",0,14,4,10,0
"uzdt",0,4,1,3,0
"outrings",1,8,3,5,0
"vishnavite",1,10,4,6,0
"gles",0,4,1,3,0
"laterifa",0,8,4,4,0
"mystagogus",1,10,3,7,0
"baalath",1,7,3,4,0
"stereospecifically",1,18,7,11,0
"glazier",1,7,3,4,0
"anfracoscopier",0,14,6,8,0
"presship",0,8,2,6,0
"phalacrocoracidae",1,17,8,9,0
"booking",1,7,3,4,0
"shilled",1,7,2,5,0
"outpressing",1,11,4,7,0
"ror",0,3,1,2,0
"nonowner",1,8,3,5,0
"esperance",1,9,4,5,0
"gages",0,5,2,3,0
"perist",0,6,2,4,0
"gonionia",1,8,5,3,0
"reemerging",1,10,4,6,0
"frankforts",1,10,2,8,0
"xanadu",1,6,3,3,0
"lithotrities",1,12,5,7,0
"gauntry",1,7,2,5,0
"nyvwnradhffgyuyusnlpjwvki",0,25,4,21,0
"thymonucleic",1,12,4,8,0
"undecorative",1,12,6,6,0
"platonianismatoid",0,17,8,9,0
"amarillis",1,9,4,5,0
"biternate",1,9,4,5,0
"wsw",1,3,0,3,0
"palaeeudyptes",1,13,6,7,0
"umbersick",0,9,3,6,0
"cinquercialected",0,16,7,9,0
"datecapa",0,8,4,4,0
"sporoniarist",0,12,5,7,0
"uncurbedly",1,10,3,7,0
"tardive",1,7,3,4,0
"uigursh",0,7,3,4,0
"universatile",0,12,6,6,0
"rodewdrously",0,12,4,8,0
"ljrsekqvvxzassi'moym'm'd",0,24,4,20,3
"yup",1,3,1,2,0
"backsbordificarpulate",0,21,8,13,0
"zdf",0,3,0,3,0
"microlepidopteron",0,17,7,10,0
"fragmas",0,7,2,5,0
"absolutista",1,11,5,6,0
"sokemen",1,7,3,4,0
"polatheliticheilly",0,18,7,11,0
"tasteless",1,9,3,6,0
"gymnosophs",1,10,2,8,0
"nutjobber",1,9,3,6,0
"rhetoric",1,8,3,5,0
"vectrogue",0,9,4,5,0
"branslatrix",0,11,3,8,0
"magsmen",1,7,2,5,0
"technicipien",0,12,5,7,0
"doxographer",1,11,4,7,0
"epai",0,4,3,1,0
"unprays",1,7,2,5,0
"rcqf",0,4,0,4,0
"jocundity",1,9,3,6,0
"varifically",0,11,4,7,0
"nontangibly",1,11,3,8,0
"opisthosomata",0,13,6,7,0
"cappal",0,6,2,4,0
"zinfandousnesses",0,16,6,10,0
"lavouretry",0,10,4,6,0
"galeneness",0,10,4,6,0
"assimilationisms",1,16,7,9,0
"webster",1,7,2,5,0
"pyrientonishman",0,15,5,10,0
"vitriolise",1,10,5,5,0
"iridescence",1,11,5,6,0
"unruefulness",1,12,5,7,0
"fankling",1,8,2,6,0
"interry",0,7,2,5,0
"ruckus",1,6,2,4,0
"misrecognition",1,14,6,8,0
"unhinged",1,8,3,5,0
"eggler",1,6,2,4,0
"mogliting",0,9,3,6,0
"metempiricisms",1,14,5,9,0
"octorsus",0,8,3,5,0
"lituus",1,6,3,3,0
"rhamnoside",1,10,4,6,0
"abscesses",1,9,3,6,0
"villamaria",1,10,5,5,0
"currel",0,6,2,4,0
"electromyography",1,16,5,11,0
"ploycoslurocthlllietryluns",0,26,7,19,0
"subprottier",0,11,4,7,0
"katherylonychidachrachous",0,25,8,17,0
"ric",1,3,1,2,0
"vondsira",1,8,3,5,0
"feminesses",0,10,4,6,0
"metif",1,5,2,3,0
"trilizing",0,9,3,6,0
"stopia",0,6,3,3,0
"microcystal",0,11,3,8,0
"decharinterr",0,12,4,8,0
"pcp",1,3,0,3,0
"shiomanwayingens",0,16,6,10,0
"megaloceras",0,11,5,6,0
"machroid",0,8,3,5,0
"holliquitous",0,12,6,6,0
"recipitaka",0,10,5,5,0
"neoanthropine",0,13,6,7,0
"weemlxwjv'kbaznqdnyd'ejalhki",0,28,6,22,2
"barrackings",1,11,3,8,0
"alaunes",0,7,4,3,0
"intergeneric",1,12,5,7,0
"pseudocystment",0,14,4,10,0
"heringer",1,8,3,5,0
"markeviking",0,11,4,7,0
"mimond",0,6,2,4,0
"botinep",0,7,3,4,0
"anencephalia",1,12,6,6,0
"jarvie",1,6,3,3,0
"suicidologies",1,13,7,6,0
"decordiidae",0,11,6,5,0
"cediserwhaliseilled",0,19,8,11,0
"lulhfarby'jwjggvyz",0,18,2,16,1
"meme",1,4,2,2,0
"medicinated",0,11,5,6,0
"comminister",1,11,4,7,0
"meless",0,6,2,4,0
"pasteurelleae",1,13,7,6,0
"dumosities",1,10,5,5,0
"carpopodite",1,11,5,6,0
"kircurriness",0,12,4,8,0
"certosina",1,9,4,5,0
"repackager",1,10,4,6,0
"exara",0,5,3,2,0
"bulcibersh",0,10,3,7,0
"hontdealasa",0,11,5,6,0
"phelonion",1,9,4,5,0
"edenioodename",0,13,8,5,0
"leavenworth",1,11,4,7,0
"auxo",1,4,3,1,0
"sanoserous",1,10,5,5,0
"lltutumuiwkdkzpjdnnxpns",0,23,4,19,0
"innobedient",1,11,5,6,0
"imbraction",0,10,4,6,0
"huca",0,4,2,2,0
"yodghsrcsnyk",0,12,1,11,0
"tunney",1,6,2,4,0
"veraguira",0,9,5,4,0
"brannungur",0,10,3,7,0
"evables",0,7,3,4,0
"sceptring",1,9,2,7,0
"calanthe",1,8,3,5,0
"reife",0,5,3,2,0
"kapila",1,6,3,3,0
"plaidmen",1,8,3,5,0
"laager",1,6,3,3,0
"gokoitret",0,9,4,5,0
"antidiabetic",1,12,6,6,0
"juramenta",1,9,4,5,0
"complimentator",0,14,5,9,0
"schwitters",1,10,2,8,0
"aeuplole",0,8,5,3,0
"bedbugs",1,7,2,5,0
"unstepping",1,10,3,7,0
"vi'tucan",0,8,3,5,1
"postmodernisms",1,14,4,10,0
"lamoille",1,8,4,4,0
"mncjevfjwpfcfhnchsurruyv",0,24,3,21,0
"pynetpkcqugpkgiu",0,16,4,12,0
"yeldrocks",1,9,2,7,0
"rjyzoaoljqknb",0,13,3,10,0
"nonalinement",1,12,5,7,0
"radioanaphoric",0,14,7,7,0
"falconer",1,8,3,5,0
"hawknose",1,8,3,5,0
"unprejudice",1,11,5,6,0
"detrimenting",0,12,4,8,0
"mindfucks",1,9,2,7,0
"wanemons",0,8,3,5,0
"pationacks",0,10,4,6,0
"calefactional",0,13,6,7,0
"womeuivehs",0,10,5,5,0
"qghsxgsdrkjbahgwjx",0,18,1,17,0
"dogfox",1,6,2,4,0
"dificiously",0,11,5,6,0
"outscorns",1,9,3,6,0
"clyoperrgamoschntirroumadrtinlilicoliuandogilaschtrbisegwane",0,60,22,38,0
"wordmaking",1,10,3,7,0
"folkland",1,8,2,6,0
"balladeroyal",1,12,5,7,0
"halaming",0,8,3,5,0
"nontemperateness",1,16,6,10,0
"pouter",1,6,3,3,0
"hior",0,4,2,2,0
"glycemia",0,8,3,5,0
"kickau",0,6,3,3,0
"mowas",1,5,2,3,0
"cystennuinian",0,13,5,8,0
"unbureaucratically",1,18,8,10,0
"tazomisltercimablas",0,19,7,12,0
"chnvabamenganesearel",0,20,8,12,0
"cappery",0,7,2,5,0
"hlwn",0,4,0,4,0
"cle",0,3,1,2,0
"yqwazzsnyduflzes",0,16,3,13,0
"prefishnerger",0,13,4,9,0
"sphenomena",0,10,4,6,0
"progue",0,6,3,3,0
"bathtsvilladisacquatic",0,22,8,14,0
"bioush",0,6,3,3,0
"overwidely",1,10,4,6,0
"hhofpxpiytxvbuzdsz",0,18,3,15,0
"suln",0,4,1,3,0
"layoquousness",0,13,6,7,0
"mettie",1,6,3,3,0
"marshflower",1,11,3,8,0
"ballman",1,7,2,5,0
"deducive",1,8,4,4,0
"limericks",1,9,3,6,0
"preopsis",0,8,3,5,0
"pobue'rjdcpuoxipowjsagwfzq",0,26,8,18,1
"myrmer",0,6,1,5,0
"labourites",1,10,5,5,0
"forestantial",0,12,5,7,0
"antty",0,5,1,4,0
"nonbeneficence",1,14,6,8,0
"yepely",1,6,2,4,0
"sauce",1,5,3,2,0
"charah",0,6,2,4,0
"paternalistically",1,17,6,11,0
"sanguifies",1,10,5,5,0
"trainmen",1,8,3,5,0
"astiverbush",0,11,4,7,0
"minstrel",1,8,2,6,0
"emhe'ujh'v",0,10,3,7,2
"xoztnrlzxffd",0,12,1,11,0
"bflower",0,7,2,5,0
"mercurialis",1,11,5,6,0
"snuffer",1,7,2,5,0
"unwaned",1,7,3,4,0
"sculduddery",1,11,3,8,0
"tariffise",1,9,4,5,0
"chuckfarthing",1,13,3,10,0
"myrtlessner",0,11,2,9,0
"bedesman",1,8,3,5,0
"cleidarthritis",1,14,5,9,0
"pleurocerebral",1,14,6,8,0
"nuthous",0,7,3,4,0
"nonbuoyantly",1,12,4,8,0
"wiqbcffgemrlufsmwo",0,18,4,14,0
"activizes",1,9,4,5,0
"mohammercive",0,12,5,7,0
"wigaes",0,6,3,3,0
"treponematoses",1,14,6,8,0
"spavindy",1,8,2,6,0
"freewritingness",0,15,5,10,0
"hottedness",0,10,3,7,0
"randomisations",1,14,6,8,0
"dargle",1,6,2,4,0
"wijwpxazjoz",0,11,3,8,0
"hypophyseoprivous",1,17,6,11,0
"qus",0,3,1,2,0
"stophomovervock",0,15,5,10,0
"slothwaities",0,12,5,7,0
"nazification",1,12,6,6,0
"clearcutness",1,12,4,8,0
"joggling",1,8,2,6,0
"chiasusceptune",0,14,6,8,0
"telitey",0,7,3,4,0
"ariel",1,5,3,2,0
"zosterops",1,9,3,6,0
"babilane",0,8,4,4,0
"hairece",0,7,4,3,0
"benoverparangs",0,14,5,9,0
"counterly",1,9,3,6,0
"gozewasllyt",0,11,3,8,0
"apostrophies",0,12,5,7,0
"chechnyan",1,9,2,7,0
"nongibs",0,7,2,5,0
"unchodonakinites",0,16,7,9,0
"cleanne",0,7,3,4,0
"etwee",1,5,3,2,0
"kees'lee",0,8,4,4,1
"blottes",0,7,2,5,0
"nondenominational",1,17,8,9,0
"suarbopterlods",0,14,5,9,0
"dongle",1,6,2,4,0
"pantinonchiliqueazio",0,20,10,10,0
"ilkxzihccqjk",0,12,2,10,0
"barbackup",0,9,3,6,0
"brigal",0,6,2,4,0
"satyras",1,7,2,5,0
"meandershepherded",0,17,6,11,0
"tory",1,4,1,3,0
"unemployment",1,12,4,8,0
"potis",0,5,2,3,0
"mmin",0,4,1,3,0
"conves",0,6,2,4,0
"mrssnrsecjkgvoufcybtolclon",0,26,5,21,0
"qwzcnlbjf",0,9,0,9,0
"twoccing",1,8,2,6,0
"compulsive",1,10,4,6,0
"jamalacings",0,11,4,7,0
"mysteriosophy",1,13,4,9,0
"hyperman",0,8,2,6,0
"byrlady",1,7,1,6,0
"unsequite",0,9,5,4,0
"alcumy",1,6,2,4,0
"bottomness",1,10,3,7,0
"pyroheliometer",1,14,6,8,0
"goeniere",0,8,5,3,0
"robbyn",1,6,1,5,0
"ayaqaalaq",0,9,5,4,0
"triols",1,6,2,4,0
"pearlitic",1,9,4,5,0
"columnistic",1,11,4,7,0
"utnapishtim",1,11,4,7,0
"somaxi",0,6,3,3,0
"mazwhlwtglh",0,11,1,10,0
"raculer",0,7,3,4,0
"jobestotidamabilaerotenstiprcophemanves",0,39,16,23,0
"protozoulogical",1,15,7,8,0
"nons",0,4,1,3,0
"hebestoonnisera",0,15,7,8,0
"siliquarius",0,11,6,5,0
"lutisms",0,7,2,5,0
"seitxbjhuiotyxph'vin'",0,21,6,15,2
"buckeye",1,7,3,4,0
"unprondereatta",0,14,6,8,0
"lobedieness",0,11,5,6,0
"wagoner",1,7,3,4,0
"kaffrarians",1,11,4,7,0
"mtkscgrljkfardbuj",0,17,2,15,0
"abelmusk",1,8,3,5,0
"purpuric",1,8,3,5,0
"highlan",0,7,2,5,0
"kbyqllzhxszqd",0,13,0,13,0
"catalufa",1,8,4,4,0
"velma",1,5,2,3,0
"muisting",1,8,3,5,0
"ylieecry",0,8,3,5,0
"schiavoni",1,9,4,5,0
"instrumentalism",1,15,5,10,0
"presages",1,8,3,5,0
"exorcistically",0,14,5,9,0
"ccaue",0,5,3,2,0
"horizontically",1,14,5,9,0
"ideogrammed",0,11,5,6,0
"alkmardnes",0,10,3,7,0
"evaristus",1,9,4,5,0
"deschutes",1,9,3,6,0
"spleuracana",0,11,5,6,0
"unnerving",1,9,3,6,0
"tfqzeqqvlwwuzfprhxnpm",0,21,2,19,0
"kcvbkalnvzwubavmg",0,17,3,14,0
"gefj",0,4,1,3,0
"memrpwzbobgqjrocoducgpww",0,24,5,19,0
"bookkneepagata",0,14,7,7,0
"adrenalcortical",1,15,6,9,0
"cecilla",1,7,3,4,0
"kries",1,5,2,3,0
"wabbcrons",0,9,2,7,0
"pari",0,4,2,2,0
"branchiosaurian",1,15,7,8,0
"inscience",1,9,4,5,0
"polycentrism",1,12,3,9,0
"gemstone",1,8,3,5,0
"deprobar",0,8,3,5,0
"nobilitle",0,9,4,5,0
"uniousnesses",0,12,6,6,0
"colshipie",0,9,4,5,0
"yqktfzxojwqokzelosibzcbev",0,25,6,19,0
"kathodal",1,8,3,5,0
"bunic",0,5,2,3,0
"copenov",0,7,3,4,0
"dissection",1,10,4,6,0
"catalanist",1,10,4,6,0
"backaches",1,9,3,6,0
"perpignan",1,9,3,6,0
"musketry",1,8,2,6,0
"collateralized",1,14,6,8,0
"minnes",0,6,2,4,0
"pyrophoruses",1,12,4,8,0
"nonremuneration",1,15,7,8,0
"unthematically",1,14,5,9,0
"batodent",0,8,3,5,0
"semimicroanalysis",1,17,7,10,0
"phexpror",0,8,2,6,0
"accha",0,5,2,3,0
"atelss",0,6,2,4,0
"winkerous",0,9,4,5,0
"rubicure",0,8,4,4,0
"lithodomus",1,10,4,6,0
"frerich",0,7,2,5,0
"midhead",0,7,3,4,0
"sboltorintladrseoway",0,20,7,13,0
"steppingstones",1,14,4,10,0
"unfingered",1,10,4,6,0
"voronoff",1,8,3,5,0
"sublieutenants",1,14,6,8,0
"homopsida",0,9,4,5,0
"korntunna",1,9,3,6,0
"nummulation",1,11,5,6,0
"disform",1,7,2,5,0
"occuttingasband",0,15,5,10,0
"whippet",1,7,2,5,0
"ster",0,4,1,3,0
"dideswomen",0,10,4,6,0
"cobryatalactionsteracadicoard",0,29,12,17,0
"substabled",0,10,3,7,0
"mascot",1,6,2,4,0
"recovery",1,8,3,5,0
"essentional",0,11,5,6,0
"gluttonising",1,12,4,8,0
"z'rumbrunijgvgmxetx",0,19,4,15,1
"iricheratinopongeroponers",0,25,11,14,0
"recamier",1,8,4,4,0
"cocisinwad",0,10,4,6,0
"leglins",1,7,2,5,0
"badhimenics",0,11,4,7,0
"caponniere",1,10,5,5,0
"epineanty",0,9,4,5,0
"favourite",1,9,5,4,0
"housewa",0,7,4,3,0
"nonseriality",1,12,5,7,0
"beful",0,5,2,3,0
"antlers",1,7,2,5,0
"misapplication",1,14,6,8,0
"icentlikoletaean",0,16,8,8,0
"panguilitalle",0,13,6,7,0
"nlqzlwcn",0,8,0,8,0
"unsummoned",1,10,4,6,0
"mandelson",1,9,3,6,0
"underuyters",0,11,4,7,0
"pearsall",1,8,3,5,0
"occleve",1,7,3,4,0
"carcisation",0,11,5,6,0
"enterma",0,7,3,4,0
"llozecybesyan",0,13,4,9,0
"unchristabel",0,12,4,8,0
"undisturbed",1,11,4,7,0
"birse",1,5,2,3,0
"berycian",0,8,3,5,0
"isodynamic",1,10,4,6,0
"gurolinick",1,10,4,6,0
"soaves",1,6,3,3,0
"trichophyllous",1,14,4,10,0
"otocranic",1,9,4,5,0
"perr",1,4,1,3,0
"outplays",1,8,3,5,0
"biozonises",0,10,5,5,0
"heela",0,5,3,2,0
"aulpinecinoragrentrmoliogsacoparnur",0,35,15,20,0
"conilurus",1,9,4,5,0
"aerophane",1,9,5,4,0
"unvoluminousness",1,16,7,9,0
"unhired",1,7,3,4,0
"bathroomed",1,10,4,6,0
"stracetambridousness",0,20,7,13,0
"ae",0,2,2,0,0
"ensheafs",0,8,3,5,0
"hlsrn'pwadovwbrstdazyalws",0,25,4,21,1
"prekindergarten",1,15,5,10,0
"aeria",1,5,4,1,0
"polyneurous",0,11,5,6,0
"albunea",1,7,4,3,0
"puggarees",1,9,4,5,0
"bowliness",0,9,3,6,0
"kfdzgvw'h",0,9,0,9,1
"s'wactmthdvbxtxtb'vproyuaxhhz",0,29,4,25,2
"tienjudere",0,10,5,5,0
"hydroborofluoric",1,16,6,10,0
"gatrotaliasestantonil",0,21,9,12,0
"schizoidism",1,11,4,7,0
"prevenance",1,10,4,6,0
"solanderfulness",0,15,5,10,0
"gopik",1,5,2,3,0
"fralle",0,6,2,4,0
"platichthyes",0,12,3,9,0
"nonfels",0,7,2,5,0
"interstitial",1,12,5,7,0
"biasness",1,8,3,5,0
"tobaccoism",1,10,4,6,0
"hederaceously",1,13,6,7,0
"pluviometry",1,11,4,7,0
"orbicuspensiveness",0,18,7,11,0
"neopologistical",0,15,7,8,0
"qxtndtqpsvykqsgs",0,16,0,16,0
"ptilocrinus",1,11,4,7,0
"lackwittedly",1,12,3,9,0
"downforcedly",0,12,3,9,0
"sanfourd",1,8,3,5,0
"tonomical",0,9,4,5,0
"snaga",0,5,2,3,0
"comparer",1,8,3,5,0
"dunster",1,7,2,5,0
"overfactiously",1,14,6,8,0
"birrell",1,7,2,5,0
"oleogeny",0,8,4,4,0
"wxiipgxegtobfsipz'",0,18,5,13,1
"pop",1,3,1,2,0
"p'uiy'y'cbnejju",0,15,4,11,3
"'rlsnb",0,6,0,6,1
"ungentlewomanlier",0,17,7,10,0
"rdodlmhwm",0,9,1,8,0
"stonewalls",1,10,3,7,0
"subspecialization",1,17,8,9,0
"markdowns",1,9,2,7,0
"teers",0,5,2,3,0
"collat",1,6,2,4,0
"rebirth",1,7,2,5,0
"sexts",1,5,1,4,0
"jgnlccfjfielvplh'ogmxnz",0,23,3,20,1
"toxicism",0,8,3,5,0
"epid",0,4,2,2,0
"grufe",1,5,2,3,0
"anigrapher",0,10,4,6,0
"bard",1,4,1,3,0
"lamaist",1,7,3,4,0
"teriante",0,8,4,4,0
"wagweno",1,7,3,4,0
"increately",1,10,4,6,0
"graphyrocarabi",0,14,5,9,0
"anisostichum",0,12,5,7,0
"rialinthimphbowepecerinenages",0,29,12,17,0
"nifiangucoucumitonaleliorea",0,27,15,12,0
"god",1,3,1,2,0
"nonyl",1,5,1,4,0
"cualms",0,6,2,4,0
"unvert",0,6,2,4,0
"strumming",1,9,2,7,0
"ardishicarype",0,13,5,8,0
"ynzocxrgqzxvjluun",0,17,3,14,0
"pezia",0,5,3,2,0
"unpetulantly",1,12,4,8,0
"bjourness",0,9,3,6,0
"raritan",1,7,3,4,0
"nonrecoil",1,9,4,5,0
"internalised",1,12,5,7,0
"aestuary",1,8,4,4,0
"raticap",0,7,3,4,0
"ultann",1,6,2,4,0
"riblechwoornollenel",0,19,7,12,0
"intellectualistically",1,21,8,13,0
"superstate",1,10,4,6,0
"uredina",0,7,4,3,0
"efonundestare",0,13,6,7,0
"splinty",1,7,1,6,0
"rmonelinauferoms",0,16,7,9,0
"brookster",0,9,3,6,0
"ketembillate",0,12,5,7,0
"eruditional",1,11,6,5,0
"immodest",1,8,3,5,0
"saam",1,4,2,2,0
"peaching",1,8,3,5,0
"wxajofbibaawmdptxfwuqgury",0,25,7,18,0
"schurman",1,8,2,6,0
"palese",0,6,3,3,0
"gexkssgctrtkajuhmgerkphy",0,24,4,20,0
"hysterol",0,8,2,6,0
"oboobia",0,7,5,2,0
"resusceptivitian",0,16,7,9,0
"buttonholes",1,11,4,7,0
"eprolwa",0,7,3,4,0
"recleared",0,9,4,5,0
"phylacobiosis",1,13,5,8,0
"toadstones",1,10,4,6,0
"uglift",0,6,2,4,0
"alphabetiser",1,12,5,7,0
"densian",0,7,3,4,0
"postdebutantes",1,14,5,9,0
"zkopldhkbczlmzkjcahlnbnrxgba",0,28,3,25,0
"ariane",1,6,4,2,0
"thristomahandyner",0,17,5,12,0
"ethnolinguistic",1,15,6,9,0
"unpikranscidae",0,14,6,8,0
"lateralized",1,11,5,6,0
"ursal",1,5,2,3,0
"carphiophiops",1,13,5,8,0
"aggaggling",0,10,3,7,0
"calke",0,5,2,3,0
"aigialosaurus",1,13,8,5,0
"spumone",1,7,3,4,0
"nibble",1,6,2,4,0
"cn'fhbnkgqotcryogbh",0,19,2,17,1
"neaptide",1,8,4,4,0
"corticotropin",1,13,5,8,0
"demanyanos",0,10,4,6,0
"tanzanitas",0,10,4,6,0
"hjtgubkwscdpz'e'iy",0,18,3,15,2
"zootechnics",1,11,4,7,0
"drudgeworks",1,11,3,8,0
"histoglossa",0,11,4,7,0
"hechte",0,6,2,4,0
"kirbie",1,6,3,3,0
"varletaille",1,11,5,6,0
"quadragenary",0,12,5,7,0
"humbleness",1,10,3,7,0
"fpzrwtrbiizaxcdw",0,16,3,13,0
"cyma",1,4,1,3,0
"cytoniarcemation",0,16,7,9,0
"dostricons",0,10,3,7,0
"reflectorise",1,12,5,7,0
"ggninicatigieruivewis",0,21,10,11,0
"worl",1,4,1,3,0
"umangite",1,8,4,4,0
"branctiva",0,9,3,6,0
"subceptions",1,11,4,7,0
"barnabe",1,7,3,4,0
"eelyspyactrivaragrtumatu",0,24,9,15,0
"lzo'kbdol'zbamuhjcc",0,19,4,15,2
"kahunanangel",0,12,5,7,0
"rieseeximieneelt",0,16,9,7,0
"tympanuchus",1,11,3,8,0
"zjqeimiiqxhfoneu",0,16,7,9,0
"vsxhridlsj'ykl'myo",0,18,2,16,2
"zelotypie",1,9,4,5,0
"holohedry",1,9,3,6,0
"nlmmcgbzbjzlmxpjxiw'wyhpxid",0,27,2,25,1
"comb",1,4,1,3,0
"spinozisms",1,10,3,7,0
"coughings",1,9,3,6,0
"donero",0,6,3,3,0
"mviuiyaamymxqzuscuwkuhs",0,23,8,15,0
"paygottunslachroraterenaroloncolonsa",0,36,14,22,0
"wirelessness",1,12,4,8,0
"preindemnifying",1,15,5,10,0
"contactor",1,9,3,6,0
"qqbklhgnwayr",0,12,1,11,0
"bhqmhlgpnigzirphhxdzecth",0,24,3,21,0
"pedicellaria",1,12,6,6,0
"'ohussefpfmqxq'xri",0,18,4,14,2
"mptpwbkmassrnxlsvjvcur'",0,23,2,21,1
"pauninditeg",0,11,5,6,0
"scrimatobian",0,12,5,7,0
"foregrounded",1,12,5,7,0
"backlands",1,9,2,7,0
"gyqskbdb'hjmgolux'cjgzkbjnzd",0,28,2,26,2
"nikolos",1,7,3,4,0
"disintegrable",1,13,5,8,0
"heterokinesis",1,13,6,7,0
"virilier",0,8,4,4,0
"bleoteetiselonatsm",0,18,8,10,0
"cophieston",0,10,4,6,0
"zoophilia",1,9,5,4,0
"land",1,4,1,3,0
"overpreters",0,11,4,7,0
"industrys",1,9,2,7,0
"stepladders",1,11,3,8,0
"gammonaea",0,9,5,4,0
"paraphonic",1,10,4,6,0
"basidigital",1,11,5,6,0
"discriminativeness",1,18,7,11,0
"underoid",0,8,4,4,0
"ascitan",1,7,3,4,0
"crant",0,5,1,4,0
"kivikivi",1,8,4,4,0
"cundity",0,7,2,5,0
"eurysthenes",1,11,4,7,0
"condalia",1,8,4,4,0
"noordbreakishexahydracrylate",0,28,10,18,0
"angiotribe",1,10,5,5,0
"nakomgilisala",1,13,6,7,0
"violator",1,8,4,4,0
"metallary",1,9,3,6,0
"spunkinesses",1,12,4,8,0
"dkddet",0,6,1,5,0
"scrapparellishers",0,17,5,12,0
"lacarne",1,7,3,4,0
"ourve",0,5,3,2,0
"extemportions",0,13,5,8,0
"yangtze",1,7,2,5,0
"superunfit",1,10,4,6,0
"jdljacxubf",0,10,2,8,0
"lookists",1,8,3,5,0
"matriarchical",1,13,5,8,0
"nonaccretion",1,12,5,7,0
"wiretapper",1,10,4,6,0
"mechelles",0,9,3,6,0
"toganteria",0,10,5,5,0
"elutinate",0,9,5,4,0
"phyllite",1,8,2,6,0
"ichtworkeld",0,11,3,8,0
"supplier",1,8,3,5,0
"fother",1,6,2,4,0
"vaselined",1,9,4,5,0
"subhypotheses",1,13,4,9,0
"coerttowomas",0,12,5,7,0
"killdeer",1,8,3,5,0
"bergh",1,5,1,4,0
"cursorientally",0,14,5,9,0
"aforesaid",1,9,5,4,0
"flurry",1,6,1,5,0
"priciact",0,8,3,5,0
"tweunrjdpocqab''xktekk",0,22,5,17,2
"hasthteoximacre",0,15,6,9,0
"linamarin",1,9,4,5,0
"slaying",1,7,2,5,0
"conservatist",1,12,4,8,0
"iujhrs'amznjdfxbsjoptmwsqksy",0,28,4,24,1
"mmgdmjnszdogxzq",0,15,1,14,0
"paragliding",1,11,4,7,0
"spinnariidae",0,12,6,6,0
"crampons",1,8,2,6,0
"hok",0,3,1,2,0
"d'qhodu'uzns",0,12,3,9,2
"thundrasianism",0,14,5,9,0
"tribathful",0,10,3,7,0
"creent",0,6,2,4,0
"pyrolamas",0,9,3,6,0
"rousseauite",1,11,7,4,0
"nihal",1,5,2,3,0
"cogotinobimity",0,14,6,8,0
"t'xpcudxvbhfavkzhga",0,19,3,16,1
"jaquesian",1,9,5,4,0
"mir",1,3,1,2,0
"noblepiumanoningcorstoromak",0,27,11,16,0
"lously",0,6,2,4,0
"wormwoods",1,9,3,6,0
"unfathomablenesses",1,18,7,11,0
"odifte",0,6,3,3,0
"heterokinesis",1,13,6,7,0
"imprisoner",1,10,4,6,0
"crotypographer",0,14,4,10,0
"januisz",1,7,3,4,0
"nondescriber",0,12,4,8,0
"freer",1,5,2,3,0
"fnaz'xom'doqvjkqeszndbrz",0,24,4,20,2
"myzodendraceous",1,15,6,9,0
"brothers",1,8,2,6,0
"ganakilot",0,9,4,5,0
"bitinssumpefferitacrmiomalltnessedsarfiectss",0,44,15,29,0
"stippled",1,8,2,6,0
"radiophotos",1,11,5,6,0
"katicawopintes",0,14,6,8,0
"personising",1,11,4,7,0
"rhesus",1,6,2,4,0
"unbillable",1,10,4,6,0
"l'fdytmxhip",0,11,1,10,1
"chiploancered",0,13,5,8,0
"aphlago",0,7,3,4,0
"unmaneged",1,9,4,5,0
"jooklam",0,7,3,4,0
"purpurchivedal",0,14,5,9,0
"moptona",0,7,3,4,0
"unaccumulated",1,13,6,7,0
"nondisciplined",1,14,5,9,0
"onaka",1,5,3,2,0
"wearability",1,11,5,6,0
"precedestration",0,15,6,9,0
"luftmensch",1,10,2,8,0
"ootompeclarprooshagentily",0,25,10,15,0
"freedoot",1,8,4,4,0
"tomography",1,10,3,7,0
"sonatine",1,8,4,4,0
"ostentator",0,10,4,6,0
"phascogale",1,10,4,6,0
"gcudotm",0,7,2,5,0
"sporocarpium",1,12,5,7,0
"rbronge",0,7,2,5,0
"indefensibly",1,12,4,8,0
"munros",1,6,2,4,0
"fomentative",0,11,5,6,0
"si'vu'h",0,7,2,5,2
"looseness",1,9,4,5,0
"propertype",0,10,3,7,0
"inviolateness",1,13,6,7,0
"restral",0,7,2,5,0
"preadamite",1,10,5,5,0
"turtlers",1,8,2,6,0
"doggle",1,6,2,4,0
"ptiatettes",0,10,4,6,0
"strousness",0,10,3,7,0
"greenba",0,7,3,4,0
"raties",0,6,3,3,0
"chorivanemms",0,12,4,8,0
"overmaschloes",0,13,5,8,0
"deshabilles",1,11,4,7,0
"imponderance",0,12,5,7,0
"optigraph",1,9,3,6,0
"salariat",1,8,4,4,0
"majess",0,6,2,4,0
"capiadermiscutria",0,17,8,9,0
"irispaterc",0,10,4,6,0
"subdiaphosphers",0,15,5,10,0
"fushun",1,6,2,4,0
"theriolates",0,11,5,6,0
"plectopter",1,10,3,7,0
"dilatorinesses",1,14,6,8,0
"oetnmrqkhzgsbqimgydguhfyrgez",0,28,5,23,0
"maceae",0,6,4,2,0
"annens",0,6,2,4,0
"interpeduncular",1,15,6,9,0
"kilorad",1,7,3,4,0
"urnmaker",1,8,3,5,0
"beastings",1,9,3,6,0
"pterophonic",0,11,4,7,0
"gypaethrin",0,10,3,7,0
"neoconchopneusis",0,16,7,9,0
"tiploid",0,7,3,4,0
"frathingorgeviod",0,16,6,10,0
"naliandomstitraniusnakkorrithrale",0,33,13,20,0
"lighter",1,7,2,5,0
"tetrachical",1,11,4,7,0
"gonitise",0,8,4,4,0
"replenish",1,9,3,6,0
"lobionapanistunkahsh",0,20,8,12,0
"thrombosi",0,9,3,6,0
"udurmetiazoniopleslalanequld",0,28,13,15,0
"inteumonal",0,10,5,5,0
"gynandromorph",1,13,3,10,0
"prockilishention",0,16,6,10,0
"stotribulian",0,12,5,7,0
"seligman",1,8,3,5,0
"intrication",1,11,5,6,0
"diffusion",1,9,4,5,0
"mespilus",1,8,3,5,0
"northington",1,11,3,8,0
"victoir",1,7,3,4,0
"mbbxomgb'wzcfaduknltuxjffn",0,26,4,22,1
"kansous",0,7,3,4,0
"anovocathmiacetone",0,18,9,9,0
"figurabilities",1,14,7,7,0
"ste",0,3,1,2,0
"gambrel",1,7,2,5,0
"webhead",1,7,3,4,0
"alasignatna",0,11,5,6,0
"armode",0,6,3,3,0
"scophossadiscanisseaugighthfling",0,32,11,21,0
"candid",1,6,2,4,0
"complexification",1,16,7,9,0
"cayla",1,5,2,3,0
"phylactorienting",0,16,5,11,0
"hophyeppermus",0,13,4,9,0
"patedev",0,7,3,4,0
"bedless",1,7,2,5,0
"ecu",1,3,2,1,0
"cotingidae",1,10,5,5,0
"rombosenchieration",0,18,8,10,0
"contrascrotal",0,13,4,9,0
"disserted",1,9,3,6,0
"contague",0,8,4,4,0
"murielle",1,8,4,4,0
"tritebpenddrongerne",0,19,6,13,0
"lopsidednesses",1,14,5,9,0
"guruzze",0,7,3,4,0
"drinkermans",0,11,3,8,0
"poy",1,3,1,2,0
"hazelhurst",1,10,3,7,0
"waistbelts",1,10,3,7,0
"unsubsell",0,9,3,6,0
"youthless",1,9,3,6,0
"malapert",1,8,3,5,0
"vrpevhoxy",0,9,2,7,0
"wbvtenesstioce",0,14,5,9,0
"unyokes",1,7,3,4,0
"bullbrier",1,9,3,6,0
"gllxea",0,6,2,4,0
"algologies",1,10,5,5,0
"protomorteromenthorescenceser",0,29,11,18,0
"trotted",1,7,2,5,0
"urethrophyma",1,12,4,8,0
"cleche",1,6,2,4,0
"sillyhood",1,9,3,6,0
"repollute",1,9,4,5,0
"eoos",0,4,3,1,0
"enjppa",0,6,2,4,0
"figynontationisolvers",0,21,8,13,0
"micropalaeontologist",1,20,9,11,0
"amooves",1,7,4,3,0
"lioaphouealatiris",0,17,10,7,0
"peingesine",0,10,5,5,0
"nontradition",1,12,5,7,0
"cricoids",1,8,3,5,0
"fiaunt",1,6,3,3,0
"botral",0,6,2,4,0
"titurnist",0,9,3,6,0
"extrepharatorioranaeuss",0,23,11,12,0
"lepolynnine",0,11,4,7,0
"sso",1,3,1,2,0
"meda",1,4,2,2,0
"microparticulable",0,17,7,10,0
"reinstructs",1,11,3,8,0
"externship",1,10,3,7,0
"langrenus",1,9,3,6,0
"hemolymph",1,9,2,7,0
"displeasureable",1,15,7,8,0
"penaea",1,6,4,2,0
"farcers",1,7,2,5,0
"reamus",0,6,3,3,0
"betreations",0,11,5,6,0
"freewriting",1,11,4,7,0
"stephanometers",0,14,5,9,0
"monstat",0,7,2,5,0
"spectrode",0,9,3,6,0
"fonig",0,5,2,3,0
"adpromissor",1,11,4,7,0
"didact",1,6,2,4,0
"peratop",0,7,3,4,0
"indiademed",1,10,5,5,0
"gasteromycetes",1,14,5,9,0
"sedbsttyomod",0,12,3,9,0
"pebr",0,4,1,3,0
"wedgie",1,6,3,3,0
"unkedin",0,7,3,4,0
"accos",0,5,2,3,0
"zxchcwzxbu'jsts'yu",0,18,2,16,2
"iguania",1,7,5,2,0
"annecorinne",1,11,5,6,0
"cdichotly",0,9,2,7,0
"wiros",1,5,2,3,0
"bsw",1,3,0,3,0
"ringworth",0,9,2,7,0
"fieldie",1,7,4,3,0
"sludgier",1,8,3,5,0
"preeconomical",1,13,6,7,0
"palaeomagnetism",1,15,7,8,0
"pierrot",1,7,3,4,0
"materialities",1,13,7,6,0
"conboisaltlarerisz",0,18,7,11,0
"akked",0,5,2,3,0
"dulcibelle",1,10,4,6,0
"nondefinably",1,12,4,8,0
"snes",0,4,1,3,0
"equa",0,4,3,1,0
"cyathiformers",0,13,4,9,0
"runtgenizing",1,12,4,8,0
"psilose",0,7,3,4,0
"chely",0,5,1,4,0
"lgrdgnrbgtn'zzqef'pgfvq'rys",0,27,1,26,3
"reruedatrialalfierselditt",0,25,11,14,0
"quatisms",0,8,3,5,0
"headbox",1,7,3,4,0
"synfuel",1,7,2,5,0
"jay",0,3,1,2,0
"nsis",0,4,1,3,0
"fredek",1,6,2,4,0
"optoelectrogenitures",0,20,9,11,0
"chemospasia",0,11,5,6,0
"tbnfgmafxzlpfwoha",0,17,3,14,0
"pentadic",1,8,3,5,0
"shabroon",1,8,3,5,0
"flimonsfrapolo",0,14,5,9,0
"ctluatabasdabppr",0,16,5,11,0
"lno'gkhxsaqilha",0,15,4,11,1
"q'fxrylfwue'bpf've",0,18,3,15,3
"cinchoate",0,9,4,5,0
"oblongritic",0,11,4,7,0
"cousin",1,6,3,3,0
"liamandat",0,9,4,5,0
"beaconlessnesses",0,16,6,10,0
"repining",1,8,3,5,0
"unswappable",1,11,4,7,0
"glutination",1,11,5,6,0
"cophalcomicynd",0,14,4,10,0
"notitic",0,7,3,4,0
"resinification",1,14,7,7,0
"cytosis",0,7,2,5,0
"countrailitz",0,12,5,7,0
"coohee",1,6,4,2,0
"fcbxwatcyrazvhziiyveanpttvysb",0,29,6,23,0
"huddlingly",1,10,2,8,0
"himeros",1,7,3,4,0
"taran",1,5,2,3,0
"undandled",1,9,3,6,0
"spomst",0,6,1,5,0
"francophobia",1,12,5,7,0
"micapopal",0,9,4,5,0
"giroflore",1,9,4,5,0
"foolier",0,7,4,3,0
"menshevik",1,9,3,6,0
"tequila",1,7,4,3,0
"coexist",1,7,3,4,0
"freaky",1,6,2,4,0
"floutingstocks",1,14,4,10,0
"phidippides",1,11,4,7,0
"bzkfefmfl",0,9,1,8,0
"'fpktrpbtbnwsdiuvan'grnjbuk",0,27,4,23,2
"u'ahlczvkgkfhlhcarroycd",0,23,4,19,1
"buoshofjogarocivfzjfk'v'an",0,26,8,18,2
"ipad",1,4,2,2,0
"terrestrialise",1,14,6,8,0
"korc",1,4,1,3,0
"stintings",1,9,2,7,0
"wzheuaqcwb",0,10,3,7,0
"woowu",0,5,3,2,0
"lightning",1,9,2,7,0
"pdwawaaufzse",0,12,5,7,0
"prunasinousness",0,15,6,9,0
"epistemolog",1,11,5,6,0
"blegeole",0,8,4,4,0
"mccarthyite",1,11,3,8,0
"postorder",1,9,3,6,0
"inspheration",1,12,5,7,0
"strata",1,6,2,4,0
"overyoung",1,9,4,5,0
"allelogram",0,10,4,6,0
"kumni",1,5,2,3,0
"bbon",0,4,1,3,0
"postscutellum",1,13,4,9,0
"palises",0,7,3,4,0
"machmiadenous",0,13,6,7,0
"fortriditic",0,11,4,7,0
"varnemoness",0,11,4,7,0
"rjvmb'ktltfskf'ovyaeabjseaaz",0,28,7,21,2
"gxiyyikqmssdlxde'iwltsqflb",0,26,4,22,1
"rubvolia",0,8,4,4,0
"irresolvabilities",1,17,8,9,0
"linecasting",1,11,4,7,0
"wcycwrzx'uz",0,11,1,10,1
"twistily",1,8,2,6,0
"wifelier",1,8,4,4,0
"chlorhexidine",1,13,5,8,0
"cyclometer",1,10,3,7,0
"precelebrator",0,13,5,8,0
"paralogism",1,10,4,6,0
"repowderless",0,12,4,8,0
"diurne",1,6,3,3,0
"ambassies",1,9,4,5,0
"thunderstrikes",1,14,4,10,0
"rennotienesquategation",0,22,11,11,0
"pangatuntergat",0,14,5,9,0
"unmodernness",0,12,4,8,0
"usphovilsponomingrpueamironernerely",0,35,14,21,0
"dimercaprol",1,11,4,7,0
"diyhqursxgoyx'tbybw'nk",0,22,3,19,2
"inonodgianthork",0,15,6,9,0
"seminai",0,7,4,3,0
"exact",1,5,2,3,0
"clarabella",1,10,4,6,0
"balzacian",1,9,4,5,0
"decalitre",1,9,4,5,0
"antepagments",1,12,4,8,0
"airstyling",0,10,3,7,0
"disfaction",0,10,4,6,0
"gid",1,3,1,2,0
"punnier",1,7,3,4,0
"adytoid",0,7,3,4,0
"qzmifllhmi'yydoiokrrwcclf",0,25,5,20,1
"schistocytes",1,12,3,9,0
"hespiridea",0,10,5,5,0
"sparrowy",1,8,2,6,0
"hamulose",1,8,4,4,0
"hackneyman",1,10,3,7,0
"buttinski",1,9,3,6,0
"threeper",0,8,3,5,0
"polyisobutyrophenolia",0,21,9,12,0
"visor",1,5,2,3,0
"numbevochabva",0,13,5,8,0
"miegeckancodlan",0,15,6,9,0
"strenuousness",1,13,5,8,0
"thrana",0,6,2,4,0
"aculattus",0,9,4,5,0
"pelharmouse",0,11,5,6,0
"galbrecht",0,9,2,7,0
"kahlotuslandy",0,13,4,9,0
"hassamen",0,8,3,5,0
"gaulit",0,6,3,3,0
"gly",0,3,0,3,0
"trichad",0,7,2,5,0
"housesat",1,8,4,4,0
"jiiq",0,4,2,2,0
"dfslkizzguag'rqa",0,16,4,12,1
"maurist",0,7,3,4,0
"peregrinates",1,12,5,7,0
"confutator",1,10,4,6,0
"bokhis",0,6,2,4,0
"photochemistry",1,14,4,10,0
"dinuba",1,6,3,3,0
"prospiterechip",0,14,5,9,0
"mocon",0,5,2,3,0
"yelt",1,4,1,3,0
"suchos",1,6,2,4,0
"xizdxixcvbvmefftfaa",0,19,5,14,0
"confections",1,11,4,7,0
"wocels",0,6,2,4,0
"dennie",1,6,3,3,0
"timbrels",1,8,2,6,0
"teems",1,5,2,3,0
"convector",1,9,3,6,0
"paramedic",1,9,4,5,0
"notan",1,5,2,3,0
"speller",1,7,2,5,0
"restorina",0,9,4,5,0
"cifig",0,5,2,3,0
"agung",1,5,2,3,0
"priml",0,5,1,4,0
"jactance",1,8,3,5,0
"precollapsing",1,13,4,9,0
"mischiefer",0,10,4,6,0
"simulance",1,9,4,5,0
"guated",0,6,3,3,0
"schia",0,5,2,3,0
"ineludibly",1,10,4,6,0
"estabbotch",0,10,3,7,0
"extender",1,8,3,5,0
"pejerrey",1,8,3,5,0
"rfobxbpixoh'mudngpyuxrk",0,23,5,18,1
"hydrosoponnody",0,14,4,10,0
"qabalah",1,7,3,4,0
"chen",1,4,1,3,0
"newsprint",1,9,2,7,0
"syecldtrrltsgwtxydy",0,19,1,18,0
"supercommentary",1,15,5,10,0
"tasonal",0,7,3,4,0
"yogurt",1,6,2,4,0
"anaxibia",1,8,5,3,0
"haulms",1,6,2,4,0
"assfaremomeneta",0,15,7,8,0
"infracorallike",0,14,6,8,0
"imblem",0,6,2,4,0
"muhanuttaurefrochiseloel",0,24,11,13,0
"parentage",1,9,4,5,0
"mesesiner",0,9,4,5,0
"ecycousinism",0,12,5,7,0
"dssnzqqw",0,8,0,8,0
"supercivilised",1,14,6,8,0
"dieselisation",1,13,7,6,0
"woricalk",0,8,3,5,0
"nauch",1,5,2,3,0
"comitra",0,7,3,4,0
"bernardo",1,8,3,5,0
"orysoakitendes",0,14,6,8,0
"overaccentuate",1,14,7,7,0
"basketwork",1,10,3,7,0
"orthyonisodont",0,14,5,9,0
"manshift",1,8,2,6,0
"bioly",0,5,2,3,0
"hemimercurrent",0,14,5,9,0
"elmendorf",1,9,3,6,0
"micropyle",1,9,3,6,0
"attendements",1,12,4,8,0
"counterchainability",0,19,8,11,0
"enfrancing",0,10,3,7,0
"anelesmacapllint",0,16,6,10,0
"rdiduialitrt",0,12,5,7,0
"adustiosis",1,10,5,5,0
"cwjbiybqmaag'ang",0,16,4,12,1
"elints",1,6,2,4,0
"usucaptable",1,11,5,6,0
"euglenineae",1,11,7,4,0
"maulgres",1,8,3,5,0
"apologetic",1,10,5,5,0
"shellie",1,7,3,4,0
"eaysfwujokqdkq'nrgv",0,19,4,15,1
"realpolitiks",1,12,5,7,0
"affilla",0,7,3,4,0
"sinhailien",1,10,5,5,0
"uncontemned",1,11,4,7,0
"gentlewomanish",1,14,5,9,0
"kame",1,4,2,2,0
"surveyals",1,9,3,6,0
"accompanying",1,12,4,8,0
"unstracheammillaccacte",0,22,8,14,0
"dinge",0,5,2,3,0
"handicrafters",1,13,4,9,0
"prookling",0,9,3,6,0
"swanpan",1,7,2,5,0
"overlightly",1,11,3,8,0
"overlaud",1,8,4,4,0
"apoint",0,6,3,3,0
"entorg",0,6,2,4,0
"gleis",1,5,2,3,0
"jjejyclgieibo'fb",0,16,5,11,1
"thrutch",1,7,1,6,0
"culex",1,5,2,3,0
"phtherologist",0,13,4,9,0
"intransliteratings",0,18,6,12,0
"napakiak",1,8,4,4,0
"howsomdever",1,11,4,7,0
"calder",1,6,2,4,0
"chaldaic",1,8,3,5,0
"juranfesmupphexts",0,17,5,12,0
"psychokidakeisha",0,16,6,10,0
"arahochums",0,10,4,6,0
"sphargised",0,10,3,7,0
"chantey",1,7,2,5,0
"cardiophobe",1,11,5,6,0
"baghdad",1,7,2,5,0
"destroyingly",1,12,3,9,0
"emphlysis",1,9,2,7,0
"cochecton",1,9,3,6,0
"eskite",0,6,3,3,0
"peregrinator",1,12,5,7,0
"badlg",0,5,1,4,0
"skep",1,4,1,3,0
"uurmlfbbxvyxa",0,13,3,10,0
"quadry",0,6,2,4,0
"kembs",1,5,1,4,0
"affrightfield",0,13,4,9,0
"homicrofilmslidemarchebiosis",0,28,11,17,0
"sarivelleexille",0,15,7,8,0
"xmalzdnulxz",0,11,2,9,0
"forittleeinelers",0,16,7,9,0
"dogton",0,6,2,4,0
"chrysopid",1,9,2,7,0
"gless",0,5,1,4,0
"misunderstander",1,15,5,10,0
"symmetrians",1,11,3,8,0
"myxobacterism",0,13,4,9,0
"unt",0,3,1,2,0
"weele",0,5,3,2,0
"luctyxcyx'p",0,11,1,10,1
"pillmonger",1,10,3,7,0
"neutical",0,8,4,4,0
"interpol",1,8,3,5,0
"ear",1,3,2,1,0
"amacensignifulgudinated",0,23,10,13,0
"hypercellularity",1,16,5,11,0
"concentrates",1,12,4,8,0
"postlaunch",1,10,3,7,0
"hematosis",0,9,4,5,0
"veechroneem",0,11,5,6,0
"pseudohumanistic",1,16,7,9,0
"seediness",1,9,4,5,0
"toppings",1,8,2,6,0
"epithetical",1,11,5,6,0
"yutzes",1,6,2,4,0
"binctigis",0,9,3,6,0
"claspt",1,6,1,5,0
"acup",0,4,2,2,0
"cholesters",0,10,3,7,0
"kittled",1,7,2,5,0
"uncustomariness",1,15,6,9,0
"gliare",1,6,3,3,0
"whitewing",1,9,3,6,0
"hiel",0,4,2,2,0
"infantiredated",0,14,6,8,0
"essera",1,6,3,3,0
"demilly",0,7,2,5,0
"parthena",1,8,3,5,0
"morphgan",1,8,2,6,0
"eczematosis",1,11,5,6,0
"nonegrohood",0,11,5,6,0
"bantidalolumalans",0,17,7,10,0
"markdowns",1,9,2,7,0
"ickersong",0,9,3,6,0
"trelu",1,5,2,3,0
"enures",1,6,3,3,0
"straucht",1,8,2,6,0
"barreleye",1,9,4,5,0
"unobligating",1,12,5,7,0
"terephthalate",1,13,5,8,0
"authenotcy",0,10,4,6,0
"elberon",1,7,3,4,0
"proctoplegia",1,12,5,7,0
"laqhfgwhcruj'",0,13,2,11,1
"rylgn'ihipccxj",0,14,2,12,1
"arsonations",0,11,5,6,0
"qleyhxyhrgcwvwbaxaw'm'",0,22,3,19,2
"ticketias",0,9,4,5,0
"equilibranchantasy",0,18,7,11,0
"ficteorisprement",0,16,6,10,0
"cheredetenagreramorimias",0,24,11,13,0
"iknxrz'd",0,8,1,7,1
"recco",1,5,2,3,0
"cytiflentatdo'nes",0,17,5,12,1
"glossion",0,8,3,5,0
"forehinting",1,11,4,7,0
"meliphagidae",1,12,6,6,0
"deppodozies",0,11,5,6,0
"molang",0,6,2,4,0
"gastroscopies",1,13,5,8,0
"topcastle",1,9,3,6,0
"chadbourne",1,10,4,6,0
"monadic",1,7,3,4,0
"thighter",0,8,2,6,0
"caoda",0,5,3,2,0
"titian",1,6,3,3,0
"mybaism",0,7,2,5,0
"aulard",1,6,3,3,0
"sluttent",0,8,2,6,0
"granum",1,6,2,4,0
"dysodils",1,8,2,6,0
"subspecialism",0,13,5,8,0
"nongintinderadexensa",0,20,8,12,0
"elegise",1,7,4,3,0
"emblemology",0,11,4,7,0
"ferriageproof",0,13,6,7,0
"despisingly",1,11,3,8,0
"poisonbush",1,10,4,6,0
"stelar",1,6,2,4,0
"overdress",1,9,3,6,0
"hlfpeowwnto",0,11,3,8,0
"bll",0,3,0,3,0
"billbergia",1,10,4,6,0
"rtinfios",0,8,3,5,0
"tequila",1,7,4,3,0
"overcon",0,7,3,4,0
"'j'fqdqfymjs",0,12,0,12,2
"ludd",1,4,1,3,0
"callisteia",1,10,5,5,0
"onychauxis",1,10,4,6,0
"mughal",1,6,2,4,0
"overshadowingly",1,15,5,10,0
"catalogists",1,11,4,7,0
"sproprily",0,9,2,7,0
"sordinavigation",0,15,7,8,0
"afgmfdzhzzyfgkfrycxv",0,20,1,19,0
"silkolines",1,10,4,6,0
"azynyjzkw",0,9,1,8,0
"sopeplabusleaveres",0,18,8,10,0
"druct",0,5,1,4,0
"quantico",1,8,4,4,0
"interbalance",1,12,5,7,0
"glory",1,5,1,4,0
"robersonville",1,13,5,8,0
"thermoclines",1,12,4,8,0
"pisordaerusnes",0,14,6,8,0
"sphendone",1,9,3,6,0
"unicorneal",1,10,5,5,0
"mormorando",1,10,4,6,0
"mclemaker",0,9,3,6,0
"vacherin",1,8,3,5,0
"urningism",1,9,3,6,0
"chingma",1,7,2,5,0
"mauantis",0,8,4,4,0
"schwalbea",1,9,3,6,0
"cably",0,5,1,4,0
"leatemiscroncenes",0,17,7,10,0
"millabascarp",0,12,4,8,0
"cackled",1,7,2,5,0
"quilkin",1,7,3,4,0
"drice",1,5,2,3,0
"haberduviness",0,13,5,8,0
"punched",1,7,2,5,0
"anticonuses",0,11,5,6,0
"overprosses",0,11,4,7,0
"nonprefects",0,11,3,8,0
"willowware",1,10,4,6,0
"egftui",0,6,3,3,0
"brantail",1,8,3,5,0
"ieras",0,5,3,2,0
"paeanize",0,8,5,3,0
"cardoming",0,9,3,6,0
"curllsville",1,11,3,8,0
"varechs",1,7,2,5,0
"whnoaxaasglrqa",0,14,5,9,0
"unjactiose",0,10,5,5,0
"causeuse",1,8,5,3,0
"hteruws",0,7,2,5,0
"unimpassioned",1,13,6,7,0
"unfathomableness",1,16,6,10,0
"significancy",1,12,4,8,0
"uncatch",0,7,2,5,0
"fermi",1,5,2,3,0
"shrow",0,5,1,4,0
"bonmeleeme",0,10,5,5,0
"volvent",1,7,2,5,0
"rosebud",1,7,3,4,0
"genooanetus",0,11,6,5,0
"cylindrosporium",1,15,5,10,0
"altwhmack'tdxtnvyxcmhx",0,22,2,20,1
"wirehairs",1,9,4,5,0
"icnz'cznhouhwbslgc",0,18,3,15,1
"isopales",0,8,4,4,0
"prie",1,4,2,2,0
"bolimeine",0,9,5,4,0
"wobbly",1,6,1,5,0
"chippable",1,9,3,6,0
"disquietude",1,11,6,5,0
"safribs",0,7,2,5,0
"angolans",1,8,3,5,0
"allynacenung",0,12,4,8,0
"unselecting",1,11,4,7,0
"ciciochedarilly",0,15,6,9,0
"reconny",0,7,2,5,0
"embergible",0,10,4,6,0
"nonartis",0,8,3,5,0
"marchesas",1,9,3,6,0
"xdpnlwbzxrhzqu",0,14,1,13,0
"wnnd",0,4,0,4,0
"rcykv",0,5,0,5,0
"clupeidols",0,10,4,6,0
"amylolyses",1,10,3,7,0
"weadrucorfloridi",0,16,7,9,0
"namochon",0,8,3,5,0
"'dbvfpzxxuukjpzrnmvyovtxd",0,25,3,22,1
"qujatota",0,8,4,4,0
"laroomuncocus",0,13,6,7,0
"ferromagnetist",0,14,5,9,0
"obscurer",1,8,3,5,0
"gly",0,3,0,3,0
"tachyphyly",0,10,1,9,0
"hpen",0,4,1,3,0
"pasquiler",1,9,4,5,0
"panded",0,6,2,4,0
"clacionian",0,10,5,5,0
"perfectas",1,9,3,6,0
"myroamayely",0,11,4,7,0
"stayable",1,8,3,5,0
"hyalomanial",0,11,5,6,0
"shoshoni",1,8,3,5,0
"alfalfa",1,7,3,4,0
"seqwl",1,5,1,4,0
"atricobl",0,8,3,5,0
"qprpidmzf'gf",0,12,1,11,1
"rondelet",1,8,3,5,0
"waceowans",0,9,4,5,0
"ternatisected",0,13,5,8,0
"aegospotami",1,11,6,5,0
"delandefenstroughteocryotic",0,27,10,17,0
"subducocardestrams",0,18,6,12,0
"escobadura",1,10,5,5,0
"optorincorr",0,11,4,7,0
"gub",1,3,1,2,0
"archabless",0,10,3,7,0
"professionalise",1,15,7,8,0
"unwiss",0,6,2,4,0
"izcdhqjhdfajrxmzrf",0,18,2,16,0
"thrapple",1,8,2,6,0
"unbraked",1,8,3,5,0
"periclase",1,9,4,5,0
"dacaxysti",0,9,3,6,0
"irv",1,3,1,2,0
"overdrench",1,10,3,7,0
"beetiltterieerts",0,16,7,9,0
"rematch",1,7,2,5,0
"grand",1,5,1,4,0
"uning",0,5,2,3,0
"cobnut",1,6,2,4,0
"unlightened",1,11,4,7,0
"requiter",1,8,4,4,0
"reintrenchments",0,15,4,11,0
"zoophyta",1,8,3,5,0
"torpefied",1,9,4,5,0
"pentalienne",0,11,5,6,0
"miscompute",1,10,4,6,0
"rise",1,4,2,2,0
"unscaldship",0,11,3,8,0
"chical",0,6,2,4,0
"disestablishmentarians",1,22,8,14,0
"begillagesisen",0,14,6,8,0
"amatembu",1,8,4,4,0
"devastations",1,12,5,7,0
"substantiveness",1,15,5,10,0
"nitwitter",0,9,3,6,0
"lumbaginously",0,13,5,8,0
"passinianism",0,12,5,7,0
"hphuza'",0,7,2,5,1
"gr",0,2,0,2,0
"semiabstractions",1,16,6,10,0
"unwomanise",1,10,5,5,0
"tilber",0,6,2,4,0
"vibrativism",0,11,4,7,0
"emotivities",1,11,6,5,0
"cephalocathartic",1,16,6,10,0
"hoem",1,4,2,2,0
"gnsmspwsphd",0,11,0,11,0
"supervene",1,9,4,5,0
"blokarzion",0,10,4,6,0
"lcty",0,4,0,4,0
"uvuxgjtfraybqej",0,15,4,11,0
"stethoscopy",1,11,3,8,0
"opticity",0,8,3,5,0
"imitatrix",1,9,4,5,0
"free",1,4,2,2,0
"stipa",1,5,2,3,0
"frixopres",0,9,3,6,0
"sterning",1,8,2,6,0
"chapourn",1,8,3,5,0
"ingulf",1,6,2,4,0
"photolith",0,9,3,6,0
"antimaterialistic",1,17,8,9,0
"didelphiae",0,10,5,5,0
"imposer",1,7,3,4,0
"bagouron",0,8,4,4,0
"turnbroach",1,10,3,7,0
"kresic",1,6,2,4,0
"toleupars",0,9,4,5,0
"watisilarffaldhned",0,18,6,12,0
"tasha",1,5,2,3,0
"arge",0,4,2,2,0
"lhi",0,3,1,2,0
"ginated",0,7,3,4,0
"spottiness",1,10,3,7,0
"chestily",1,8,2,6,0
"delph",1,5,1,4,0
"dagvdyojpzwvni'mnnfncmocou",0,26,6,20,1
"fycepheteeds",0,12,4,8,0
"veness",0,6,2,4,0
"redan",1,5,2,3,0
"davisboro",1,9,4,5,0
"renunciations",1,13,6,7,0
"gentlefolks",1,11,3,8,0
"nondexcadided",0,13,5,8,0
"caskelia",0,8,4,4,0
"ede",1,3,2,1,0
"arcology",1,8,3,5,0
"harpy",1,5,1,4,0
"milliphot",1,9,3,6,0
"aftertrenched",0,13,4,9,0
"sulu",1,4,2,2,0
"pericause",0,9,5,4,0
"novitiated",0,10,5,5,0
"miner",1,5,2,3,0
"alexander",1,9,4,5,0
"knccakigvusgtptcnsgeuskuawcvlq",0,30,7,23,0
"lklas",0,5,1,4,0
"wzt",0,3,0,3,0
"mislikins",0,9,3,6,0
"graylance",0,9,3,6,0
"aridity",1,7,3,4,0
"haciendados",1,11,5,6,0
"charmingly",1,10,2,8,0
"dramative",0,9,4,5,0
"cylkuphzlgacpbpeagc",0,19,4,15,0
"syrphically",0,11,2,9,0
"gessner",1,7,2,5,0
"retgopapn'mfejzzja'ohsnolyrffp",0,30,7,23,2
"allers",0,6,2,4,0
"infrastigmatal",1,14,5,9,0
"hydrogess",0,9,2,7,0
"phereclus",1,9,3,6,0
"flasayficrughthis",0,17,5,12,0
"dopestered",0,10,4,6,0
"purveyor",1,8,3,5,0
"quaregists",0,10,4,6,0
"ostrogothian",1,12,5,7,0
"specularisable",0,14,6,8,0
"overspends",1,10,3,7,0
"trilafon",1,8,3,5,0
"deli",1,4,2,2,0
"rsis",0,4,1,3,0
"unpendentiously",0,15,6,9,0
"bioavailableness",0,16,8,8,0
"mosaist",1,7,3,4,0
"star",1,4,1,3,0
"cestracion",1,10,4,6,0
"tyzycmsu'jucxmtnkn",0,18,2,16,1
"adjgizgrpnzytngmomduletx",0,24,5,19,0
"shotmarker",0,10,3,7,0
"tripitaka",1,9,4,5,0
"tzendal",1,7,2,5,0
"undiagram",0,9,4,5,0
"infoota",0,7,4,3,0
"persor",0,6,2,4,0
"handicap",1,8,3,5,0
"oecoparasitism",1,14,7,7,0
"tqrci''",0,7,1,6,2
"erections",1,9,4,5,0
"boatma",0,6,3,3,0
"ues",0,3,2,1,0
"pharmacopolet",0,13,5,8,0
"toolis",1,6,3,3,0
"aerobacterials",0,14,7,7,0
"irresolutions",1,13,6,7,0
"unzephyrlike",1,12,4,8,0
"partisera",0,9,4,5,0
"wldpnawcftmbr",0,13,1,12,0
"spevek",1,6,2,4,0
"jokmumat",0,8,3,5,0
"isodimorphous",1,13,6,7,0
"mannes",1,6,2,4,0
"deute",0,5,3,2,0
"rigate",0,6,3,3,0
"ouredenchorthridae",0,18,8,10,0
"genioglossaceous",0,16,8,8,0
"avion",1,5,3,2,0
"spectrographer",1,14,4,10,0
"austrine",1,8,4,4,0
"jowlings",0,8,2,6,0
"sampler",1,7,2,5,0
"herpotricha",0,11,4,7,0
"cthty",0,5,0,5,0
"culdoscopy",1,10,3,7,0
"bodrtafoms",0,10,3,7,0
"toxicol",1,7,3,4,0
"gloominess",1,10,4,6,0
"acuber",0,6,3,3,0
"ghtriked",0,8,2,6,0
"'qeqqzjzhdehgzamu'h",0,19,4,15,2
"turbellarian",1,12,5,7,0
"outentairistite",0,15,8,7,0
"rjyms'ncevmgtla",0,15,2,13,1
"stisirtiloonianghozabomasteckitagys",0,35,14,21,0
"spitsum",0,7,2,5,0
"typhomastmastinac",0,17,5,12,0
"maurili",1,7,4,3,0
"eurocentrum",0,11,5,6,0
"njnjzlmh'n",0,10,0,10,1
"kurtis",1,6,2,4,0
"bilise",0,6,3,3,0
"ejaculated",1,10,5,5,0
"aucatermakitiellares",0,20,10,10,0
"capitaphrasellie",0,16,7,9,0
"slopstone",1,9,3,6,0
"moines",1,6,3,3,0
"wordsworthianism",1,16,5,11,0
"whidah",1,6,2,4,0
"nwpzmawdckyznnt'kqu''foiqtrcvo",0,30,5,25,3
"buinolya",0,8,4,4,0
"quadriest",0,9,4,5,0
"stulings",0,8,2,6,0
"walthousefronts",0,15,5,10,0
"hylon",0,5,1,4,0
"amberdiettails",0,14,6,8,0
"overexcites",1,11,5,6,0
"craalanapine",0,12,6,6,0
"adzharians",1,10,4,6,0
"dermoclitise",0,12,5,7,0
"thelytonic",1,10,3,7,0
"rosome",0,6,3,3,0
"coint",0,5,2,3,0
"zedaligeratse",0,13,6,7,0
"ricki",1,5,2,3,0
"guckiest",1,8,3,5,0
"dstimm",0,6,1,5,0
"neute",0,5,3,2,0
"lehmann",1,7,2,5,0
"perean",1,6,3,3,0
"paranormalisation",0,17,8,9,0
"tocalote",1,8,4,4,0
"victorianism",1,12,5,7,0
"bamitch",0,7,2,5,0
"mommy",1,5,1,4,0
"hemileia",1,8,5,3,0
"ansmite",0,7,3,4,0
"boutormetdomiricoph",0,19,8,11,0
"parasexuality",1,13,6,7,0
"glavers",0,7,2,5,0
"flagint",0,7,2,5,0
"untranslucida",0,13,5,8,0
"entwines",1,8,3,5,0
"catgut",1,6,2,4,0
"listie",1,6,3,3,0
"ivacepidikerevingelboey",0,23,11,12,0
"hercogamous",1,11,5,6,0
"milliceudotkinneadozelogymistedratical",0,38,16,22,0
"siressness",0,10,3,7,0
"cyrogalites",0,11,4,7,0
"transvaluated",1,13,5,8,0
"ep'kkljlubpvfwrrtqakdrd",0,23,3,20,1
"bostrychoid",1,11,3,8,0
"benight",1,7,2,5,0
"pubers",0,6,2,4,0
"elision",1,7,4,3,0
"unmortgagee",0,11,5,6,0
"rappercosmer",0,12,4,8,0
"louverwork",1,10,4,6,0
"piecemakers",0,11,5,6,0
"ecrtro",0,6,2,4,0
"kolos",1,5,2,3,0
"cyclising",1,9,2,7,0
"efis",0,4,2,2,0
"ymjpgugqir'mbpzzef",0,18,3,15,1
"gynwutwwybyi",0,12,2,10,0
"itonia",1,6,4,2,0
"totylemenablens",0,15,5,10,0
"copiaded",0,8,4,4,0
"timantitiestiacoped",0,19,9,10,0
"tibiotarsus",1,11,5,6,0
"veness",0,6,2,4,0
"persianised",1,11,5,6,0
"corene",1,6,3,3,0
"cryosphericist",0,14,4,10,0
"vend",1,4,1,3,0
"herediplator",0,12,5,7,0
"honduran",1,8,3,5,0
"lallans",1,7,2,5,0
"purblindner",0,11,3,8,0
"saveloy",1,7,3,4,0
"creston",1,7,2,5,0
"convexed",1,8,3,5,0
"ret",0,3,1,2,0
"democrash",0,9,3,6,0
"hexers",1,6,2,4,0
"hyalospongia",1,12,5,7,0
"hkvgduyunfyvo",0,13,3,10,0
"hemophobias",0,11,5,6,0
"anglicanism",1,11,4,7,0
"exocoelectedly",0,14,6,8,0
"dainemian",0,9,5,4,0
"taproom",1,7,3,4,0
"cheadle",1,7,3,4,0
"kymnel",1,6,1,5,0
"oxjxoeykytatnomwsxsfofbe'jnrqo",0,30,8,22,1
"inventurousnesses",0,17,7,10,0
"klondykes",1,9,2,7,0
"kindheart",1,9,3,6,0
"pleiophyllite",0,13,5,8,0
"contracteriological",0,19,8,11,0
"laproprin",0,9,3,6,0
"licqusmend",0,10,3,7,0
"unmercifulnesses",1,16,6,10,0
"narcissing",0,10,3,7,0
"kinetoscope",1,11,5,6,0
"unrhymist",0,9,2,7,0
"paer",0,4,2,2,0
"unembraced",1,10,4,6,0
"quee",0,4,3,1,0
"jacobs",1,6,2,4,0
"verange",0,7,3,4,0
"disobligingnesses",1,17,6,11,0
"lqqht",0,5,0,5,0
"lindeberg",1,9,3,6,0
"emmys",1,5,1,4,0
"struthiform",1,11,3,8,0
"phampaings",0,10,3,7,0
"msn",1,3,0,3,0
"muckman",1,7,2,5,0
"sigsmond",1,8,2,6,0
"nibxsci",0,7,2,5,0
"squotharomatsucket",0,18,7,11,0
"hayakawa",1,8,4,4,0
"margarosanite",1,13,6,7,0
"dairymen",1,8,3,5,0
"malaptera",0,9,4,5,0
"coagulabilities",1,15,8,7,0
"exxw",0,4,1,3,0
"nonmatrimonially",1,16,6,10,0
"mathilde",1,8,3,5,0
"uromycladium",1,12,5,7,0
"hookworm",1,8,3,5,0
"stomy",0,5,1,4,0
"exertionless",1,12,5,7,0
"cuse",0,4,2,2,0
"exuvia",1,6,4,2,0
"carpophyl",1,9,2,7,0
"hillorthednes",0,13,4,9,0
"fundament",1,9,3,6,0
"viscounsellable",0,15,6,9,0
"xenode",0,6,3,3,0
"razorbillowweed",0,15,6,9,0
"ist",1,3,1,2,0
"archlets",1,8,2,6,0
"fideicommissioner",1,17,8,9,0
"counsee",0,7,4,3,0
"polers",1,6,2,4,0
"hpes",0,4,1,3,0
"diphosphoric",1,12,4,8,0
"forelliano",0,10,5,5,0
"pretreats",1,9,3,6,0
"naphlatie",0,9,4,5,0
"raspatory",1,9,3,6,0
"kxvvfizgvlowkxchjpxxrqg",0,23,2,21,0
"pillheals",0,9,3,6,0
"anglophilism",0,12,4,8,0
"mcgraw",1,6,1,5,0
"endoptimonarrozzardom",0,21,8,13,0
"predictor",1,9,3,6,0
"savagely",1,8,3,5,0
"customshouses",1,13,5,8,0
"nonnationalism",1,14,6,8,0
"rudenespintionitcra",0,19,8,11,0
"clayback",0,8,2,6,0
"thicterujaconeteve",0,18,8,10,0
"asestricarthalbukhomtrus",0,24,8,16,0
"bassoons",1,8,3,5,0
"struction",1,9,3,6,0
"shinza",1,6,2,4,0
"medlines",0,8,3,5,0
"pyrulas",0,7,2,5,0
"coigapin",0,8,4,4,0
"enhearted",0,9,4,5,0
"tuwpxnvddwwc''fbng",0,18,1,17,2
"despose",1,7,3,4,0
"jostlingspiel",0,13,4,9,0
"tatorcethiwo",0,12,5,7,0
"zephyranthes",1,12,3,9,0
"torino",1,6,3,3,0
"excity",0,6,2,4,0
"boehmenite",1,10,5,5,0
"dessepia",0,8,4,4,0
"ker",1,3,1,2,0
"curtainty",0,9,3,6,0
"unvaguely",1,9,4,5,0
"ichneumonoid",1,12,6,6,0
"mycotic",1,7,2,5,0
"transferregimenthocer",0,21,7,14,0
"hepatotoxin",1,11,5,6,0
"acric",0,5,2,3,0
"rrnmhnc",0,7,0,7,0
"oldiscism",0,9,3,6,0
"melonmonger",1,11,4,7,0
"thhnffyakunu'vdkelp'a",0,21,5,16,2
"maugressibilitiation",0,20,10,10,0
"anastasius",1,10,5,5,0
"novestrogarehothyla",0,19,7,12,0
"ecurantaltionarreadielanermarchoochan",0,37,17,20,0
"unblindie",0,9,4,5,0
"monreal",1,7,3,4,0
"anthiathia",1,10,5,5,0
"subbeen",0,7,3,4,0
"ranicateinforties",0,17,8,9,0
"hylotheistic",1,12,4,8,0
"hydrocirsocele",1,14,5,9,0
"twkc",0,4,0,4,0
"polies",1,6,3,3,0
"mispickels",1,10,3,7,0
"coprocessor",1,11,4,7,0
"''weljxlymyl",0,12,1,11,2
"decomp",0,6,2,4,0
"wibqvyqdmgjmakdpvvlmopka",0,24,4,20,0
"semid",0,5,2,3,0
"obscurative",1,11,5,6,0
"kasolite",1,8,4,4,0
"dinornithologic",0,15,6,9,0
"bloodmobile",1,11,5,6,0
"reinstitutors",0,13,5,8,0
"hiral",0,5,2,3,0
"fissidactyl",1,11,3,8,0
"opiveinalerclololed",0,19,9,10,0
"fordays",1,7,2,5,0
"ventage",1,7,3,4,0
"panjandrum",1,10,3,7,0
"synagogic",0,9,3,6,0
"colosalverbioncel",0,17,7,10,0
"unpreparing",1,11,4,7,0
"lacteal",1,7,3,4,0
"calliperer",1,10,4,6,0
"enigmatically",1,13,5,8,0
"mlismitsolistoweeversed",0,23,9,14,0
"passwords",1,9,2,7,0
"onset",1,5,2,3,0
"guaranaees",1,10,6,4,0
"rectal",1,6,2,4,0
"rosser",1,6,2,4,0
"avowe",1,5,3,2,0
"penniless",1,9,3,6,0
"unjointerrez",0,12,5,7,0
"tcvd",0,4,0,4,0
"boogeniaceae",0,12,8,4,0
"ancre",1,5,2,3,0
"sonnette",0,8,3,5,0
"tarzanishburn",0,13,4,9,0
"simplication",0,12,5,7,0
"dobela",0,6,3,3,0
"astigmoscope",1,12,5,7,0
"confesser",1,9,3,6,0
"amphigenous",1,11,5,6,0
"deportments",1,11,3,8,0
"misjudger",1,9,3,6,0
"cks",0,3,0,3,0
"tomecollikedy",0,13,5,8,0
"shaitan",1,7,3,4,0
"saicial",0,7,4,3,0
"winternations",0,13,5,8,0
"avondale",1,8,4,4,0
"reistiest",1,9,4,5,0
"bouvies",0,7,4,3,0
"russianist",1,10,4,6,0
"pofleep",0,7,3,4,0
"tipstaffs",1,9,2,7,0
"tenovecabes",0,11,5,6,0
"tetramorphism",1,13,4,9,0
"coldbloodedness",1,15,5,10,0
"kitengre",0,8,3,5,0
"kwv'berqcq'gqjozfle'oqtcz",0,25,4,21,3
"whipcordy",1,9,2,7,0
"vousins",0,7,3,4,0
"zzintitode",0,10,4,6,0
"acroprin",0,8,3,5,0
"meercato",0,8,4,4,0
"pterian",1,7,3,4,0
"undecarboardwoman",0,17,7,10,0
"homeotherapy",1,12,5,7,0
"inga",1,4,2,2,0
"landtrachaudresby",0,17,5,12,0
"hkkewatlpigx'rtuxh",0,18,4,14,1
"anythingarian",1,13,5,8,0
"north",1,5,1,4,0
"ineiraness",0,10,5,5,0
"compendick",0,10,3,7,0
"acaridize",0,9,5,4,0
"unkidnaped",1,10,4,6,0
"ranomers",1,8,3,5,0
"streetsboro",1,11,4,7,0
"melitarboophaus",0,15,7,8,0
"mesocephalon",1,12,5,7,0
"weaseling",0,9,4,5,0
"sacchuses",0,9,3,6,0
"triostasy",0,9,3,6,0
"avowal",1,6,3,3,0
"buckrams",1,8,2,6,0
"kotyttia",0,8,3,5,0
"govoe",0,5,3,2,0
"pentahedrous",1,12,5,7,0
"lamellas",1,8,3,5,0
"gigfenessalvers",0,15,5,10,0
"goaly",0,5,2,3,0
"tates",1,5,2,3,0
"corke",0,5,2,3,0
"shift",1,5,1,4,0
"unhoops",1,7,3,4,0
"befrill",1,7,2,5,0
"harlemite",1,9,4,5,0
"yeasty",1,6,2,4,0
"huesca",1,6,3,3,0
"mundungus",1,9,3,6,0
"radiotelemeter",1,14,7,7,0
"puckerel",1,8,3,5,0
"eclog",0,5,2,3,0
"eagted",0,6,3,3,0
"mullane",1,7,3,4,0
"himyaria",0,8,4,4,0
"efdnvekmbavshwermocdcgs",0,23,5,18,0
"apothes",0,7,3,4,0
"obsignedly",0,10,3,7,0
"bisyllabic",0,10,3,7,0
"windrose",1,8,3,5,0
"unforeknow",0,10,4,6,0
"magnetically",1,12,4,8,0
"mcfd",1,4,0,4,0
"whirley",1,7,2,5,0
"hopiessozo",0,10,5,5,0
"asosannaska",0,11,5,6,0
"unappableness",0,13,5,8,0
"houbara",1,7,4,3,0
"dkoeadnlvvunygkswbxwo",0,21,5,16,0
"terialytternel",0,14,5,9,0
"llojekwsuf",0,10,3,7,0
"kelebe",1,6,3,3,0
"borobusphavereed",0,16,7,9,0
"barret",1,6,2,4,0
"solgohachia",1,11,5,6,0
"variole",1,7,4,3,0
"hhbpwmco",0,8,1,7,0
"tirejectual",0,11,5,6,0
"obtruncators",0,12,4,8,0
"hemihypotonia",1,13,6,7,0
"lexis",1,5,2,3,0
"harod",1,5,2,3,0
"bathegettingprisms",0,18,5,13,0
"ottly",0,5,1,4,0
"pitings",0,7,2,5,0
"ceagstichy",0,10,3,7,0
"sekeep",0,6,3,3,0
"biennales",1,9,4,5,0
"blotless",1,8,2,6,0
"harium",0,6,3,3,0
"unsexy",1,6,2,4,0
"irous",1,5,3,2,0
"ehpmyzldsgkmvsq'bflkkdhbbow",0,27,2,25,1
"jsrbduk",0,7,1,6,0
"jhdgxbrtxy",0,10,0,10,0
"yhdnpkoj",0,8,1,7,0
"fullbodied",1,10,4,6,0
"coratin",0,7,3,4,0
"voidness",1,8,3,5,0
"nitionic",0,8,4,4,0
"chelonid",1,8,3,5,0
"fanker",0,6,2,4,0
"inessine",0,8,4,4,0
"spelunceasing",0,13,5,8,0
"appendang",0,9,3,6,0
"denhoff",1,7,2,5,0
"carrelled",0,9,3,6,0
"mvooqwwjiwgsb'",0,14,3,11,1
"onconfedership",0,14,5,9,0
"yearly",1,6,2,4,0
"jibouti",1,7,4,3,0
"cersuleckins",0,12,4,8,0
"gipsyfy",1,7,1,6,0
"qk",0,2,0,2,0
"nonmalarial",1,11,5,6,0
"chring",0,6,1,5,0
"ings",0,4,1,3,0
"unlinesque",0,10,5,5,0
"defacto",1,7,3,4,0
"qugerapeabennoanis",0,18,9,9,0
"schoolgirly",1,11,3,8,0
"lachellem",0,9,3,6,0
"gymnurine",1,9,3,6,0
"bans",0,4,1,3,0
"deposita",1,8,4,4,0
"polywag",0,7,2,5,0
"mentorship",1,10,3,7,0
"cactuslike",1,10,4,6,0
"'lxdhpwwzw",0,10,0,10,1
"haakon",1,6,3,3,0
"feeblish",1,8,3,5,0
"monogrammatic",1,13,5,8,0
"nervous",1,7,3,4,0
"preeves",1,7,3,4,0
"etwee",1,5,3,2,0
"gainsayers",1,10,4,6,0
"unenfoldnesses",0,14,5,9,0
"patronatat",0,10,4,6,0
"ualosuas",0,8,5,3,0
"cull",1,4,1,3,0
"bedrizzlingly",0,13,3,10,0
"uncultlike",0,10,4,6,0
"acrament",0,8,3,5,0
"acceptabilities",1,15,7,8,0
"cherish",1,7,2,5,0
"resulted",1,8,3,5,0
"proid",0,5,2,3,0
"rhab",0,4,1,3,0
"'mtdfh",0,6,0,6,1
"soundtrack",1,10,3,7,0
"chlorimetric",1,12,4,8,0
"polid",0,5,2,3,0
"counklystomility",0,16,5,11,0
"'zydkwzpvkszlvccaxoylst",0,23,2,21,1
"spintexts",1,9,2,7,0
"octarch",1,7,2,5,0
"bosefe",0,6,3,3,0
"poplarville",1,11,4,7,0
"dithedulolelsiniomaqualy",0,24,11,13,0
"proxenjugwes",0,12,4,8,0
"roland",1,6,2,4,0
"cagasviounniperptahatinilungloxis",0,33,14,19,0
"neuropathidae",0,13,7,6,0
"macradenous",1,11,5,6,0
"inaccessibly",1,12,4,8,0
"underspecified",1,14,6,8,0
"amandibulare",0,12,6,6,0
"unilluminatum",0,13,6,7,0
"contentations",1,13,5,8,0
"unmechanisational",0,17,8,9,0
"procuration",1,11,5,6,0
"unaltec",0,7,3,4,0
"thedric",1,7,2,5,0
"aburst",1,6,2,4,0
"therly",0,6,1,5,0
"adunistinhagelous",0,17,8,9,0
"appointing",1,10,4,6,0
"hauling",1,7,3,4,0
"eyeopener",1,9,5,4,0
"jxgxffrhqrquhjtwehxd'",0,21,2,19,1
"exchansitis",0,11,4,7,0
"braquet",0,7,3,4,0
"numerousness",1,12,5,7,0
"harmonides",1,10,4,6,0
"velicate",1,8,4,4,0
"vmr",1,3,0,3,0
"gatekeeper",1,10,5,5,0
"qzvfrexlwwsdsmkcd'p",0,19,1,18,1
"unsheathering",0,13,5,8,0
"unswam",0,6,2,4,0
"outbending",1,10,4,6,0
"hagiophyre",0,10,4,6,0
"pissheathies",0,12,5,7,0
"seatwork",1,8,3,5,0
"traditionalist",1,14,6,8,0
"baisefully",0,10,4,6,0
"glynis",1,6,1,5,0
"repurposivism",0,13,5,8,0
"lazarette",1,9,4,5,0
"cantrile",0,8,3,5,0
"fis",0,3,1,2,0
"pedicula",0,8,4,4,0
"archmugwump",1,11,3,8,0
"jzvw'rxzquyff'xdlzwc'",0,21,1,20,3
"mayanist",1,8,3,5,0
"hurtful",0,7,2,5,0
"ugaritic",1,8,4,4,0
"tection",0,7,3,4,0
"xanthes",0,7,2,5,0
"bnzh",0,4,0,4,0
"fishhooks",1,9,3,6,0
"aserterocong",0,12,5,7,0
"tenfutwsbi",0,10,3,7,0
"certainest",1,10,4,6,0
"reptomented",0,11,4,7,0
"burghmoot",1,9,3,6,0
"puirtith",1,8,3,5,0
"telejournalist",1,14,6,8,0
"anglomania",1,10,5,5,0
"mattedly",1,8,2,6,0
"dissecting",1,10,3,7,0
"wauks",1,5,2,3,0
"glycerol",1,8,2,6,0
"thextojkzfvfnikowigizicrmh'kog",0,30,8,22,1
"thantox",0,7,2,5,0
"owidrfsianite",0,13,6,7,0
"yiuhkucgqbeoqbh",0,15,5,10,0
"collacty",0,8,2,6,0
"antidictions",0,12,5,7,0
"lacustral",1,9,3,6,0
"semipash",0,8,3,5,0
"shemu",1,5,2,3,0
"prodrugs",1,8,2,6,0
"tricyclic",1,9,2,7,0
"deboner",1,7,3,4,0
"cambridgeshire",1,14,5,9,0
"exorgassing",0,11,4,7,0
"warmonogenfrandron",0,18,6,12,0
"overstorm",0,9,3,6,0
"kotzebue",1,8,4,4,0
"hooray",1,6,3,3,0
"homies",1,6,3,3,0
"tamented",0,8,3,5,0
"ddnjom'mvxi'",0,12,2,10,2
"underbevelling",0,14,5,9,0
"evando",0,6,3,3,0
"phborivanovirc",0,14,5,9,0
"unred",1,5,2,3,0
"dikar",0,5,2,3,0
"prowess",1,7,2,5,0
"busters",1,7,2,5,0
"ballou",1,6,3,3,0
"crumblies",1,9,3,6,0
"xray",1,4,1,3,0
"tubalcain",1,9,4,5,0
"luccal",0,6,2,4,0
"kerbside",1,8,3,5,0
"gobispospona",0,12,5,7,0
"frisinters",0,10,3,7,0
"clorine",0,7,3,4,0
"privatdozent",1,12,4,8,0
"flitter",1,7,2,5,0
"parcellus",0,9,3,6,0
"msotrin",0,7,2,5,0
"promissvry",1,10,2,8,0
"siliacquinest",0,13,6,7,0
"bbovis",0,6,2,4,0
"cufficationards",0,15,6,9,0
"ne",0,2,1,1,0
"cyanin",1,6,2,4,0
"gloeosporium",1,12,6,6,0
"nonexpugnescence",0,16,6,10,0
"nondisposed",1,11,4,7,0
"errakow",0,7,3,4,0
"stroppy",1,7,1,6,0
"helotism",1,8,3,5,0
"clatineakyl",0,11,4,7,0
"dh'hbkeqcsufbqeo",0,16,4,12,1
"prelogic",1,8,3,5,0
"bugbee",1,6,3,3,0
"vcybdygwlxwc",0,12,0,12,0
"thacker",1,7,2,5,0
"pironomucogrmitleerphkins",0,25,9,16,0
"lyohrhs",0,7,1,6,0
"gappering",0,9,3,6,0
"cerpugalladeions",0,16,7,9,0
"gavateris",0,9,4,5,0
"oards",0,5,2,3,0
"extraclassable",0,14,5,9,0
"indishman",0,9,3,6,0
"unquestion",0,10,5,5,0
"synchysis",1,9,1,8,0
"amerveil",1,8,4,4,0
"thepw'agqbm'gbsqtjfwif",0,22,3,19,2
"prgbbdhfazftauop'",0,17,4,13,1
"duits",1,5,2,3,0
"eviteraphagnon",0,14,6,8,0
"homoblastic",1,11,4,7,0
"landfolk",1,8,2,6,0
"bestubbornness",0,14,4,10,0
"curser",1,6,2,4,0
"roulebraistic",0,13,6,7,0
"bolshevisms",1,11,3,8,0
"olnizvkorho",0,11,4,7,0
"rwfeverhindwscxhpfxix",0,21,4,17,0
"aquemiaced",0,10,6,4,0
"diactin",1,7,3,4,0
"preventionable",0,14,6,8,0
"circumjovial",1,12,5,7,0
"redivides",1,9,4,5,0
"swingletrees",1,12,4,8,0
"misdealing",1,10,4,6,0
"darklier",1,8,3,5,0
"avgazillaenadverlestate",0,23,10,13,0
"cptdapnmejp",0,11,2,9,0
"bimillennial",1,12,5,7,0
"gobiesox",1,8,4,4,0
"anise",1,5,3,2,0
"bvisp",0,5,1,4,0
"detestation",1,11,5,6,0
"shophalottes",0,12,4,8,0
"damia",1,5,3,2,0
"hrfdig",0,6,1,5,0
"colatoring",0,10,4,6,0
"dapocaomiaphryicutinoiadone",0,27,14,13,0
"pelermstamenfiverinrandecscerel",0,31,11,20,0
"roarer",1,6,3,3,0
"perkinson",0,9,3,6,0
"ratiocinative",1,13,7,6,0
"exscutellate",1,12,5,7,0
"vavykpnpwctfcw",0,14,1,13,0
"empleaches",1,10,4,6,0
"illworks",0,8,2,6,0
"uskdar",1,6,2,4,0
"lostangles",0,10,3,7,0
"rediversion",1,11,5,6,0
"wfuzxubmtviisi'uaxhcgniofcqva",0,29,10,19,1
"sensigenous",1,11,5,6,0
"photohistance",0,13,5,8,0
"v'clhcnaeagsajkzrduqc",0,21,5,16,1
"shallowpate",1,11,4,7,0
"sovereignize",1,12,6,6,0
"polygraphed",1,11,3,8,0
"gilud",1,5,2,3,0
"yhflcedwvyminsvpcdcwculv",0,24,3,21,0
"superduper",1,10,4,6,0
"tawnya",1,6,2,4,0
"bluestone",1,9,4,5,0
"indentures",1,10,4,6,0
"laryssa",1,7,2,5,0
"miswrought",1,10,3,7,0
"i'mmtmrqrbxixcbk",0,16,2,14,1
"phal",0,4,1,3,0
"kreinne",0,7,3,4,0
"chumship",1,8,2,6,0
"eucyl",0,5,2,3,0
"oniby",0,5,2,3,0
"bolsterwork",1,11,3,8,0
"overdependent",1,13,5,8,0
"hyperaccurately",1,15,5,10,0
"bosbzhzzktawnpqpesa",0,19,4,15,0
"xericised",0,9,4,5,0
"domestication",1,13,6,7,0
"tjywilnacltqbaldbzwxtmopx",0,25,4,21,0
"zinged",1,6,2,4,0
"meacomvarouneraralperitst",0,25,11,14,0
"wnqpitbdwhy",0,11,1,10,0
"chomsky",1,7,1,6,0
"patd",1,4,1,3,0
"intercommunicably",0,17,6,11,0
"grinner",1,7,2,5,0
"contesiegin",0,11,5,6,0
"quaesitum",1,9,5,4,0
"corridor",1,8,3,5,0
"action",1,6,3,3,0
"gomeral",1,7,3,4,0
"bometriornsicoghereluide",0,24,11,13,0
"raphiang",0,8,3,5,0
"zoosporangiophore",1,17,8,9,0
"bandalousness",0,13,5,8,0
"catamaran",1,9,4,5,0
"randentart",0,10,3,7,0
"wichoops",0,8,3,5,0
"recessionary",1,12,5,7,0
"redeless",1,8,3,5,0
"pinterestable",0,13,5,8,0
"deco",1,4,2,2,0
"harian",0,6,3,3,0
"gnarled",1,7,2,5,0
"canaried",1,8,4,4,0
"platycercus",1,11,3,8,0
"lapopettropamiaplila",0,20,9,11,0
"ehlnoi",0,6,3,3,0
"prooflessly",1,11,3,8,0
"pflugerville",1,12,4,8,0
"corruging",0,9,3,6,0
"dionysia",1,8,4,4,0
"petary",1,6,2,4,0
"milksoppishness",1,15,4,11,0
"mzqjazwajwis'ofs",0,16,4,12,1
"pareses",1,7,3,4,0
"pondas",0,6,2,4,0
"atkin",0,5,2,3,0
"cohepshipply",0,12,3,9,0
"ovillus",1,7,3,4,0
"blowdown",1,8,2,6,0
"limewatered",0,11,5,6,0
"olefin",1,6,3,3,0
"limbryngeliableness",0,19,6,13,0
"budgeted",1,8,3,5,0
"feinterpassiope",0,15,7,8,0
"octoate",1,7,4,3,0
"stromboli",1,9,3,6,0
"sassanian",1,9,4,5,0
"collists",0,8,2,6,0
"wfrlymueremgylcocmcqafuuvluprc",0,30,8,22,0
"faizabad",1,8,4,4,0
"seir",1,4,2,2,0
"manian",0,6,3,3,0
"bharkowntron",0,12,3,9,0
"adamsville",1,10,4,6,0
"prosynthesial",0,13,4,9,0
"livelines",0,9,4,5,0
"dwarfy",1,6,1,5,0
"cantonisations",1,14,6,8,0
"ter",0,3,1,2,0
"vaponder",0,8,3,5,0
"lus",0,3,1,2,0
"storminesses",1,12,4,8,0
"submarket",1,9,3,6,0
"reworashess",0,11,4,7,0
"schizognathism",1,14,4,10,0
"subclavicle",0,11,4,7,0
"poranteron",0,10,4,6,0
"dilatantnessembriform",0,21,7,14,0
"dps",1,3,0,3,0
"eucopepoda",1,10,6,4,0
"jxfdutlmspnjx",0,13,1,12,0
"deified",1,7,4,3,0
"riflery",1,7,2,5,0
"snacking",1,8,2,6,0
"snuff",1,5,1,4,0
"pointillist",1,11,4,7,0
"sinaupinuatiniagai",0,18,11,7,0
"arteritist",0,10,4,6,0
"proirrigations",0,14,6,8,0
"nudum",1,5,2,3,0
"zpojzlzmrry",0,11,1,10,0
"iwl'bhrquvskncipt",0,17,3,14,1
"plastidular",1,11,4,7,0
"eutaxy",1,6,3,3,0
"stylers",1,7,1,6,0
"stroddles",1,9,2,7,0
"muslin",1,6,2,4,0
"hordarian",1,9,4,5,0
"bioblastic",1,10,4,6,0
"coeliotomy",1,10,5,5,0
"novelheads",0,10,4,6,0
"nobilitated",1,11,5,6,0
"counterprove",1,12,5,7,0
"nums",0,4,1,3,0
"puddles",1,7,2,5,0
"gklh",0,4,0,4,0
"colyer",1,6,2,4,0
"perovsk",0,7,2,5,0
"hast",0,4,1,3,0
"tessidifitrisesdelted",0,21,8,13,0
"georgettes",1,10,4,6,0
"sparsioplast",1,12,4,8,0
"waveless",1,8,3,5,0
"recondisobar",0,12,5,7,0
"satteringum",0,11,4,7,0
"zjpkdvcnypbupmwwvy",0,18,1,17,0
"needles",1,7,3,4,0
"incantando",0,10,4,6,0
"porayxuledenclurchasere",0,23,9,14,0
"unperilously",1,12,5,7,0
"nekrasov",1,8,3,5,0
"neverthelater",1,13,5,8,0
"codirectionisms",0,15,6,9,0
"ketuvim",1,7,3,4,0
"imbricellar",0,11,4,7,0
"kraaitl'lqv'bhmmu",0,17,4,13,2
"coreeritipid",0,12,6,6,0
"narratory",1,9,3,6,0
"nontaxation",0,11,5,6,0
"surveyings",1,10,3,7,0
"bostwickelium",0,13,5,8,0
"hubshi",1,6,2,4,0
"scon",0,4,1,3,0
"immunohedron",0,12,5,7,0
"cosine",1,6,3,3,0
"fyvktltmklrvfjkdfuv",0,19,1,18,0
"rowdily",1,7,2,5,0
"implantersville",0,15,5,10,0
"odintonqusahave",0,15,7,8,0
"antonymous",1,10,4,6,0
"trancelebrats",0,13,4,9,0
"dehuths",0,7,2,5,0
"ssus",0,4,1,3,0
"postmoderance",0,13,5,8,0
"waresboro",1,9,4,5,0
"halalling",1,9,3,6,0
"landahl",1,7,2,5,0
"imed",0,4,2,2,0
"calaba",1,6,3,3,0
"skomeshyhhivevenextaghoounce",0,28,11,17,0
"superfluousness",1,15,6,9,0
"deraconclentris",0,15,5,10,0
"rheumatologist",1,14,6,8,0
"cyromorphioalism",0,16,6,10,0
"bghjw",0,5,0,5,0
"saintliterances",0,15,6,9,0
"cataclasticisms",0,15,5,10,0
"unjoinable",1,10,5,5,0
"anvinaroblelunee",0,16,8,8,0
"cruzannexisternal",0,17,6,11,0
"weldin",0,6,2,4,0
"colonette",1,9,4,5,0
"bthu'jceziobl",0,13,4,9,1
"coffelain",0,9,4,5,0
"quarterdeckers",1,14,5,9,0
"peddlery",1,8,2,6,0
"bacteroi",0,8,4,4,0
"bouet",1,5,3,2,0
"entificality",0,12,5,7,0
"mendequiong",0,11,5,6,0
"gutsizes",0,8,3,5,0
"xpzs'lmee",0,9,2,7,1
"leveridge",1,9,4,5,0
"chukcheeshed",0,12,4,8,0
"androscopehood",0,14,6,8,0
"lubec",1,5,2,3,0
"autonomy",1,8,4,4,0
"fimbaean",0,8,4,4,0
"interling",0,9,3,6,0
"soruscicular",0,12,5,7,0
"roberval",1,8,3,5,0
"phyte",0,5,1,4,0
"redevelopers",1,12,5,7,0
"beggardom",1,9,3,6,0
"veringbonessent",0,15,5,10,0
"poorlier",1,8,4,4,0
"ematint",0,7,3,4,0
"saunt",0,5,2,3,0
"mongeau",1,7,4,3,0
"rxd",0,3,0,3,0
"twintosis",0,9,3,6,0
"reenlisted",1,10,4,6,0
"reparradless",0,12,4,8,0
"hugeousnesses",1,13,6,7,0
"ully",0,4,1,3,0
"refractors",1,10,3,7,0
"unrichartoolite",0,15,7,8,0
"parisianisation",1,15,8,7,0
"shortney",0,8,2,6,0
"jpmpxsctngjnsfvui",0,17,2,15,0
"sciatherically",1,14,5,9,0
"buenave",0,7,4,3,0
"ctrtichepurden",0,14,4,10,0
"flirting",1,8,2,6,0
"forthoscopic",0,12,4,8,0
"unwaggably",1,10,3,7,0
"resourcefulness",1,15,6,9,0
"sopapillas",1,10,4,6,0
"jaments",0,7,2,5,0
"replacement",1,11,4,7,0
"repletenesses",1,13,5,8,0
"nonsuppressively",1,16,5,11,0
"secondees",1,9,4,5,0
"d'oynczhhzavmr",0,14,2,12,1
"unmomentously",1,13,5,8,0
"packed",1,6,2,4,0
"obsessiveness",1,13,5,8,0
"perfectural",0,11,4,7,0
"anisol",1,6,3,3,0
"narwhales",1,9,3,6,0
"immissions",1,10,4,6,0
"curassow",1,8,3,5,0
"gyps",1,4,0,4,0
"aceous",0,6,4,2,0
"presuffer",1,9,3,6,0
"paitricy",0,8,3,5,0
"unmenontiftillerrehemetessed",0,28,11,17,0
"unsundivistorinax",0,17,7,10,0
"garciasville",1,12,5,7,0
"smockingbird",0,12,3,9,0
"topcoaster",0,10,4,6,0
"quillon",1,7,3,4,0
"evif'eppyue'awhuuzhhzo",0,22,9,13,2
"devonic",1,7,3,4,0
"ryswick",1,7,1,6,0
"multis",0,6,2,4,0
"alehoof",1,7,4,3,0
"shlytes",0,7,1,6,0
"geriveysvilysuddess",0,19,6,13,0
"appendicalgia",1,13,6,7,0
"alleycats",1,9,3,6,0
"winkinvol",0,9,3,6,0
"interlockianism",0,15,6,9,0
"angelodynas",0,11,4,7,0
"wsqunterenosho",0,14,5,9,0
"tintoapecrinos",0,14,6,8,0
"amniomancy",1,10,4,6,0
"sprinchoke",0,10,3,7,0
"iytqzpuk'ct'czkyyqkcdzscvvh",0,27,2,25,2
"deflexicosborthic",0,17,6,11,0
"achloxeness",0,11,4,7,0
"joutaphyrgazoiseurizinglutiotistenna",0,36,16,20,0
"exar",0,4,2,2,0
"volplanines",0,11,4,7,0
"protectivisection",0,17,7,10,0
"irreparatory",0,12,5,7,0
"condor",1,6,2,4,0
"myelinisations",1,14,6,8,0
"kshiodivid",0,10,4,6,0
"splenanage",0,10,4,6,0
"citynesses",1,10,3,7,0
"carruthers",1,10,3,7,0
"phalans",0,7,2,5,0
"kucmewjqu'vnjrbu",0,16,4,12,1
"factoidal",1,9,4,5,0
"consultantships",1,15,4,11,0
"polder",1,6,2,4,0
"bolosieriekinan",0,15,8,7,0
"medressing",0,10,3,7,0
"attainabilities",1,15,8,7,0
"hydrobilirubin",1,14,5,9,0
"speakings",1,9,3,6,0
"minist",0,6,2,4,0
"rhousia",0,7,4,3,0
"hebrists",0,8,2,6,0
"odal",1,4,2,2,0
"icakenpacin",0,11,5,6,0
"stencies",0,8,3,5,0
"psychosymptuosaurinyles",0,23,7,16,0
"aylin",0,5,2,3,0
"reascension",1,11,5,6,0
"monobtu",0,7,3,4,0
"seleucidean",1,11,6,5,0
"witza",0,5,2,3,0
"cruzados",1,8,3,5,0
"mxmnyadfowwe'hx",0,15,3,12,1
"vgcgvllxj",0,9,0,9,0
"ixb'xvqxhior",0,12,3,9,1
"melinis",1,7,3,4,0
"canmaker",1,8,3,5,0
"nitromethanes",1,13,5,8,0
"kincobs",1,7,2,5,0
"rackles",0,7,2,5,0
"yelm'zcyfdx",0,11,1,10,1
"multiprotodecomparedness",0,24,9,15,0
"genticlimbiners",0,15,5,10,0
"moraceous",1,9,5,4,0
"veromous",0,8,4,4,0
"antecell",1,8,3,5,0
"picted",0,6,2,4,0
"b'toj",0,5,1,4,1
"phe",0,3,1,2,0
"cheesemaking",1,12,5,7,0
"extraordinaire",1,14,7,7,0
"acoadvolari",0,11,6,5,0
"antidomestic",1,12,5,7,0
"jarrell",1,7,2,5,0
"trisyllabical",1,13,4,9,0
"transnationality",0,16,6,10,0
"begicoperopplateri",0,18,8,10,0
"laparocolpohysterophytes",0,24,8,16,0
"noncompulsion",0,13,5,8,0
"predriving",1,10,3,7,0
"ifmud'jjikfv",0,12,3,9,1
"photogenic",1,10,4,6,0
"snowdonia",1,9,4,5,0
"electrodialitic",1,15,7,8,0
"hynnukagnifor",0,13,4,9,0
"moltiostin",0,10,4,6,0
"eucatropine",1,11,6,5,0
"alits",0,5,2,3,0
"autoprothesis",1,13,6,7,0
"nelleumed",0,9,4,5,0
"dixies",1,6,3,3,0
"pandra",0,6,2,4,0
"ianswast",0,8,3,5,0
"nelson",1,6,2,4,0
"live",1,4,2,2,0
"broupbqlduthcr",0,14,3,11,0
"hujsak",1,6,2,4,0
"guacho",1,6,3,3,0
"lectate",0,7,3,4,0
"guidonian",1,9,5,4,0
"hawkey",1,6,2,4,0
"lidatict",0,8,3,5,0
"mszjpidqswnxsc",0,14,1,13,0
"grouteco",0,8,4,4,0
"lavalike",1,8,4,4,0
"viscovities",0,11,5,6,0
"mearstone",1,9,4,5,0
"yorkers",1,7,2,5,0
"scroungings",1,11,3,8,0
"nematocera",1,10,5,5,0
"gutierrez",1,9,4,5,0
"huska",0,5,2,3,0
"stumpline",0,9,3,6,0
"ziszf",0,5,1,4,0
"myeloplax",1,9,3,6,0
"eforphypocethagharmamitistriatoman",0,34,13,21,0
"leukoses",1,8,4,4,0
"caboclo",1,7,3,4,0
"ka",1,2,1,1,0
"asida",0,5,3,2,0
"skimobile",1,9,4,5,0
"utaenieyravionogys",0,18,9,9,0
"saponaceousness",1,15,7,8,0
"euryphage",1,9,4,5,0
"plans",1,5,1,4,0
"malgonomies",0,11,5,6,0
"greastwort",0,10,3,7,0
"deliverabilities",1,16,8,8,0
"blizz",1,5,1,4,0
"fib",1,3,1,2,0
"tarrhogically",0,13,4,9,0
"ffelstthy",0,9,1,8,0
"smelterman",1,10,3,7,0
"urentiaticatin",0,14,7,7,0
"postrace",1,8,3,5,0
"fortunes",1,8,3,5,0
"egomilium",0,9,5,4,0
"lipunialy",0,9,4,5,0
"cladophylls",1,11,2,9,0
"salimetric",1,10,4,6,0
"schanse",1,7,2,5,0
"spireoro",0,8,4,4,0
"lous",0,4,2,2,0
"lampus",0,6,2,4,0
"antiparagraphed",0,15,6,9,0
"hindoo",1,6,3,3,0
"eyeshadow",1,9,4,5,0
"theicia",0,7,4,3,0
"prosh",0,5,1,4,0
"coffed",1,6,2,4,0
"superfunctional",1,15,6,9,0
"dvssjjlnpmhnzdkee'jz",0,20,2,18,1
"martingly",0,9,2,7,0
"chickerer",0,9,3,6,0
"unornamentally",1,14,5,9,0
"quleussms",0,9,3,6,0
"indyer",0,6,2,4,0
"interrog",1,8,3,5,0
"embarrate",0,9,4,5,0
"antipsychonomic",0,15,5,10,0
"qophs",1,5,1,4,0
"vgildishorkibriencorber",0,23,8,15,0
"lidie",1,5,3,2,0
"taungthu",1,8,3,5,0
"commier",0,7,3,4,0
"helvellic",1,9,3,6,0
"hotomushchings",0,14,4,10,0
"sloka",0,5,2,3,0
"co'eqllbfgmtv'oyhhhhpxyi",0,24,4,20,2
"arthria",0,7,3,4,0
"iur",0,3,2,1,0
"lugube",0,6,3,3,0
"infalled",0,8,3,5,0
"sceatt",1,6,2,4,0
"oira",1,4,3,1,0
"htrshzwjvpweblmmxuwqcv",0,22,2,20,0
"paitrick",1,8,3,5,0
"corniplier",0,10,4,6,0
"princelike",1,10,4,6,0
"latea",1,5,3,2,0
"anging",0,6,2,4,0
"monotoned",1,9,4,5,0
"hiadmspenidiemquenphis",0,22,9,13,0
"calliopsis",1,10,4,6,0
"rosion",0,6,3,3,0
"hickmankingness",0,15,4,11,0
"missonerrate",0,12,5,7,0
"hypsister",0,9,2,7,0
"paregoric",1,9,4,5,0
"loon",0,4,2,2,0
"isidore",1,7,4,3,0
"skyjacked",1,9,2,7,0
"cys",0,3,0,3,0
"ferriage",1,8,4,4,0
"uchee",1,5,3,2,0
"cnacterefordmins",0,16,5,11,0
"povertagerackitale",0,18,8,10,0
"sandpapers",1,10,3,7,0
"undershapen",1,11,4,7,0
"thermanist",0,10,3,7,0
"advisorily",1,10,4,6,0
"undersetting",1,12,4,8,0
"chondrofetal",1,12,4,8,0
"wondeladue",0,10,5,5,0
"superphysicalness",1,17,5,12,0
"nonradiographic",0,15,6,9,0
"superadaptation",0,15,7,8,0
"riveliphing",0,11,4,7,0
"diapecalytenalorito",0,19,9,10,0
"onwa",0,4,2,2,0
"tomoleonwovily",0,14,6,8,0
"bifughthalcote",0,14,5,9,0
"bergh",1,5,1,4,0
"myoclonal",0,9,3,6,0
"pwxhlabwtkbkbjbkpqdf",0,20,1,19,0
"snoopers",1,8,3,5,0
"toeshoe",1,7,4,3,0
"spinnakers",1,10,3,7,0
"overlubricating",1,15,6,9,0
"cadomaerqus",0,11,5,6,0
"galogis",0,7,3,4,0
"naturalize",0,10,5,5,0
"trichel",0,7,2,5,0
"zingiberaceae",1,13,7,6,0
"multimes",0,8,3,5,0
"wickup",1,6,2,4,0
"tarsalia",1,8,4,4,0
"dewpoints",1,9,3,6,0
"brooncer",0,8,3,5,0
"azygobranchiata",1,15,6,9,0
"emous",0,5,3,2,0
"monotus",0,7,3,4,0
"adducible",1,9,4,5,0
"hypothetising",1,13,4,9,0
"adoniad",1,7,4,3,0
"naive",1,5,3,2,0
"yojuana",0,7,4,3,0
"northupite",1,10,4,6,0
"assail",0,6,3,3,0
"yxdxjqxljnlrbtonrdbfko",0,22,2,20,0
"effervescing",1,12,4,8,0
"asce",0,4,2,2,0
"ericolin",1,8,4,4,0
"opposingly",1,10,3,7,0
"karyosoma",1,9,4,5,0
"tao",1,3,2,1,0
"postincarnation",1,15,6,9,0
"w''lvzsjupulwjlmkf",0,18,2,16,2
"pitahayas",1,9,4,5,0
"forfeitable",1,11,5,6,0
"inhort",0,6,2,4,0
"barnhard",1,8,2,6,0
"istalsocronsisnaressm",0,21,7,14,0
"blackington",1,11,3,8,0
"cambrian",1,8,3,5,0
"kaigrtlzgsjlwelmpeazujghavox",0,28,8,20,0
"nuldettuconstenscuny",0,20,6,14,0
"alminitrollo",0,12,5,7,0
"deattributed",1,12,5,7,0
"labiovelarises",0,14,7,7,0
"hopkinsonite",0,12,5,7,0
"prodramatic",1,11,4,7,0
"bejkzeuzklro",0,12,4,8,0
"phalaeostratus",0,14,6,8,0
"ujljzbimhvzahiupudbxcajmow",0,26,8,18,0
"epigynum",1,8,3,5,0
"tentings",1,8,2,6,0
"davir",0,5,2,3,0
"castanian",1,9,4,5,0
"voltina",0,7,3,4,0
"mudtrack",1,8,2,6,0
"tlzev",0,5,1,4,0
"tarmacolous",0,11,5,6,0
"onomatopoieses",1,14,8,6,0
"wifeship",1,8,3,5,0
"eurymede",1,8,4,4,0
"precommit",1,9,3,6,0
"ilen",0,4,2,2,0
"nonliquefiability",0,17,8,9,0
"multifactorial",1,14,6,8,0
"molinary",1,8,3,5,0
"nerolyphornne",0,13,4,9,0
"inturbidated",1,12,5,7,0
"demotivism",0,10,4,6,0
"galeerineous",0,12,7,5,0
"superadministrator",1,18,7,11,0
"conting",0,7,2,5,0
"rajshahi",1,8,3,5,0
"acenaphthylaminoethylimnetical",0,30,11,19,0
"teler",0,5,2,3,0
"planispherical",1,14,5,9,0
"autopilot",1,9,5,4,0
"obloquina",0,9,5,4,0
"potamophilous",1,13,6,7,0
"haidendesnjuleslicisicatal",0,26,11,15,0
"hophinocapabhons",0,16,6,10,0
"macanture",0,9,4,5,0
"dessication",1,11,5,6,0
"abonnement",1,10,4,6,0
"xcaxrgtjfixyx",0,13,2,11,0
"candolle",1,8,3,5,0
"panhedgins",0,10,3,7,0
"mistouche",0,9,4,5,0
"cumberland",1,10,3,7,0
"staginally",0,10,3,7,0
"misaddrest",1,10,3,7,0
"archarnecontive",0,15,6,9,0
"anterofixation",1,14,7,7,0
"capernoite",0,10,5,5,0
"moodys",1,6,2,4,0
"operagoings",1,11,5,6,0
"devonite",1,8,4,4,0
"shin",0,4,1,3,0
"coas",0,4,2,2,0
"sappiest",1,8,3,5,0
"baryngolity",0,11,3,8,0
"lamellibranchiata",1,17,7,10,0
"nifedipine",1,10,5,5,0
"macraucheniidae",1,15,8,7,0
"glassine",1,8,3,5,0
"photos",0,6,2,4,0
"secroimmelies",0,13,6,7,0
"cyanogenic",1,10,4,6,0
"piezometer",1,10,5,5,0
"awjmkljtfodbsvwplklha'fsc",0,25,3,22,1
"untimentally",0,12,4,8,0
"zkn'lmyshcxxyntaa",0,17,2,15,1
"bement",1,6,2,4,0
"paaraphimosis",1,13,6,7,0
"slaught",0,7,2,5,0
"deithounbebflarigly",0,19,7,12,0
"fenite",1,6,3,3,0
"atest",0,5,2,3,0
"vandie",0,6,3,3,0
"prople",0,6,2,4,0
"qlqtjvlhtjasfjwbd'wcj",0,21,1,20,1
"occupancies",1,11,5,6,0
"viander",1,7,3,4,0
"vibrayheadla",0,12,5,7,0
"notic",0,5,2,3,0
"garryover",0,9,3,6,0
"brodecons",0,9,3,6,0
"crouches",1,8,3,5,0
"scucuadronous",0,13,6,7,0
"omphalic",1,8,3,5,0
"essnaftiones",0,12,5,7,0
"anona",1,5,3,2,0
"ncet",0,4,1,3,0
"keeperships",1,11,4,7,0
"homoean",1,7,4,3,0
"leaching",1,8,3,5,0
"carnotto",0,8,3,5,0
"grabiant",0,8,3,5,0
"sser",0,4,1,3,0
"madigan",1,7,3,4,0
"unsnugness",1,10,3,7,0
"ungitatnes",0,10,4,6,0
"lolium",1,6,3,3,0
"krn'moxk",0,8,1,7,1
"steloonwite",0,11,5,6,0
"maya",1,4,2,2,0
"staining",1,8,3,5,0
"cordialness",1,11,4,7,0
"malvin",1,6,2,4,0
"aquellatopogoned",0,16,8,8,0
"epiky",1,5,2,3,0
"jssecrhxkpneljfaadjlqyphryaur",0,29,6,23,0
"strophyld",0,9,1,8,0
"dau",1,3,2,1,0
"feringowle",0,10,4,6,0
"berms",1,5,1,4,0
"corporativist",1,13,5,8,0
"tracontisms",0,11,3,8,0
"acadoer",0,7,4,3,0
"ufarantion",0,10,5,5,0
"nebrous",0,7,3,4,0
"oui",1,3,3,0,0
"postform",1,8,2,6,0
"semindemusioness",0,16,7,9,0
"autolatries",1,11,6,5,0
"proabolite",0,10,5,5,0
"innatian",0,8,4,4,0
"exceptor",1,8,3,5,0
"amphibology",1,11,4,7,0
"bgrxndqxfxbimpdw'vuulhdmjbs",0,27,3,24,1
"polychrestical",1,14,4,10,0
"hydrosulphide",1,13,4,9,0
"onbfzgxbjpoxv",0,13,2,11,0
"salvationist",1,12,5,7,0
"doritarianissimos",0,17,8,9,0
"tmdrqwjupienltbxcqw",0,19,3,16,0
"sevhrgcqqsmakhqzkstebstr",0,24,3,21,0
"crockford",1,9,2,7,0
"'d",0,2,0,2,1
"munroe",1,6,3,3,0
"muscaring",0,9,3,6,0
"sinfighte",0,9,3,6,0
"chromicise",1,10,4,6,0
"infeoffs",1,8,3,5,0
"ovorhomboidal",1,13,6,7,0
"vivistylest",0,11,3,8,0
"insvilla",0,8,3,5,0
"corrodible",1,10,4,6,0
"gastroenterology",1,16,6,10,0
"allan",1,5,2,3,0
"lulie",1,5,3,2,0
"lytton",1,6,1,5,0
"vimiiu",0,6,4,2,0
"atelognathia",1,12,6,6,0
"fring",0,5,1,4,0
"citrulline",1,10,4,6,0
"reconciliator",1,13,6,7,0
"gracular",0,8,3,5,0
"lzxoocduxqzzefz'",0,16,4,12,1
"ssaromivalesecovinyad",0,21,9,12,0
"admerveils",0,10,4,6,0
"ygwvokrgntkffaxzgekrqf",0,22,3,19,0
"sordellina",1,10,4,6,0
"bacelesuliltrzatansketthonede",0,29,11,18,0
"mpis",0,4,1,3,0
"skreepeddle",0,11,4,7,0
"palaestrical",1,12,5,7,0
"olethea",1,7,4,3,0
"lfsqrcjibcrpkuievxinzf",0,22,5,17,0
"unchrisomloosing",0,16,6,10,0
"bendis",0,6,2,4,0
"anncygiccoisala",0,15,6,9,0
"glycombina",0,10,3,7,0
"asolobic",0,8,4,4,0
"hormogoneales",1,13,6,7,0
"anteriorly",1,10,4,6,0
"coxwainings",0,11,4,7,0
"petitionarily",1,13,6,7,0
"shammas",1,7,2,5,0
"photoproteid",0,12,5,7,0
"occasionalness",1,14,6,8,0
"saucerized",1,10,5,5,0
"superspeculation",1,16,7,9,0
"source",1,6,3,3,0
"zigeuner",1,8,4,4,0
"counteres",0,9,4,5,0
"schweitzer",1,10,3,7,0
"asepticises",1,11,5,6,0
"premolossingerlings",0,19,6,13,0
"pagehood",1,8,4,4,0
"ojdfovzavpswqjgeima",0,19,6,13,0
"pacorro",1,7,3,4,0
"dracaenaceae",1,12,7,5,0
"curictinsenessednes",0,19,7,12,0
"polyribonuclease",0,16,7,9,0
"proly",0,5,1,4,0
"litui",1,5,3,2,0
"connoisseur",1,11,5,6,0
"tubuliporidae",1,13,7,6,0
"compassy",0,8,2,6,0
"evangelised",1,11,5,6,0
"shadrach",1,8,2,6,0
"callomes",0,8,3,5,0
"brateribracade",0,14,6,8,0
"nasandjajar",0,11,4,7,0
"fqlovrzs",0,8,1,7,0
"napier",1,6,3,3,0
"krhrnux'ughv",0,12,2,10,1
"revoted",1,7,3,4,0
"flukinesses",1,11,4,7,0
"phemorgrollials",0,15,5,10,0
"woonoctepecockfink",0,18,7,11,0
"bereavementing",0,14,6,8,0
"laureless",0,9,4,5,0
"dxdqmqyamcqkslipxcix",0,20,3,17,0
"poursuitts",1,10,4,6,0
"bayload",0,7,3,4,0
"ovolactovegetarian",1,18,9,9,0
"conospotrionoshalogelynjarratia",0,31,13,18,0
"vaguity",1,7,3,4,0
"alodian",1,7,4,3,0
"causticisation",1,14,7,7,0
"electronidae",0,12,6,6,0
"cohabitabilities",0,16,8,8,0
"minimalities",1,12,6,6,0
"kareendorsale",0,13,6,7,0
"saraceous",0,9,5,4,0
"narigareellermolezar",0,20,9,11,0
"kamila",1,6,3,3,0
"ces",0,3,1,2,0
"lipper",1,6,2,4,0
"isometegistimos",0,15,7,8,0
"imbiber",1,7,3,4,0
"sustain",1,7,3,4,0
"tufalike",1,8,4,4,0
"diobolons",1,9,4,5,0
"fureadetid",0,10,5,5,0
"stylohyoid",1,10,3,7,0
"acritan",0,7,3,4,0
"fragmentates",1,12,4,8,0
"theatrophones",1,13,5,8,0
"nintendinitus",1,13,5,8,0
"gitaga",0,6,3,3,0
"corterlinure",0,12,5,7,0
"marbling",1,8,2,6,0
"deulemas",0,8,4,4,0
"pentaiodid",0,10,5,5,0
"subcastilessness",0,16,5,11,0
"wearced",0,7,3,4,0
"ophiuridae",1,10,6,4,0
"limnoria",1,8,4,4,0
"nonades",0,7,3,4,0
"meteoropathologic",1,17,8,9,0
"llagia",0,6,3,3,0
"fi'",0,3,1,2,1
"retrospective",1,13,5,8,0
"pudgiest",1,8,3,5,0
"swivicedly",0,10,3,7,0
"grope",1,5,2,3,0
"falun",1,5,2,3,0
"trippler",1,8,2,6,0
"noncloisterers",0,14,5,9,0
"hydrophobe",1,10,3,7,0
"misnamine",0,9,4,5,0
"'uyejoq",0,7,3,4,1
"kmsfyhysna",0,10,1,9,0
"fscuhjmc",0,8,1,7,0
"fance",0,5,2,3,0
"concertification",0,16,7,9,0
"exosemonger",0,11,5,6,0
"nwwjosdpazyetq",0,14,3,11,0
"elopers",1,7,3,4,0
"megaphone",1,9,4,5,0
"ax'ibmhywgoxc",0,13,3,10,1
"bousness",0,8,3,5,0
"eurottoura",0,10,6,4,0
"udella",1,6,3,3,0
"suborbitary",1,11,4,7,0
"realcher",0,8,3,5,0
"xrofbwngjdswjjzmzy",0,18,1,17,0
"desmodus",1,8,3,5,0
"oaxonambrolinsted",0,17,7,10,0
"lavallating",0,11,4,7,0
"gadsburg",0,8,2,6,0
"slakable",1,8,3,5,0
"panino",1,6,3,3,0
"interlike",0,9,4,5,0
"phic",0,4,1,3,0
"hig",0,3,1,2,0
"orihyperbola",1,12,5,7,0
"irremedited",0,11,5,6,0
"tulsa",1,5,2,3,0
"nose",1,4,2,2,0
"snesdner",0,8,2,6,0
"presavagery",1,11,4,7,0
"abbottstown",1,11,3,8,0
"creviced",1,8,3,5,0
"seeress",1,7,3,4,0
"sardina",1,7,3,4,0
"ulishicog",0,9,4,5,0
"paphism",0,7,2,5,0
"renoticed",1,9,4,5,0
"kalapooia",1,9,6,3,0
"rox",1,3,1,2,0
"ampmakian",0,9,4,5,0
"copatriarchy",0,12,4,8,0
"glatarcherandiatefuslae",0,23,10,13,0
"rainteeness",0,11,5,6,0
"hodoscope",1,9,4,5,0
"colonist",1,8,3,5,0
"varna",1,5,2,3,0
"decolourant",1,11,5,6,0
"mosagiatal",0,10,5,5,0
"lenwicking",0,10,3,7,0
"esrhyiwe",0,8,3,5,0
"uncomerinclistic",0,16,6,10,0
"dable",0,5,2,3,0
"jabberwockies",1,13,5,8,0
"nocustes",0,8,3,5,0
"gemmulations",1,12,5,7,0
"tawdriness",1,10,3,7,0
"wgkipoeyjtc",0,11,3,8,0
"opportunenesses",1,15,6,9,0
"lapoparantionvolatersh",0,22,9,13,0
"fips",1,4,1,3,0
"unburg",0,6,2,4,0
"roegumptional",0,13,6,7,0
"oxlands",1,7,2,5,0
"prostheses",1,10,3,7,0
"coprolite",1,9,4,5,0
"vggxpphzlusfbczrw",0,17,1,16,0
"woodpile",1,8,4,4,0
"ramulous",1,8,4,4,0
"mesometable",0,11,5,6,0
"titivations",1,11,5,6,0
"caboanugge",0,10,5,5,0
"embryopathology",1,15,5,10,0
"orientisation",1,13,7,6,0
"nebulation",1,10,5,5,0
"craighle",1,8,3,5,0
"privation",1,9,4,5,0
"kolacca",0,7,3,4,0
"ulioteteeaphiflancalupe",0,23,12,11,0
"fraughtily",0,10,3,7,0
"manchuria",1,9,4,5,0
"overhead",1,8,4,4,0
"mollusively",0,11,4,7,0
"pearce",1,6,3,3,0
"immunoglobulin",1,14,6,8,0
"polystyrene",1,11,3,8,0
"dictyosomers",0,12,4,8,0
"agisteste",0,9,4,5,0
"scaldini",1,8,3,5,0
"oberosteus",0,10,5,5,0
"assessor",1,8,3,5,0
"arrivance",1,9,4,5,0
"papiliosphere",0,13,6,7,0
"oephrlyfx",0,9,2,7,0
"photometrists",1,13,4,9,0
"leptodactylus",1,13,4,9,0
"esbatement",1,10,4,6,0
"phototaxes",1,10,4,6,0
"energesis",1,9,4,5,0
"bacchanalias",1,12,5,7,0
"ciellism",0,8,3,5,0
"jacobaea",1,8,5,3,0
"laryngectomee",1,13,5,8,0
"exactnesses",1,11,4,7,0
"prospection",1,11,4,7,0
"fsyd'nqxyclcjknm",0,16,0,16,1
"endocrinidae",0,12,6,6,0
"pnqmha'muoxwzekrshc",0,19,4,15,1
"fiess",0,5,2,3,0
"juahhtxhopau",0,12,5,7,0
"pernod",1,6,2,4,0
"dusiniurnellinesses",0,19,8,11,0
"triploidize",0,11,5,6,0
"piegan",1,6,3,3,0
"gewurztramineous",0,16,7,9,0
"coagment",1,8,3,5,0
"currier",1,7,3,4,0
"fossilisk",0,9,3,6,0
"fabulously",1,10,4,6,0
"alexiphanic",0,11,5,6,0
"unmultiplicable",1,15,6,9,0
"gauma",0,5,3,2,0
"ntares",0,6,2,4,0
"taiwanimalcula",0,14,7,7,0
"permafros",0,9,3,6,0
"arthritic",1,9,3,6,0
"urspractic",0,10,3,7,0
"yaphies",0,7,3,4,0
"daniella",1,8,4,4,0
"trosky",1,6,1,5,0
"overprepares",1,12,5,7,0
"platitudinised",1,14,6,8,0
"nn",0,2,0,2,0
"mrknpilzhgcrx'bjorcwxfedcmlk",0,28,3,25,1
"desvill",0,7,2,5,0
"recoderliemattisheridgetic",0,26,11,15,0
"outbreathiest",0,13,6,7,0
"qvgzkshsqmlozbemkp",0,18,2,16,0
"plficcamicstelel",0,16,5,11,0
"stateswomen",1,11,4,7,0
"unincorporatedness",1,18,7,11,0
"channes",0,7,2,5,0
"gnerinurivibelthouncopognthystas",0,32,11,21,0
"splanchnotomical",1,16,5,11,0
"paeh'ddlellpuhyc",0,16,4,12,1
"atfalati",1,8,4,4,0
"sauntines",0,9,4,5,0
"sunrego",0,7,3,4,0
"iualsosrgmd",0,11,4,7,0
"epopoeias",1,9,6,3,0
"desilverises",1,12,5,7,0
"atisins",0,7,3,4,0
"redistricting",1,13,4,9,0
"july",1,4,1,3,0
"batista",1,7,3,4,0
"tangi",1,5,2,3,0
"anthropopathically",1,18,6,12,0
"uioraras",0,8,5,3,0
"nvihzzbdpfpyw",0,13,1,12,0
"x'khuzaztl",0,10,2,8,1
"dwvjqclt'ewfkchuqkgdpcmr",0,24,2,22,1
"napier",1,6,3,3,0
"srkp",0,4,0,4,0
"supervigilance",1,14,6,8,0
"bibliomale",0,10,5,5,0
"hoeurpertoliteramad",0,19,9,10,0
"gaseousnesses",1,13,6,7,0
"refong",0,6,2,4,0
"phenylalanine",1,13,5,8,0
"irsyyqmnusjscnhrqeymux",0,22,4,18,0
"embiidae",1,8,5,3,0
"kosuaaqeyhxmx",0,13,5,8,0
"solway",1,6,2,4,0
"shoeing",1,7,3,4,0
"pancreatectomies",1,16,7,9,0
"ardussi",1,7,3,4,0
"occipital",1,9,4,5,0
"cemethedsorioranans",0,19,8,11,0
"rastrums",1,8,2,6,0
"hyricilocer",0,11,4,7,0
"peacheritables",0,14,6,8,0
"ferriolabeg",0,11,5,6,0
"lyomeri",1,7,3,4,0
"teinoids",0,8,4,4,0
"bargepole",1,9,4,5,0
"trxkveoktpquhip",0,15,4,11,0
"clessbulan",0,10,3,7,0
"'''",0,3,0,3,3
"euclidean",1,9,5,4,0
"magnetohydrodynamics",1,20,6,14,0
"aortomalaxis",1,12,6,6,0
"meshuggenahs",1,12,4,8,0
"chloroiodide",1,12,6,6,0
"peesweeps",1,9,4,5,0
"aerotriodissotrophagidae",0,24,12,12,0
"coquillage",1,10,5,5,0
"hnavzuajanhzmaakshzzlerd",0,24,7,17,0
"boo",1,3,2,1,0
"sabbatha",0,8,3,5,0
"ledwmdcizk",0,10,2,8,0
"lignified",1,9,4,5,0
"dovenoronpphromohontlyprhyplaracor",0,34,10,24,0
"ereed",0,5,3,2,0
"hydronautic",0,11,4,7,0
"tesler",1,6,2,4,0
"jubilatio",1,9,5,4,0
"hydrosera",0,9,3,6,0
"chrya",0,5,1,4,0
"ecalcography",0,12,4,8,0
"enistelly",0,9,3,6,0
"playlengtonia",0,13,5,8,0
"pepsi",1,5,2,3,0
"digestibilities",1,15,7,8,0
"isoaminiles",1,11,6,5,0
"disillusionised",1,15,7,8,0
"xmfrinqsc",0,9,1,8,0
"includes",1,8,3,5,0
"randie",1,6,3,3,0
"rearanging",1,10,4,6,0
"erlohe",0,6,3,3,0
"unprovocation",0,13,6,7,0
"wojtyla",1,7,2,5,0
"abu",1,3,2,1,0
"gewixwgqjvsoj",0,13,3,10,0
"archartist",1,10,3,7,0
"audy",1,4,2,2,0
"neronedrifaerog",0,15,7,8,0
"dolerites",0,9,4,5,0
"eghfqfzssmso",0,12,2,10,0
"fluidally",1,9,3,6,0
"privacation",0,11,5,6,0
"mutrachouthic",0,13,5,8,0
"trussataticatol",0,15,6,9,0
"helsinki",1,8,3,5,0
"carcased",1,8,3,5,0
"schoolboy",1,9,3,6,0
"nccytiqps",0,9,1,8,0
"otion",0,5,3,2,0
"redig",1,5,2,3,0
"dispersale",0,10,4,6,0
"jfugpbtrr'ukzmqxslsfydtz'",0,25,2,23,2
"avergedor",0,9,4,5,0
"fzzqbnvjkpgdfgcpavrpcxvhptewj",0,29,2,27,0
"zoarces",1,7,3,4,0
"langsettle",1,10,3,7,0
"omdurman",1,8,3,5,0
"mzegbpgfp'zs",0,12,1,11,1
"jyscycvvmi",0,10,1,9,0
"palle",0,5,2,3,0
"podostemaceous",1,14,7,7,0
"porticularing",0,13,5,8,0
"ster",0,4,1,3,0
"discordable",1,11,4,7,0
"cryoanaesthesia",1,15,7,8,0
"oilcamps",1,8,3,5,0
"shopkeeperta",0,12,5,7,0
"diae",0,4,3,1,0
"aeroembolism",1,12,6,6,0
"iydwkrmsmuhaursuwpcv",0,20,5,15,0
"blowpate",0,8,3,5,0
"e'iveiawnulirlsakn",0,18,8,10,1
"swaggishnesses",0,14,4,10,0
"ptyas",1,5,1,4,0
"perstringement",1,14,4,10,0
"palindromic",1,11,4,7,0
"smallens",1,8,2,6,0
"disinvites",1,10,4,6,0
"disfleewoodlesophia",0,19,9,10,0
"criollas",1,8,3,5,0
"corporacy",1,9,3,6,0
"knize",0,5,2,3,0
"ingulfment",1,10,3,7,0
"xfmreumgfbh",0,11,2,9,0
"uncess",0,6,2,4,0
"simor",0,5,2,3,0
"centrosome",1,10,4,6,0
"triculek",0,8,3,5,0
"remagnetizing",1,13,5,8,0
"embrave",1,7,3,4,0
"creaght",1,7,2,5,0
"reinvolving",1,11,4,7,0
"microgramma",1,11,4,7,0
"disconanthae",1,12,5,7,0
"neilah",1,6,3,3,0
"uncanvassed",1,11,4,7,0
"autocoprophagist",0,16,7,9,0
"irehpbnycsjnfvqkzotdzqykjei",0,27,5,22,0
"foxichincen",0,11,4,7,0
"peshastin",1,9,3,6,0
"lqsyhjgrthufpqxe",0,16,2,14,0
"caledeeideutteriimbreglehodestinnated",0,37,17,20,0
"ogregea",0,7,4,3,0
"quinins",1,7,3,4,0
"whenituddle",0,11,4,7,0
"hiessoconpy",0,11,4,7,0
"jadktnffciv",0,11,2,9,0
"tebhellate",0,10,4,6,0
"nkgnpwbbhlo",0,11,1,10,0
"fibber",1,6,2,4,0
"breadstick",1,10,3,7,0
"burke",1,5,2,3,0
"ytsmi''hrvu",0,11,2,9,2
"immaculacy",1,10,4,6,0
"oosporous",1,9,5,4,0
"normanna",1,8,3,5,0
"curiosity",1,9,4,5,0
"nuttishness",0,11,3,8,0
"alexantheism",0,12,5,7,0
"oversimplifying",1,15,5,10,0
"fkerobd",0,7,2,5,0
"donzels",1,7,2,5,0
"corporifer",0,10,4,6,0
"overbit",1,7,3,4,0
"donutridisters",0,14,5,9,0
"exhum",0,5,2,3,0
"patrizia",1,8,4,4,0
"arillodes",1,9,4,5,0
"proidacatemnochrisillattrainzlemiding",0,37,14,23,0
"undegenerate",1,12,6,6,0
"shrimpers",1,9,2,7,0
"cupfulfid",0,9,3,6,0
"mosby",1,5,1,4,0
"penetral",1,8,3,5,0
"ggvwosrbomowzfdvhn",0,18,3,15,0
"zanesville",1,10,4,6,0
"amaryllis",1,9,3,6,0
"wingate",1,7,3,4,0
"nicadore",0,8,4,4,0
"revendicated",1,12,5,7,0
"coppente",0,8,3,5,0
"riflery",1,7,2,5,0
"'myvnaanqykwzsv'jxhgzgmqwrb",0,27,2,25,2
"runtgenographic",1,15,5,10,0
"nondistractingly",1,16,4,12,0
"obezomatoryza",0,13,6,7,0
"elytrorhagia",1,12,5,7,0
"peirability",0,11,5,6,0
"gowdspinnatipartialed",0,21,8,13,0
"cudontoxicalematachromes",0,24,10,14,0
"consonantalize",1,14,6,8,0
"dist",0,4,1,3,0
"myrarfis",0,8,2,6,0
"bblylalle",0,9,2,7,0
"jarousnes",0,9,4,5,0
"spadassin",1,9,3,6,0
"forus",0,5,2,3,0
"cat'll",0,6,1,5,1
"prospectivism",0,13,4,9,0
"jiffs",1,5,1,4,0
"jellylikeness",1,13,4,9,0
"kikawaeo",1,8,5,3,0
"picturised",1,10,4,6,0
"briareum",0,8,4,4,0
"cerrises",1,8,3,5,0
"pepsinia",0,8,4,4,0
"bristolville",1,12,4,8,0
"limonism",0,8,3,5,0
"sirloiny",1,8,3,5,0
"iozf",0,4,2,2,0
"rovanilla",0,9,4,5,0
"valises",1,7,3,4,0
"juxtapositive",1,13,6,7,0
"canisters",1,9,3,6,0
"crocodile",1,9,4,5,0
"hyozo",1,5,2,3,0
"byrnes",1,6,1,5,0
"unmoralise",1,10,5,5,0
"kippie",1,6,3,3,0
"promatrologrammatous",0,20,8,12,0
"hydrophilistinesses",0,19,6,13,0
"hirty",0,5,1,4,0
"antility",0,8,3,5,0
"sesamoids",1,9,4,5,0
"peculaternightstolsters",0,23,7,16,0
"ykxdlgjtchezft",0,14,1,13,0
"preaconty",0,9,3,6,0
"repars",0,6,2,4,0
"chromograph",1,11,3,8,0
"comanche",1,8,3,5,0
"bundaberg",1,9,3,6,0
"thor",1,4,1,3,0
"trigonum",1,8,3,5,0
"roontorin",0,9,4,5,0
"synkinesis",1,10,3,7,0
"toque",1,5,3,2,0
"psitymnishipin",0,14,4,10,0
"ctuzvokseji'",0,12,4,8,1
"technostructures",1,16,5,11,0
"quillaism",0,9,4,5,0
"disharmoniphone",0,15,6,9,0
"openheartednesses",1,17,7,10,0
"llovera",1,7,3,4,0
"nabak",1,5,2,3,0
"uasgqejhdtgkokmvpq'dpa",0,22,5,17,1
"gbhonfayfmtzpecm",0,16,3,13,0
"butions",0,7,3,4,0
"theric",0,6,2,4,0
"walcessity",0,10,3,7,0
"ebenistes",1,9,4,5,0
"ulerid",0,6,3,3,0
"suva",1,4,2,2,0
"felichthyses",0,12,3,9,0
"eugh",1,4,2,2,0
"sandgrouses",1,11,4,7,0
"dusty",1,5,1,4,0
"constative",1,10,4,6,0
"flecher",0,7,2,5,0
"auridal",0,7,4,3,0
"virgouleuse",1,11,6,5,0
"spumones",1,8,3,5,0
"prass",0,5,1,4,0
"ophidae",0,7,4,3,0
"muttonwood",1,10,4,6,0
"maroc",1,5,2,3,0
"mesigible",0,9,4,5,0
"aypfmk",0,6,1,5,0
"upe",0,3,2,1,0
"indemia",0,7,4,3,0
"vertoscopes",1,11,4,7,0
"mosidderyloxemermodeld",0,22,8,14,0
"kittan",0,6,2,4,0
"ijussioning",0,11,5,6,0
"superacute",1,10,5,5,0
"jfyuyfj'ppewm",0,13,2,11,1
"langshan",1,8,2,6,0
"subm",0,4,1,3,0
"inappreciably",1,13,5,8,0
"ribonucleoline",0,14,7,7,0
"qsvoa'ciloobmrqsjuvb",0,20,6,14,1
"virgina",1,7,3,4,0
"krigia",1,6,3,3,0
"cockbell",1,8,2,6,0
"oxyluciferae",0,12,6,6,0
"railingly",1,9,3,6,0
"welladvisedly",0,13,4,9,0
"unte",0,4,2,2,0
"tuperoubring",0,12,5,7,0
"ionizers",1,8,4,4,0
"stidiumely",0,10,4,6,0
"leiden",1,6,3,3,0
"anabaptist",1,10,4,6,0
"ufsdgjrsyrqplvny",0,16,1,15,0
"excambing",1,9,3,6,0
"redeclined",1,10,4,6,0
"apodemus",1,8,4,4,0
"houseparent",1,11,5,6,0
"cheverel",1,8,3,5,0
"mucisic",0,7,3,4,0
"kirantionary",0,12,5,7,0
"rwivkhhnhjlck",0,13,1,12,0
"gabel",1,5,2,3,0
"sublus",0,6,2,4,0
"overextremis",0,12,5,7,0
"riskiness",1,9,3,6,0
"aleural",0,7,4,3,0
"flatton",0,7,2,5,0
"daeaft",0,6,3,3,0
"galactised",0,10,4,6,0
"sysatrophary",0,12,3,9,0
"lateness",1,8,3,5,0
"pxqz'cunptsmmssfyfa",0,19,2,17,1
"casts",1,5,1,4,0
"unlimbec",0,8,3,5,0
"vinitvey",0,8,3,5,0
"rehook",1,6,3,3,0
"unfricative",1,11,5,6,0
"ammists",0,7,2,5,0
"rewrite",1,7,3,4,0
"loras",0,5,2,3,0
"corrhine",0,8,3,5,0
"deutonymphal",1,12,4,8,0
"qmw'omdyvbc",0,11,1,10,1
"usumdum",0,7,3,4,0
"conflecterachee",0,15,6,9,0
"basticiseneching",0,16,6,10,0
"excerptibility",0,14,5,9,0
"treadventur",0,11,4,7,0
"electangentle",0,13,5,8,0
"incandescency",1,13,4,9,0
"wbgitnuiahdicqlyjvzxqit",0,23,6,17,0
"deely",0,5,2,3,0
"brandice",1,8,3,5,0
"semisirque",1,10,5,5,0
"linguistries",1,12,5,7,0
"pole",1,4,2,2,0
"addax",1,5,2,3,0
"fameuse",1,7,4,3,0
"toge",0,4,2,2,0
"entoprocta",1,10,4,6,0
"hintevanlabuntysemutts",0,22,7,15,0
"fachdubcokle",0,12,4,8,0
"anachueta",1,9,5,4,0
"acro",0,4,2,2,0
"postamputation",1,14,6,8,0
"marijo",1,6,3,3,0
"nasalised",1,9,4,5,0
"sovietisation",1,13,7,6,0
"pinata",1,6,3,3,0
"felsiums",0,8,3,5,0
"rvyoql'hech",0,11,2,9,1
"prifors",0,7,2,5,0
"farcinoleukemia",0,15,8,7,0
"medressehs",1,10,3,7,0
"canephobia",0,10,5,5,0
"misassembles",1,12,4,8,0
"satai",1,5,3,2,0
"alcalzaring",0,11,4,7,0
"multilobulated",1,14,6,8,0
"bthrorrorngeralopeesphunbelicrtaltadexputis",0,43,15,28,0
"freebootie",0,10,6,4,0
"mcladimen",0,9,3,6,0
"nodriantrabamierficituolunie",0,28,14,14,0
"aflerfuxopareaeag",0,17,9,8,0
"taenidia",1,8,5,3,0
"detectance",0,10,4,6,0
"lo",1,2,1,1,0
"latise",0,6,3,3,0
"uncements",0,9,3,6,0
"coras",0,5,2,3,0
"plessimeter",1,11,4,7,0
"uties",0,5,3,2,0
"authwomatbres",0,13,5,8,0
"auxil",1,5,3,2,0
"petaididdle",0,11,5,6,0
"nonvulsivity",0,12,4,8,0
"wdodgg",0,6,1,5,0
"terminaliaceae",1,14,8,6,0
"spectress",0,9,2,7,0
"lauro",1,5,3,2,0
"doic",0,4,2,2,0
"pery",0,4,1,3,0
"melnick",1,7,2,5,0
"treamba",0,7,3,4,0
"esvtodylw",0,9,2,7,0
"spellular",0,9,3,6,0
"progressionally",1,15,5,10,0
"melanosarcoma",1,13,6,7,0
"ossein",1,6,3,3,0
"acike",0,5,3,2,0
"jarabidead",0,10,5,5,0
"brewis",1,6,2,4,0
"pras",0,4,1,3,0
"obtention",1,9,4,5,0
"honeybrook",1,10,4,6,0
"geochemistous",0,13,6,7,0
"utgrawan",0,8,3,5,0
"eleusis",1,7,4,3,0
"abricalvassoriluric",0,19,8,11,0
"hae",0,3,2,1,0
"song",1,4,1,3,0
"equuleus",1,8,5,3,0
"boheas",1,6,3,3,0
"salapiacelnskfelapa",0,19,8,11,0
"coinduction",0,11,5,6,0
"kthfxfzov",0,9,1,8,0
"listerine",1,9,4,5,0
"tjaicirv'prfjbxt'yed",0,20,4,16,2
"nectarinia",1,10,5,5,0
"lingayata",1,9,4,5,0
"snarler",1,7,2,5,0
"ursulette",1,9,4,5,0
"galactosan",1,10,4,6,0
"qrsadqofiee",0,11,5,6,0
"riny",0,4,1,3,0
"strubbly",1,8,1,7,0
"megaly",0,6,2,4,0
"debutant",1,8,3,5,0
"cryptomerous",1,12,4,8,0
"vaceniepritratien",0,17,8,9,0
"kutes",0,5,2,3,0
"nonnerver",0,9,3,6,0
"noncontagionists",0,16,6,10,0
"lido",1,4,2,2,0
"akure",1,5,3,2,0
"nonconspiratorial",1,17,7,10,0
"p'",0,2,0,2,1
"tradename",1,9,4,5,0
"section",1,7,3,4,0
"unpannis",0,8,3,5,0
"ztdppemjjwmxhpqkixb",0,19,2,17,0
"consubstantiated",1,16,6,10,0
"cirratulidae",1,12,6,6,0
"prekindergarten",1,15,5,10,0
"spher",0,5,1,4,0
"disaccharidases",1,15,6,9,0
"microchasis",0,11,4,7,0
"snollygoster",1,12,3,9,0
"counterculture",1,14,6,8,0
"provincialate",1,13,6,7,0
"pting",0,5,1,4,0
"propore",0,7,3,4,0
"bicyclical",1,10,3,7,0
"interiorly",1,10,4,6,0
"allomorphism",1,12,4,8,0
"cvalist",0,7,2,5,0
"garikitcharabbyism",0,18,6,12,0
"alismsda",0,8,3,5,0
"antinastidoraglike",0,18,8,10,0
"noninterconnecticut",0,19,7,12,0
"miscensured",1,11,4,7,0
"bhikku",1,6,2,4,0
"bew",1,3,1,2,0
"poincara",1,8,4,4,0
"umooulaterodres",0,15,8,7,0
"kay",1,3,1,2,0
"scalds",1,6,1,5,0
"poppability",1,11,4,7,0
"warrantabness",0,13,4,9,0
"vivisectionary",0,14,6,8,0
"cichoriaceae",1,12,7,5,0
"pilaf",1,5,2,3,0
"peccary",1,7,2,5,0
"kxxqaevtlclmnglhenyrmg",0,22,3,19,0
"cryophilic",1,10,3,7,0
"mslxbjlkiorgyr",0,14,2,12,0
"favourite",1,9,5,4,0
"scavenage",1,9,4,5,0
"uren",0,4,2,2,0
"nyman",1,5,1,4,0
"rockaleena",0,10,5,5,0
"niersteiners",1,12,5,7,0
"pigwzhmre",0,9,2,7,0
"ahmadabad",1,9,4,5,0
"calculi",1,7,3,4,0
"sandectity",0,10,3,7,0
"nonbeliever",1,11,5,6,0
"ynl",0,3,0,3,0
"palah",0,5,2,3,0
"hearn",1,5,2,3,0
"unceable",0,8,4,4,0
"ackint",0,6,2,4,0
"asheetee",0,8,5,3,0
"chesticists",0,11,3,8,0
"brescia",1,7,3,4,0
"lesesurres",0,10,4,6,0
"quare",1,5,3,2,0
"roosterlessness",0,15,5,10,0
"vegetativeness",1,14,6,8,0
"malfeasance",1,11,5,6,0
"equipaging",1,10,5,5,0
"forestic",0,8,3,5,0
"romneyas",1,8,3,5,0
"windbreaks",1,10,3,7,0
"phycography",0,11,2,9,0
"overmaturely",1,12,5,7,0
"garrulity",1,9,3,6,0
"hasted",1,6,2,4,0
"kinetographers",0,14,5,9,0
"reconsecretion",0,14,6,8,0
"autocoherer",1,11,6,5,0
"unboxes",1,7,3,4,0
"nutiess",0,7,3,4,0
"fons",1,4,1,3,0
"ue",0,2,2,0,0
"ballsiness",1,10,3,7,0
"insolenticulated",0,16,7,9,0
"colde",0,5,2,3,0
"cereless",1,8,3,5,0
"malocclusioned",0,14,6,8,0
"weftages",1,8,3,5,0
"ue",0,2,2,0,0
"sinewiness",1,10,4,6,0
"stic",0,4,1,3,0
"sashaying",0,9,3,6,0
"observably",1,10,3,7,0
"dlbjlddrtlqhepmfwukuyfakylzk",0,28,4,24,0
"oxytone",1,7,3,4,0
"carpocapsa",1,10,4,6,0
"exantis",0,7,3,4,0
"sfqkjxodtbquemj",0,15,3,12,0
"overapped",0,9,4,5,0
"kallitypes",1,10,3,7,0
"appuis",1,6,3,3,0
"reimpovetourmel",0,15,7,8,0
"amityville",1,10,4,6,0
"shrewstruck",1,11,2,9,0
"ichnid",0,6,2,4,0
"orphed",0,6,2,4,0
"gunning",1,7,2,5,0
"sulfoselenide",1,13,6,7,0
"gandeeville",1,11,5,6,0
"negrote",0,7,3,4,0
"enteritings",0,11,4,7,0
"resenomation",0,12,6,6,0
"extraorbitally",1,14,5,9,0
"francestown",1,11,3,8,0
"ftitrongndn",0,11,2,9,0
"oracle",1,6,3,3,0
"preinstances",0,12,4,8,0
"willower",1,8,3,5,0
"presentialities",1,15,7,8,0
"fluorous",0,8,4,4,0
"microtypeppedillemed",0,20,7,13,0
"unvoraciously",1,13,6,7,0
"preocravey",0,10,4,6,0
"iooyycznkvltukrrg",0,17,4,13,0
"gncadose",0,8,3,5,0
"kolkozes",1,8,3,5,0
"downbend",1,8,2,6,0
"ababdeh",1,7,3,4,0
"fotmakings",0,10,3,7,0
"chilomycterus",1,13,4,9,0
"cocesecabriledectity",0,20,8,12,0
"gronchi",1,7,2,5,0
"aceanumette",0,11,6,5,0
"embioptera",1,10,5,5,0
"octastylos",1,10,3,7,0
"precontrivedly",0,14,4,10,0
"improvisatores",1,14,6,8,0
"rophocorare",0,11,5,6,0
"stononaliker",0,12,5,7,0
"malapropish",1,11,4,7,0
"chronon",1,7,2,5,0
"dorticosteus",0,12,5,7,0
"event",1,5,2,3,0
"addible",1,7,3,4,0
"scripee",1,7,3,4,0
"doorstensinger",0,14,5,9,0
"affrontment",1,11,3,8,0
"domphysan",0,9,2,7,0
"sanilan",0,7,3,4,0
"omniparentum",0,12,5,7,0
"nakyrlcg",0,8,1,7,0
"nonreader",1,9,4,5,0
"jabbily",0,7,2,5,0
"luaus",1,5,3,2,0
"martyn",1,6,1,5,0
"allethrin",1,9,3,6,0
"microwires",1,10,4,6,0
"blepharocephaly",0,15,5,10,0
"matriculator",1,12,5,7,0
"misjudger",1,9,3,6,0
"nitcheing",0,9,3,6,0
"periorchitis",1,12,5,7,0
"esteter",0,7,3,4,0
"jills",1,5,1,4,0
"prospect",1,8,2,6,0
"angdistis",1,9,3,6,0
"kenoticist",1,10,4,6,0
"disbecillenotax",0,15,6,9,0
"shaksperian",1,11,4,7,0
"steadisms",0,9,3,6,0
"xss'pmome'dccmnawygonug",0,23,5,18,2
"clvhgkitudutyej",0,15,4,11,0
"blastomatism",0,12,4,8,0
"cajuns",1,6,2,4,0
"fibrittellifornity",0,18,6,12,0
"phylloscopus",1,12,3,9,0
"parallelopipedon",1,16,7,9,0
"bdsiupetvsxhwcgskqguxttt",0,24,4,20,0
"vigorishes",1,10,4,6,0
"straddling",1,10,2,8,0
"histologically",1,14,5,9,0
"inspoting",0,9,3,6,0
"phelladialistically",0,19,7,12,0
"lacrimation",1,11,5,6,0
"hwracqskluf",0,11,2,9,0
"windsor",1,7,2,5,0
"preilluminate",1,13,6,7,0
"southland",1,9,3,6,0
"unarmogenity",0,12,5,7,0
"frontbitivages",0,14,5,9,0
"bukshee",1,7,3,4,0
"ductility",1,9,3,6,0
"desilicified",1,12,6,6,0
"midg",0,4,1,3,0
"echis",1,5,2,3,0
"ifoumularoniniteatulalidonflbentcanente",0,39,18,21,0
"ghencceali",0,10,4,6,0
"macrophyllous",1,13,4,9,0
"minishmen",0,9,3,6,0
"bld",1,3,0,3,0
"fhhvjwigtloeo",0,13,4,9,0
"pregenerative",0,13,6,7,0
"gelexesunn",0,10,4,6,0
"phenetic",1,8,3,5,0
"inessentiality",1,14,6,8,0
"hackhazilled",0,12,4,8,0
"unrestricts",0,11,3,8,0
"mithriac",1,8,3,5,0
"wenger",1,6,2,4,0
"athal",1,5,2,3,0
"somq'bkywdyzkujgr",0,17,2,15,1
"elanoides",1,9,5,4,0
"leate",0,5,3,2,0
"scintil",1,7,2,5,0
"biventerectomies",0,16,7,9,0
"boozlingerbracewoman",0,20,8,12,0
"kgdoxduyd",0,9,2,7,0
"pecting",0,7,2,5,0
"unrested",1,8,3,5,0
"monotremous",1,11,5,6,0
"scientologist",1,13,5,8,0
"fral",0,4,1,3,0
"preenginess",0,11,4,7,0
"panpharmacon",1,12,4,8,0
"shanniaceablenumier",0,19,9,10,0
"mukwonaccus",0,11,4,7,0
"evvyyard",0,8,2,6,0
"rekindlings",0,11,3,8,0
"caricous",1,8,4,4,0
"philodendrologies",0,17,7,10,0
"unitarian",1,9,5,4,0
"vitdwuhkpaooudq",0,15,6,9,0
"elophobic",0,9,4,5,0
"yhemhoedkgukeqbjec",0,18,6,12,0
"curvicostate",1,12,5,7,0
"grenfell",1,8,2,6,0
"mantidae",1,8,4,4,0
"brownsdale",1,10,3,7,0
"economiser",1,10,5,5,0
"pointal",1,7,3,4,0
"phasiron",1,8,3,5,0
"pioche",1,6,3,3,0
"jahvttzkxyuvadfdht'ommqkrv",0,26,4,22,1
"spaka",0,5,2,3,0
"semiextinction",1,14,6,8,0
"telexed",1,7,3,4,0
"wqc",0,3,0,3,0
"pon",0,3,1,2,0
"spirogyra",1,9,3,6,0
"osmovisinae",0,11,6,5,0
"nsrb",1,4,0,4,0
"cosignescences",0,14,5,9,0
"mapiovarepinasca",0,16,8,8,0
"ngirm",0,5,1,4,0
"sqcccaizfvfetkjvtfpyxubtyvm",0,27,4,23,0
"longson",0,7,2,5,0
"tevets",1,6,2,4,0
"mose",1,4,2,2,0
"profy",0,5,1,4,0
"arctiidae",1,9,5,4,0
"antiprelate",1,11,5,6,0
"cityfied",1,8,3,5,0
"preradiophorus",0,14,6,8,0
"manducable",1,10,4,6,0
"burseraceous",1,12,6,6,0
"ropedancer",1,10,4,6,0
"''dgchcjbnnrgwv'uj'",0,19,1,18,4
"knhduhrxpkxb",0,12,1,11,0
"broochemopolises",0,16,7,9,0
"emme",0,4,2,2,0
"tupwone",0,7,3,4,0
"seacrafty",1,9,3,6,0
"althara",0,7,3,4,0
"darks",1,5,1,4,0
"anglicization",1,13,6,7,0
"tamanaha",1,8,4,4,0
"tained",0,6,3,3,0
"stmerwoodinongied",0,17,7,10,0
"swizzles",1,8,2,6,0
"lviv",1,4,1,3,0
"opprobriously",1,13,5,8,0
"gjzzbwbcxgxcclgzt'",0,18,0,18,1
"rontiated",0,9,4,5,0
"saunaing",1,8,4,4,0
"mmblxxscjo",0,10,1,9,0
"dutchman",1,8,2,6,0
"inatided",0,8,4,4,0
"mcculloch",1,9,2,7,0
"bedtime",1,7,3,4,0
"searchment",1,10,3,7,0
"ergatomorph",1,11,4,7,0
"ciliophobies",0,12,6,6,0
"xynm'wpgoie",0,11,3,8,1
"cephalanthus",1,12,4,8,0
"popty",0,5,1,4,0
"procarboluria",0,13,6,7,0
"rna",1,3,1,2,0
"servosystematised",0,17,6,11,0
"warkloom",1,8,3,5,0
"incongruently",1,13,4,9,0
"nonretraceable",1,14,6,8,0
"prost",1,5,1,4,0
"vivalental",0,10,4,6,0
"nudusable",0,9,4,5,0
"subfluvial",1,10,4,6,0
"saurated",0,8,4,4,0
"diaguita",0,8,5,3,0
"moeritherianthropically",0,23,9,14,0
"kanreprankpots",0,14,4,10,0
"lienogastric",1,12,5,7,0
"lesage",1,6,3,3,0
"texted",1,6,2,4,0
"g'llswpoujnngaldqtrwtbane",0,25,5,20,1
"priestfish",1,10,3,7,0
"shoeblack",1,9,3,6,0
"munchen",1,7,2,5,0
"nonenforceability",1,17,7,10,0
"dishneseedtkey",0,14,5,9,0
"yugoslave",0,9,4,5,0
"traducianism",1,12,5,7,0
"deliveryman",1,11,4,7,0
"profligates",1,11,4,7,0
"wolfy",1,5,1,4,0
"typees",1,6,2,4,0
"bunci",0,5,2,3,0
"astigmat",1,8,3,5,0
"berthoud",1,8,3,5,0
"porsailer",0,9,4,5,0
"cyclopes",1,8,2,6,0
"deodoriser",1,10,5,5,0
"uxoriality",1,10,5,5,0
"spirally",1,8,2,6,0
"floatingly",1,10,3,7,0
"outdalty",0,8,3,5,0
"sozinesses",0,10,4,6,0
"hasseur",0,7,3,4,0
"timeline",1,8,4,4,0
"rwbmkuyhd",0,9,1,8,0
"symbos",0,6,1,5,0
"gourdful",1,8,3,5,0
"uniformised",1,11,5,6,0
"yafa",1,4,2,2,0
"colopexotomy",1,12,5,7,0
"puddiness",0,9,3,6,0
"fairyland",1,9,3,6,0
"mollus",0,6,2,4,0
"tolatock",0,8,3,5,0
"unsmirkingly",1,12,3,9,0
"chaplains",1,9,3,6,0
"anw'wbs",0,7,1,6,1
"wabrignexes",0,11,4,7,0
"nafud",1,5,2,3,0
"bristibility",0,12,4,8,0
"eney",0,4,2,2,0
"loyolism",1,8,3,5,0
"coffics",0,7,2,5,0
"xgsurwcxhksunvlhdzoaxf",0,22,4,18,0
"u'bcof'xpgrgjjzkcizmogbdfd",0,26,4,22,2
"methylenedioxymethamphetamine",1,29,11,18,0
"strumatic",1,9,3,6,0
"volumenometry",1,13,5,8,0
"disrated",1,8,3,5,0
"johnnie",1,7,3,4,0
"spammies",0,8,3,5,0
"anne",1,4,2,2,0
"micrometeoritic",1,15,7,8,0
"dillth",0,6,1,5,0
"intervenors",1,11,4,7,0
"mowis",0,5,2,3,0
"plumbisolvent",1,13,4,9,0
"racketiness",1,11,4,7,0
"omnipotentialist",0,16,7,9,0
"semirebellion",1,13,6,7,0
"sufferenk",0,9,3,6,0
"becka",1,5,2,3,0
"deserveful",0,10,4,6,0
"dispewynda",0,10,3,7,0
"reas",0,4,2,2,0
"odocoileus",1,10,6,4,0
"excitingly",1,10,3,7,0
"dlzswbknh",0,9,0,9,0
"meson",1,5,2,3,0
"brussels",1,8,2,6,0
"nonobviously",1,12,5,7,0
"'icig'e'hfwacejz",0,16,5,11,3
"ventish",0,7,2,5,0
"lity",0,4,1,3,0
"smic",0,4,1,3,0
"yfezl'yfroorwi",0,14,4,10,1
"trevett",1,7,2,5,0
"airyte",0,6,3,3,0
"indisputatious",0,14,7,7,0
"fagger",1,6,2,4,0
"kalapuyan",1,9,4,5,0
"sphakiot",1,8,3,5,0
"hooppole",1,8,4,4,0
"pigmentary",1,10,3,7,0
"mphec",0,5,1,4,0
"bero'e",0,6,3,3,1
"pinary",0,6,2,4,0
"rourusters",0,10,4,6,0
"swarphembassimeliniar",0,21,8,13,0
"pyrtendly",0,9,1,8,0
"jaz'hsax't",0,10,2,8,2
"unberdertonicurranglos",0,22,8,14,0
"quickhearted",1,12,5,7,0
"stretta",1,7,2,5,0
"underlighted",0,12,4,8,0
"histiciests",0,11,4,7,0
"praemaxillas",0,12,5,7,0
"idealless",1,9,4,5,0
"cx'gu",0,5,1,4,1
"delousers",1,9,4,5,0
"plumularia",1,10,5,5,0
"unsomatic",1,9,4,5,0
"prefectship",1,11,3,8,0
"pinelands",1,9,3,6,0
"biometrocidae",0,13,7,6,0
"phrery",0,6,1,5,0
"unthinkably",1,11,3,8,0
"pietisms",1,8,3,5,0
"aphingsphilus",0,13,4,9,0
"made",1,4,2,2,0
"seizors",1,7,3,4,0
"alkhasis",0,8,3,5,0
"treculia",1,8,4,4,0
"pustulations",1,12,5,7,0
"prelegislated",0,13,5,8,0
"aubela",0,6,4,2,0
"msiandrtent",0,11,3,8,0
"alpheus",1,7,3,4,0
"dutchman",1,8,2,6,0
"bugdom",1,6,2,4,0
"pioscastongortcogipem",0,21,8,13,0
"quoits",1,6,3,3,0
"fumarases",1,9,4,5,0
"westernight",0,11,3,8,0
"contumaciousness",1,16,7,9,0
"prototherian",1,12,5,7,0
"nondesulfur",0,11,4,7,0
"kney",0,4,1,3,0
"mexity",0,6,2,4,0
"tatiodavass",0,11,5,6,0
"fatiscence",1,10,4,6,0
"lowderivarium",0,13,6,7,0
"preemie",1,7,4,3,0
"boycotterers",0,12,4,8,0
"ranshakle",1,9,3,6,0
"lomy",0,4,1,3,0
"toura",1,5,3,2,0
"doormat",1,7,3,4,0
"odom",1,4,2,2,0
"saturnalistic",0,13,5,8,0
"mycerinus",1,9,3,6,0
"tarantular",1,10,4,6,0
"gropexy",0,7,2,5,0
"vsgvgeeotpxp",0,12,3,9,0
"nov",1,3,1,2,0
"kasparing",0,9,3,6,0
"ornater",1,7,3,4,0
"neberrico",0,9,4,5,0
"aethra",1,6,3,3,0
"bontuetsthanalid",0,16,6,10,0
"multitiere",0,10,5,5,0
"deadend",1,7,3,4,0
"haffkins",0,8,2,6,0
"hypertelic",1,10,3,7,0
"rhagolysis",0,10,3,7,0
"raden",0,5,2,3,0
"protomorphic",1,12,4,8,0
"comintern",1,9,3,6,0
"supertwist",1,10,3,7,0
"scuttle",1,7,2,5,0
"courtless",1,9,3,6,0
"clarable",0,8,3,5,0
"valiestia",0,9,5,4,0
"phrasemen",1,9,3,6,0
"orife",0,5,3,2,0
"byre",1,4,1,3,0
"palaeotypical",1,13,6,7,0
"caliche",1,7,3,4,0
"eneximina",0,9,5,4,0
"anasheck",0,8,3,5,0
"qxybyicfmytkquvlqws",0,19,2,17,0
"terti",1,5,2,3,0
"unress",0,6,2,4,0
"capataz",1,7,3,4,0
"asandlis",0,8,3,5,0
"mandra",0,6,2,4,0
"jullatillecrads",0,15,5,10,0
"vitek",1,5,2,3,0
"sheepeckboukown",0,15,6,9,0
"mossinesses",1,11,4,7,0
"purebeco",0,8,4,4,0
"overinger",0,9,4,5,0
"rumex",1,5,2,3,0
"hohe",1,4,2,2,0
"inshelta",0,8,3,5,0
"pasear",1,6,3,3,0
"amphites",0,8,3,5,0
"flippered",0,9,3,6,0
"anderefidroceatrwian",0,20,9,11,0
"adon",1,4,2,2,0
"ghtenes",0,7,2,5,0
"cholys",0,6,1,5,0
"horacio",1,7,4,3,0
"bakers",1,6,2,4,0
"extracathexis",0,13,5,8,0
"opinionists",1,11,5,6,0
"chartlessnesses",0,15,4,11,0
"hiphiidae",0,9,5,4,0
"thiodiglycols",1,13,4,9,0
"fullar",0,6,2,4,0
"unaccumultise",0,13,6,7,0
"evangelistic",1,12,5,7,0
"sharmas",0,7,2,5,0
"lticiblogsonsis",0,15,5,10,0
"cheverias",0,9,4,5,0
"lessen",1,6,2,4,0
"unsmokratinirosteostologenous",0,29,13,16,0
"choush",1,6,2,4,0
"juverna",1,7,3,4,0
"cerimans",1,8,3,5,0
"outtracillicence",0,16,7,9,0
"acariday",0,8,4,4,0
"peq",0,3,1,2,0
"kaffeeklatch",1,12,4,8,0
"ankagermoustondear",0,18,8,10,0
"alfedena",1,8,4,4,0
"laggings",1,8,2,6,0
"retrohepatia",0,12,6,6,0
"tripletail",1,10,4,6,0
"outlegist",0,9,4,5,0
"calopogon",1,9,4,5,0
"vauquelinite",0,12,7,5,0
"sixteeners",1,10,4,6,0
"bhayance",0,8,3,5,0
"qesbcxsddi",0,10,2,8,0
"colleague",1,9,5,4,0
"chliably",0,8,2,6,0
"daintifying",1,11,4,7,0
"toaterancers",0,12,5,7,0
"interradiating",1,14,6,8,0
"beaters",1,7,3,4,0
"mimmocky",1,8,2,6,0
"poudofes",0,8,4,4,0
"kinderspiel",1,11,4,7,0
"micrometallidice",0,16,7,9,0
"cading",0,6,2,4,0
"orthopurposthetic",0,17,6,11,0
"calcuttan",1,9,3,6,0
"empiricists",1,11,4,7,0
"tramurate",0,9,4,5,0
"logfuromy",0,9,3,6,0
"negrophobia",1,11,5,6,0
"blackband",1,9,2,7,0
"anaphalantiasis",1,15,7,8,0
"advehm",0,6,2,4,0
"indubious",1,9,5,4,0
"brython",1,7,1,6,0
"mainstructive",0,13,5,8,0
"iberian",1,7,4,3,0
"shoeia",0,6,4,2,0
"venantes",1,8,3,5,0
"comy",0,4,1,3,0
"chargehouse",1,11,5,6,0
"thessalonki",1,11,4,7,0
"darwinian",1,9,4,5,0
"geoting",0,7,3,4,0
"mummagbobless",0,13,4,9,0
"asbury",1,6,2,4,0
"crimitimather",0,13,5,8,0
"merman",1,6,2,4,0
"voiceover",1,9,5,4,0
"ulks",0,4,1,3,0
"ligniform",1,9,3,6,0
"ablegroangbotonsherp",0,20,7,13,0
"pelted",1,6,2,4,0
"bassinet",1,8,3,5,0
"euless",1,6,3,3,0
"rqkbsputn",0,9,1,8,0
"ploidy",1,6,2,4,0
"anabaptistry",1,12,4,8,0
"gfslapslgyt",0,11,1,10,0
"jujubercularly",0,14,5,9,0
"unvanquishing",1,13,5,8,0
"lepider",0,7,3,4,0
"norbialiation",0,13,7,6,0
"hysis",0,5,1,4,0
"heliotyping",1,11,4,7,0
"alexandropol",0,12,5,7,0
"sthrrinjequsties",0,16,5,11,0
"bushwelo",0,8,3,5,0
"silverboom",1,10,4,6,0
"ste",0,3,1,2,0
"cepharis",0,8,3,5,0
"prmanonieteme",0,13,6,7,0
"microhmmeters",0,13,4,9,0
"felt",1,4,1,3,0
"expenaltrawf",0,12,4,8,0
"crossboy",0,8,2,6,0
"triders",0,7,2,5,0
"bookstores",1,10,4,6,0
"trilamellate",0,12,5,7,0
"besincesnepiobs",0,15,6,9,0
"reuven",1,6,3,3,0
"ideographically",1,15,6,9,0
"lancelet",1,8,3,5,0
"mdskorntffvdkpoxsamuoqj",0,23,5,18,0
"billify",0,7,2,5,0
"j'uoqqfefeoff",0,13,5,8,1
"gooserumped",1,11,5,6,0
"staktometry",0,11,3,8,0
"whitter",1,7,2,5,0
"khuzistan",1,9,3,6,0
"recompensatory",1,14,5,9,0
"superelites",1,11,5,6,0
"gawiqeeioymj",0,12,6,6,0
"qqpx'eafycicz'",0,14,3,11,2
"eponymize",1,9,4,5,0
"noncongruous",1,12,5,7,0
"scrota",1,6,2,4,0
"dagedqf",0,7,2,5,0
"sleepiniol",0,10,5,5,0
"sternboards",1,11,3,8,0
"und",0,3,1,2,0
"ubleesoppelinedah",0,17,8,9,0
"flamp",0,5,1,4,0
"hyphene",0,7,2,5,0
"pherogleerthossndenatindoophidonsallligrestan",0,45,16,29,0
"hrfxmofqe",0,9,2,7,0
"ficamilianeshan",0,15,7,8,0
"sopun",0,5,2,3,0
"julienning",1,10,4,6,0
"alfirk",1,6,2,4,0
"iodopsin",1,8,4,4,0
"interagreeing",1,13,6,7,0
"febricant",1,9,3,6,0
"slype",1,5,1,4,0
"columbites",1,10,4,6,0
"echoers",1,7,3,4,0
"romorphenbitively",0,17,6,11,0
"ntin",0,4,1,3,0
"catjangs",1,8,2,6,0
"ewnv",0,4,1,3,0
"vaticanism",1,10,4,6,0
"rapidamente",1,11,5,6,0
"soord",1,5,2,3,0
"leasemongery",0,12,5,7,0
"zfvmzgouyddrvmptdg",0,18,2,16,0
"paron",1,5,2,3,0
"moukden",1,7,3,4,0
"refight",1,7,2,5,0
"dymq",0,4,0,4,0
"vapocautery",0,11,5,6,0
"okxbozmjlqjurvsfrsrupgtsvunq",0,28,5,23,0
"djgzfwhrxfxgxqp",0,15,0,15,0
"dissociopellaros",0,16,7,9,0
"aristotelean",1,12,6,6,0
"swine",1,5,2,3,0
"cotypic",0,7,2,5,0
"quadriformable",0,14,6,8,0
"occidentate",0,11,5,6,0
"hadlyme",1,7,2,5,0
"handplayer",0,10,3,7,0
"tetraxonianist",0,14,6,8,0
"brisked",1,7,2,5,0
"brasseries",1,10,4,6,0
"autoanalytic",1,12,6,6,0
"yauyghvcooau",0,12,6,6,0
"lapaintinsolentionintrojectionalisable",0,38,17,21,0
"inberg",0,6,2,4,0
"taed",1,4,2,2,0
"catospelle",0,10,4,6,0
"othings",0,7,2,5,0
"beltis",1,6,2,4,0
"xiphisuran",1,10,4,6,0
"outtonguing",1,11,5,6,0
"benshi",1,6,2,4,0
"sulfindigotin",0,13,5,8,0
"alliterationist",1,15,7,8,0
"sun",1,3,1,2,0
"rmslmbqnejvqwsdoa",0,17,3,14,0
"pioneers",1,8,4,4,0
"hoppings",1,8,2,6,0
"genovera",1,8,4,4,0
"nonpolarity",1,11,4,7,0
"zaandam",1,7,3,4,0
"unfolditermortical",0,18,7,11,0
"sedimentations",1,14,6,8,0
"shitkickee",0,10,4,6,0
"mademoiselle",1,12,6,6,0
"lamprey",1,7,2,5,0
"cortagolders",0,12,4,8,0
"belanesthicacicepteveashacor",0,28,12,16,0
"paraguayaquilate",0,16,9,7,0
"bomblor",0,7,2,5,0
"toucanid",1,8,4,4,0
"drick",0,5,1,4,0
"schoolage",1,9,4,5,0
"jewess",1,6,2,4,0
"imiccis",0,7,3,4,0
"diascrahienchelessons",0,21,8,13,0
"auvnqbjqnnptoczeuuznoepr",0,24,8,16,0
"subaqua",1,7,4,3,0
"gbyjgggfywtqp",0,13,0,13,0
"besognier",1,9,4,5,0
"amission",1,8,4,4,0
"inventionality",0,14,6,8,0
"stylitism",1,9,2,7,0
"homologic",1,9,4,5,0
"squatnesses",1,11,4,7,0
"smaik",1,5,2,3,0
"aquish",0,6,3,3,0
"distenwosy",0,10,3,7,0
"enteroischiocele",1,16,8,8,0
"orthoxazine",1,11,5,6,0
"agnomen",1,7,3,4,0
"courectorre",0,11,5,6,0
"agriochoerus",1,12,6,6,0
"prognosticable",1,14,5,9,0
"overa",0,5,3,2,0
"imponderables",1,13,5,8,0
"mincoptingnocogreasend",0,22,8,14,0
"vcsigwcqarvv",0,12,2,10,0
"pncjkpryxaafhetkzqzv",0,20,3,17,0
"evagination",1,11,6,5,0
"cumarolish",0,10,4,6,0
"perming",0,7,2,5,0
"signmen",0,7,2,5,0
"sepistic",0,8,3,5,0
"oceanica",1,8,5,3,0
"strica",0,6,2,4,0
"bea",1,3,2,1,0
"crogonsix",0,9,3,6,0
"keysvilludibreviation",0,21,9,12,0
"disquisiting",1,12,5,7,0
"hooverville",1,11,5,6,0
"niveau",1,6,4,2,0
"spermologer",1,11,4,7,0
"paravan",0,7,3,4,0
"distorts",1,8,2,6,0
"town",1,4,1,3,0
"precooled",1,9,4,5,0
"melanotic",1,9,4,5,0
"powwower",1,8,3,5,0
"cardiotherapy",1,13,5,8,0
"corallines",1,10,4,6,0
"pardubice",1,9,4,5,0
"lanapaha",0,8,4,4,0
"savery",1,6,2,4,0
"ismaelism",1,9,4,5,0
"scages",0,6,2,4,0
"witchbook",0,9,3,6,0
"motiforceto",0,11,5,6,0
"'jooecirz'loamyfqatiu",0,21,9,12,2
"hermannia",1,9,4,5,0
"joub",1,4,2,2,0
"disaccordancy",0,13,4,9,0
"zeroise",1,7,4,3,0
"counterattraction",1,17,7,10,0
"hyperinvolution",1,15,6,9,0
"jukhysrudkje'pf'cl",0,18,3,15,2
"archmurderising",0,15,5,10,0
"carapists",0,9,3,6,0
"mawkier",1,7,3,4,0
"remipedantic",0,12,5,7,0
"nephropodiffish",0,15,5,10,0
"unbrooded",1,9,4,5,0
"disable",0,7,3,4,0
"encatarrhaphy",1,13,4,9,0
"limbas",1,6,2,4,0
"dictograph",1,10,3,7,0
"foecunditatis",1,13,6,7,0
"superti",0,7,3,4,0
"mistlewood",0,10,4,6,0
"thewlike",1,8,3,5,0
"bvz'zrctvjcjeflclswwya",0,22,2,20,1
"thorvald",1,8,2,6,0
"filigraphic",0,11,4,7,0
"cvnnipbzwxmesgvx",0,16,2,14,0
"ecdysiast",1,9,3,6,0
"vhrxzqukgdnujaumzwvauwu",0,23,7,16,0
"nbknestt'",0,9,1,8,1
"bsc",1,3,0,3,0
"skither",1,7,2,5,0
"matrility",0,9,3,6,0
"philochus",0,9,3,6,0
"genotype",1,8,3,5,0
"subnotebook",1,11,5,6,0
"unplumped",0,9,3,6,0
"overcompensated",1,15,6,9,0
"ziyigddsqngkfmx",0,15,2,13,0
"siliquarian",0,11,6,5,0
"suborner",1,8,3,5,0
"hasting",1,7,2,5,0
"cancelability",1,13,5,8,0
"prussianisers",1,13,5,8,0
"humean",1,6,3,3,0
"batfish",1,7,2,5,0
"refright",0,8,2,6,0
"casus",0,5,2,3,0
"balery",0,6,2,4,0
"peers",1,5,2,3,0
"hibenzamia",0,10,5,5,0
"adenomeningeal",1,14,7,7,0
"superactive",1,11,5,6,0
"orchlings",0,9,2,7,0
"suppositive",1,11,5,6,0
"weenen",0,6,3,3,0
"overinsisted",0,12,5,7,0
"dubois",1,6,3,3,0
"zipporthmids",0,12,3,9,0
"notorhynchus",1,12,3,9,0
"fornflux",0,8,2,6,0
"ahur",0,4,2,2,0
"angulus",1,7,3,4,0
"hepancentionny",0,14,5,9,0
"obladiogamerography",0,19,8,11,0
"floater",1,7,3,4,0
"hypsophobia",1,11,4,7,0
"rexes",1,5,2,3,0
"unbreaking",1,10,4,6,0
"clooshidathry",0,13,4,9,0
"ovelaggearmollyal",0,17,7,10,0
"kolea",1,5,3,2,0
"lecithinases",1,12,5,7,0
"sporistternctleranetearediadeprleituc",0,37,15,22,0
"darlinals",0,9,3,6,0
"beliefly",0,8,3,5,0
"nonroy",0,6,2,4,0
"derequisitions",1,14,7,7,0
"helicopt",1,8,3,5,0
"concurboatsuspers",0,17,6,11,0
"trolla",0,6,2,4,0
"quashey",1,7,3,4,0
"cettibiditingatint",0,18,7,11,0
"autoclastic",1,11,5,6,0
"chipperfusingly",0,15,4,11,0
"lstins",0,6,1,5,0
"desmet",1,6,2,4,0
"pennarcocently",0,14,4,10,0
"xoacions",0,8,4,4,0
"omktlsngqmjgnwuuhppavxk'",0,24,4,20,1
"dionuckludis",0,12,5,7,0
"ditog",0,5,2,3,0
"oatoumis",0,8,5,3,0
"yethnlkbdsw",0,11,1,10,0
"lxvlnjmkntty",0,12,0,12,0
"bolandating",0,11,4,7,0
"negro",1,5,2,3,0
"immortalisers",1,13,5,8,0
"'croh'vomnzy'npkvzcpy",0,21,2,19,3
"burny",1,5,1,4,0
"prm",0,3,0,3,0
"redescender",0,11,4,7,0
"whoqe",0,5,2,3,0
"siametapnels",0,12,5,7,0
"ungoscopula",0,11,5,6,0
"zzvvhnynu",0,9,1,8,0
"decimalists",1,11,4,7,0
"legong",1,6,2,4,0
"pedophilism",0,11,4,7,0
"hechtians",0,9,3,6,0
"omnites",0,7,3,4,0
"disfoliageousness",0,17,8,9,0
"rarong",0,6,2,4,0
"wier",1,4,2,2,0
"preaccidental",1,13,5,8,0
"philhellenism",1,13,4,9,0
"pxe",0,3,1,2,0
"sawtimber",1,9,3,6,0
"overutilizations",1,16,8,8,0
"ssthibirhale",0,12,4,8,0
"dictyopterin",0,12,4,8,0
"backlashes",1,10,3,7,0
"maskalonge",1,10,4,6,0
"kurwx'djgcejqv'wsohpses",0,23,4,19,2
"thackerville",1,12,4,8,0
"unkindledness",1,13,4,9,0
"ensilages",1,9,4,5,0
"atermanshantopock",0,17,6,11,0
"dothides",0,8,3,5,0
"inferribility",1,13,5,8,0
"unfallacious",1,12,6,6,0
"allelopipedon",0,13,6,7,0
"tiphianism",0,10,4,6,0
"gallemulhaufficity",0,18,7,11,0
"desimone",1,8,4,4,0
"vaticinated",1,11,5,6,0
"nonabsorptive",1,13,5,8,0
"bundard",0,7,2,5,0
"shoddylike",1,10,3,7,0
"limacina",1,8,4,4,0
"unindividuated",1,14,7,7,0
"jmuiwfmllqwmw",0,13,2,11,0
"direcrially",0,11,4,7,0
"shnvjtiwmw",0,10,1,9,0
"estela",1,6,3,3,0
"nonimmunised",1,12,5,7,0
"abilinstructacleascusaraucera",0,29,13,16,0
"anomaliped",1,10,5,5,0
"nonconsulters",0,13,4,9,0
"eaaoxgclhkaafjhdrdrzixjfis",0,26,8,18,0
"endosome",1,8,4,4,0
"burgle",1,6,2,4,0
"saxonically",1,11,4,7,0
"grough",1,6,2,4,0
"turbidity",1,9,3,6,0
"pew",1,3,1,2,0
"panetella",1,9,4,5,0
"helminthici",0,11,4,7,0
"engnessang",1,10,3,7,0
"omars",0,5,2,3,0
"prewless",0,8,2,6,0
"jacksnipe",1,9,3,6,0
"milivouthoressh",0,15,6,9,0
"ybprpevvokquxjqtkxzohvr'erntxd",0,30,5,25,1
"merckx",1,6,1,5,0
"emprosthotonos",1,14,5,9,0
"upvomit",1,7,3,4,0
"chalybeous",1,10,4,6,0
"latitudinous",1,12,6,6,0
"redesigned",1,10,4,6,0
"thirm",0,5,1,4,0
"subcontinual",1,12,5,7,0
"electrifier",1,11,5,6,0
"chalkeeper",0,10,4,6,0
"nationalising",1,13,6,7,0
"wgamfoddkmbgjn'vci",0,18,3,15,1
"broek",1,5,2,3,0
"hionith",0,7,3,4,0
"zapodidae",1,9,5,4,0
"bocasine",1,8,4,4,0
"feeblement",0,10,4,6,0
"demigrations",1,12,5,7,0
"hangability",1,11,4,7,0
"metrarinke",0,10,4,6,0
"nod",1,3,1,2,0
"flibbertigibbety",1,16,5,11,0
"scholiastic",1,11,4,7,0
"lomentaria",1,10,5,5,0
"urosted",0,7,3,4,0
"leprosarium",1,11,5,6,0
"affatuate",1,9,5,4,0
"vanisher",1,8,3,5,0
"homopteran",1,10,4,6,0
"margaux",1,7,3,4,0
"amentula",1,8,4,4,0
"gennevilliers",1,13,5,8,0
"weaslurus",0,9,4,5,0
"embonpoint",1,10,4,6,0
"sandglasses",1,11,3,8,0
"blindfishers",0,12,3,9,0
"julita",1,6,3,3,0
"microcosmos",1,11,4,7,0
"spantary",0,8,2,6,0
"dramela",0,7,3,4,0
"themuses",0,8,3,5,0
"brophory",0,8,2,6,0
"kie'",0,4,2,2,1
"zobe",1,4,2,2,0
"unfascinate",1,11,5,6,0
"canopy",1,6,2,4,0
"pyralidoidea",1,12,6,6,0
"frisbees",1,8,3,5,0
"splenalgy",1,9,2,7,0
"saturality",0,10,4,6,0
"galla",1,5,2,3,0
"extravailabiogravispecifishes",0,29,13,16,0
"gkow'llmipmhif",0,14,3,11,1
"campbellites",1,12,4,8,0
"pyroline",1,8,3,5,0
"bools",1,5,2,3,0
"chartologic",0,11,4,7,0
"phytonomy",1,9,2,7,0
"reachieves",1,10,5,5,0
"dysart",1,6,1,5,0
"dislionism",0,10,4,6,0
"permatropic",0,11,4,7,0
"perigeratoria",0,13,7,6,0
"latreuse",0,8,4,4,0
"dgiatrda",0,8,3,5,0
"cttts",0,5,0,5,0
"kariti",1,6,3,3,0
"rotterdam",1,9,3,6,0
"richediabjis",0,12,5,7,0
"gyred",1,5,1,4,0
"aldermanical",1,12,5,7,0
"begaudy",1,7,3,4,0
"lwdneee",0,7,3,4,0
"nonapprovingiana",0,16,7,9,0
"commerds",0,8,2,6,0
"quaternions",1,11,5,6,0
"ankyloglossini",0,14,5,9,0
"uncloudy",1,8,3,5,0
"adbqwglie'ynhrcu'ggzgzrgglg",0,27,4,23,2
"quibblings",1,10,3,7,0
"reimpact",1,8,3,5,0
"zkhdciqmtqpmhqyjrpbtmq",0,22,1,21,0
"rengthe",0,7,2,5,0
"appaquirkingsomed",0,17,7,10,0
"trigornafeaspisetalinghauns",0,27,11,16,0
"inhis",0,5,2,3,0
"dasic",0,5,2,3,0
"w'txymhlxx'zrfuo",0,16,2,14,2
"cologies",0,8,4,4,0
"acoustoelectric",1,15,7,8,0
"meejdttnxpeqzodwoj",0,18,5,13,0
"santonin",1,8,3,5,0
"hytepibeaticit",0,14,6,8,0
"auxoamylamine",0,13,7,6,0
"wpis",0,4,1,3,0
"dopped",1,6,2,4,0
"theatrophon",0,11,4,7,0
"volently",1,8,2,6,0
"rockably",1,8,2,6,0
"xnfrantqdsi'le",0,14,3,11,1
"antitrypsin",1,11,3,8,0
"whhflkpsu",0,9,1,8,0
"rigidity",1,8,3,5,0
"crimmanaria",0,11,5,6,0
"kadu",1,4,2,2,0
"akian",0,5,3,2,0
"tabooleys",1,9,4,5,0
"frintiong",0,9,3,6,0
"deindustrialise",1,15,7,8,0
"sidoney",1,7,3,4,0
"importher",0,9,3,6,0
"episiorrhagia",1,13,7,6,0
"gemmonstandicall",0,16,5,11,0
"xfzvmaondvaysvgzjuksewsygvk",0,27,5,22,0
"copumotc'",0,9,3,6,1
"weitranalediferoacrunitiousk",0,28,14,14,0
"himidehotasatic",0,15,7,8,0
"phalacrocorax",1,13,5,8,0
"etindearevillis",0,15,7,8,0
"cxyhiynqdsglsinczjtpfosw",0,24,3,21,0
"trestlework",1,11,3,8,0
"sideat",0,6,3,3,0
"archmonarch",1,11,3,8,0
"postless",1,8,2,6,0
"megacerotinae",0,13,7,6,0
"deletion",1,8,4,4,0
"cytotroph",0,9,2,7,0
"reeve",1,5,3,2,0
"nitudberloisometered",0,20,9,11,0
"qunenapssessis",0,14,5,9,0
"carnivals",1,9,3,6,0
"dingen",0,6,2,4,0
"lurgans",0,7,2,5,0
"gastrantarish",0,13,4,9,0
"kwweujrhqcgvqvnhaswjqmlsmk",0,26,3,23,0
"thyreoid",1,8,3,5,0
"rye",0,3,1,2,0
"spreezing",1,9,3,6,0
"hesitating",1,10,4,6,0
"lampleticicoring",0,16,6,10,0
"unbroadcasted",1,13,5,8,0
"liorg",0,5,2,3,0
"har",0,3,1,2,0
"jwunebxbkdne",0,12,3,9,0
"psescoectina",0,12,5,7,0
"podsonstroddyl",0,14,3,11,0
"camboose",1,8,4,4,0
"tilvsf",0,6,1,5,0
"missiventry",0,11,3,8,0
"bloodlilit",0,10,4,6,0
"toadyishnesses",0,14,5,9,0
"scriver",1,7,2,5,0
"eldfather",1,9,3,6,0
"eudorunix",0,9,5,4,0
"horseheads",1,10,4,6,0
"burtsbitinomowdyverhinescrodromprecervermotableproushile",0,56,20,36,0
"yacks",1,5,1,4,0
"demergenced",0,11,4,7,0
"nagged",1,6,2,4,0
"theocratical",1,12,5,7,0
"namaqualand",1,11,5,6,0
"cront",0,5,1,4,0
"velyiningent",0,12,4,8,0
"resellschaft",0,12,3,9,0
"pgrtekkrznnqvlovlzcllrjjve",0,26,3,23,0
"superoxylenes",0,13,5,8,0
"nucleolini",1,10,5,5,0
"gauger",1,6,3,3,0
"congeological",0,13,6,7,0
"sivaite",1,7,4,3,0
"noncooperationist",1,17,8,9,0
"outrove",1,7,4,3,0
"balanurian",0,10,5,5,0
"flatbrod",1,8,2,6,0
"frfet",0,5,1,4,0
"nonintervention",1,15,6,9,0
"divulsive",1,9,4,5,0
"serrated",1,8,3,5,0
"cormel",1,6,2,4,0
"shering",0,7,2,5,0
"microbes",1,8,3,5,0
"alumbloom",1,9,4,5,0
"unsubduedly",1,11,4,7,0
"bhaktapur",1,9,3,6,0
"cunteriseaticabomne",0,19,9,10,0
"tenerity",1,8,3,5,0
"partie",1,6,3,3,0
"pignerate",1,9,4,5,0
"nauzi",0,5,3,2,0
"kendandass",0,10,3,7,0
"essancia",1,8,4,4,0
"microme",0,7,3,4,0
"rommels",0,7,2,5,0
"pontoniers",1,10,4,6,0
"antipathogen",0,12,5,7,0
"bretry",0,6,1,5,0
"excludible",1,10,4,6,0
"clericussations",0,15,6,9,0
"catholiciser",1,12,5,7,0
"multifidus",1,10,4,6,0
"neritidae",1,9,5,4,0
"mononitrobenzene",1,16,7,9,0
"bonbon",1,6,2,4,0
"spralledine",0,11,4,7,0
"theomagnetisms",0,14,5,9,0
"perman",0,6,2,4,0
"badmouthing",1,11,4,7,0
"lobulousness",0,12,5,7,0
"jeto",0,4,2,2,0
"seidlitz",1,8,3,5,0
"lentles",0,7,2,5,0
"hogman",0,6,2,4,0
"houtionde",0,9,5,4,0
"tubiporoid",1,10,5,5,0
"olociatoverdocantew",0,19,9,10,0
"exaltachi",0,9,4,5,0
"tunnate",0,7,3,4,0
"wolfkins",1,8,2,6,0
"alkoxide",1,8,4,4,0
"coulmer",0,7,3,4,0
"preenlikeely",0,12,5,7,0
"jsfuypue'pepgebbzojghmbl",0,24,6,18,1
"hypericales",1,11,4,7,0
"bedeter",0,7,3,4,0
"aliyahaliyahs",1,13,6,7,0
"barouse",0,7,4,3,0
"unbraking",1,9,3,6,0
"bannffaghoperuprtunolionseorvesind",0,34,13,21,0
"flemish",1,7,2,5,0
"unmodificative",1,14,7,7,0
"iviccs",0,6,2,4,0
"bigamy",1,6,2,4,0
"ultrasonogramed",0,15,6,9,0
"reindustriation",0,15,7,8,0
"angevalencia",0,12,6,6,0
"categorizing",0,12,5,7,0
"decurite",0,8,4,4,0
"isorpoired",0,10,5,5,0
"inconvironocalle",0,16,7,9,0
"appellatively",1,13,5,8,0
"oderalishershan",0,15,6,9,0
"ricardama",1,9,4,5,0
"rntlararolama",0,13,5,8,0
"gllipho",0,7,2,5,0
"sympetalae",1,10,4,6,0
"unmaiden",1,8,4,4,0
"jentrid",0,7,2,5,0
"rmepkownoufs",0,12,4,8,0
"cetelate",0,8,4,4,0
"queenish",0,8,4,4,0
"goshawful",1,9,3,6,0
"mullness",0,8,2,6,0
"baselard",1,8,3,5,0
"koralie",1,7,4,3,0
"deprophenlinatchobast",0,21,7,14,0
"horse",1,5,2,3,0
"cultigen",1,8,3,5,0
"farragut",1,8,3,5,0
"ib'vxsuxvujscaxutmmojxks",0,24,6,18,1
"cropamas",0,8,3,5,0
"retropoleis",0,11,5,6,0
"gxcjpkfpy'airw'",0,15,2,13,2
"impact",1,6,2,4,0
"busiglous",0,9,4,5,0
"doctrine",1,8,3,5,0
"unfrock",1,7,2,5,0
"spiegeleisen",1,12,6,6,0
"boongary",1,8,3,5,0
"status",1,6,2,4,0
"brichec",0,7,2,5,0
"untruckling",1,11,3,8,0
"oqjcjgmrfulphotn",0,16,3,13,0
"exceptionary",1,12,5,7,0
"strime",0,6,2,4,0
"chamiarrin",0,10,4,6,0
"q'ydisjxvr",0,10,1,9,1
"squandermaniac",1,14,6,8,0
"rrblashele",0,10,3,7,0
"reprehened",0,10,4,6,0
"phonabexscty",0,12,3,9,0
"wilbar",1,6,2,4,0
"cahons",0,6,2,4,0
"confabulated",1,12,5,7,0
"reinspirits",1,11,4,7,0
"unclassificated",0,15,6,9,0
"ainteigadfatia",0,14,8,6,0
"ironmaster",1,10,4,6,0
"rokmgdlpjmsbehwjp",0,17,2,15,0
"manteo",1,6,3,3,0
"hubboestoioparittyc",0,19,8,11,0
"stocoelight",0,11,4,7,0
"slogouns",0,8,3,5,0
"ninwork",0,7,2,5,0
"hectory",0,7,2,5,0
"sto",0,3,1,2,0
"dreed",1,5,2,3,0
"outtinkling",1,11,4,7,0
"inoculated",1,10,5,5,0
"tzutuhil",1,8,3,5,0
"trophottings",0,12,3,9,0
"undeparatophone",0,15,7,8,0
"aftereyeing",1,11,5,6,0
"bledicors",0,9,3,6,0
"ctyganects",0,10,2,8,0
"pirameatian",0,11,6,5,0
"sweetkins",1,9,3,6,0
"blickey",1,7,2,5,0
"dowbleddrhuclyalarkntithaka",0,27,8,19,0
"ilus",0,4,2,2,0
"instaidness",0,11,4,7,0
"melote",1,6,3,3,0
"firebrant",0,9,3,6,0
"moorberry",1,9,3,6,0
"disinfectant",1,12,4,8,0
"herower",0,7,3,4,0
"incorrupted",1,11,4,7,0
"bellied",1,7,3,4,0
"mokintiverle",0,12,5,7,0
"searcloth",1,9,3,6,0
"reevection",0,10,5,5,0
"burdensome",1,10,4,6,0
"organtic",0,8,3,5,0
"hirenerat",0,9,4,5,0
"otes",1,4,2,2,0
"icoriums",0,8,4,4,0
"ultrarapid",1,10,4,6,0
"automobiled",1,11,6,5,0
"clauddetta",1,10,4,6,0
"radioman",1,8,4,4,0
"pennalisms",1,10,3,7,0
"devinna",1,7,3,4,0
"zels",1,4,1,3,0
"cytherea",1,8,3,5,0
"misdials",1,8,3,5,0
"sermonist",1,9,3,6,0
"oralfue",0,7,4,3,0
"adiknybbyxm",0,11,2,9,0
"ixfshjjyclkrphkjvktq",0,20,1,19,0
"semipiousness",1,13,6,7,0
"periphrygians",0,13,4,9,0
"nonprivileged",1,13,5,8,0
"necklike",1,8,3,5,0
"streneriatenicktiavindengglleyorifixarejapyotr",0,46,18,28,0
"irj",0,3,1,2,0
"diipenates",1,10,5,5,0
"outwriggled",1,11,4,7,0
"skimmington",1,11,3,8,0
"peaberries",1,10,5,5,0
"gly",0,3,0,3,0
"niuean",1,6,4,2,0
"catrosepiped",0,12,5,7,0
"overseriously",1,13,6,7,0
"subcomputations",1,15,6,9,0
"pantonaccum",0,11,4,7,0
"gyropilot",1,9,3,6,0
"hnrjbxzozrcxamgtoyw",0,19,3,16,0
"steeve",1,6,3,3,0
"earilinspiring",0,14,6,8,0
"sorecognitobiologiest",0,21,10,11,0
"sciamachy",1,9,3,6,0
"dissymmetricality",0,17,5,12,0
"pongess",0,7,2,5,0
"fainters",1,8,3,5,0
"reglossianises",0,14,6,8,0
"dyswuyheytv'bwvbmsijtfjj'",0,25,3,22,2
"yfyduv'wmtlytcbxaouqxxfhm",0,25,4,21,1
"troubadourist",1,13,6,7,0
"wn",0,2,0,2,0
"betti",1,5,2,3,0
"sauncy",1,6,2,4,0
"manihot",1,7,3,4,0
"thouse",1,6,3,3,0
"appreciatorily",1,14,6,8,0
"enced",0,5,2,3,0
"'tiytkaznxbz",0,12,2,10,1
"isohyetal",1,9,4,5,0
"crasin",0,6,2,4,0
"abscissa",1,8,3,5,0
"ostia",1,5,3,2,0
"waitstaff",1,9,3,6,0
"yinchmoo",0,8,3,5,0
"elyse",1,5,2,3,0
"telepathising",1,13,5,8,0
"aerobusses",1,10,5,5,0
"mcminutive",0,10,4,6,0
"viridissa",1,9,4,5,0
"autocarpial",0,11,6,5,0
"pheboicabillaniting",0,19,8,11,0
"geronomite",1,10,5,5,0
"jesuist",1,7,3,4,0
"hippienesses",1,12,5,7,0
"feverberry",1,10,3,7,0
"viragi",0,6,3,3,0
"liverleaveningshade",0,19,8,11,0
"equener",0,7,4,3,0
"ifulvenorraticuneseringnetigrgges",0,33,13,20,0
"contating",0,9,3,6,0
"burcuros",0,8,3,5,0
"rhythmies",0,9,2,7,0
"pida",0,4,2,2,0
"correkee",0,8,4,4,0
"zpeziqpaht",0,10,3,7,0
"alcmene",1,7,3,4,0
"sihasapa",1,8,4,4,0
"sansk",1,5,1,4,0
"buarerocarorexichesussy",0,23,10,13,0
"eparblnuhvkmsittsi",0,18,5,13,0
"hypervitalicyl",0,14,4,10,0
"harpsichord",1,11,3,8,0
"nonreverently",1,13,4,9,0
"aphyllanthaceae",1,15,6,9,0
"pgrel'niozmez'h",0,15,4,11,2
"outproduceable",0,14,7,7,0
"syncopating",1,11,3,8,0
"nonbelligerency",1,15,5,10,0
"optatives",1,9,4,5,0
"haex",0,4,2,2,0
"pqrikstehsvecyet",0,16,4,12,0
"debutes",0,7,3,4,0
"crystallogeny",1,13,3,10,0
"qjb",0,3,0,3,0
"percuttermobility",0,17,6,11,0
"napoleonist",1,11,5,6,0
"leptoty",0,7,2,5,0
"storages",1,8,3,5,0
"mozzetta",1,8,3,5,0
"votiveness",1,10,4,6,0
"abaddie",0,7,4,3,0
"payn",0,4,1,3,0
"cephallical",0,11,4,7,0
"yosahokli",0,9,4,5,0
"lidar",1,5,2,3,0
"netterousnes",0,12,5,7,0
"leachous",0,8,4,4,0
"arass",0,5,2,3,0
"panspermists",1,12,3,9,0
"paulinistically",1,15,6,9,0
"wuproueres",0,10,5,5,0
"pf",1,2,0,2,0
"sociability",1,11,5,6,0
"alid",0,4,2,2,0
"babweapelmined",0,14,6,8,0
"falsers",1,7,2,5,0
"subscriber",1,10,3,7,0
"padklb",0,6,1,5,0
"mesodermaged",0,12,5,7,0
"zooxanthine",0,11,5,6,0
"antimodernity",0,13,5,8,0
"swordsmanship",1,13,3,10,0
"arethuse",1,8,4,4,0
"anglophobe",1,10,4,6,0
"disoperator",0,11,5,6,0
"retrim",1,6,2,4,0
"panial",0,6,3,3,0
"anning",0,6,2,4,0
"protonematoid",1,13,6,7,0
"extratympanic",1,13,4,9,0
"quereolastallourelmingall",0,25,11,14,0
"gulitalceartaitipoida",0,21,11,10,0
"eliaheraliafon",0,14,8,6,0
"maximums",1,8,3,5,0
"scrymatistrametiandenced",0,24,8,16,0
"equitarism",0,10,5,5,0
"lindberg",1,8,2,6,0
"superstition",1,12,5,7,0
"rattinesses",1,11,4,7,0
"tremellales",1,11,4,7,0
"extenuator",1,10,5,5,0
"lmvhbugf",0,8,1,7,0
"turividanviswanysunes",0,21,8,13,0
"telesales",1,9,4,5,0
"priapuses",1,9,4,5,0
"desposes",0,8,3,5,0
"sewes",0,5,2,3,0
"cers",0,4,1,3,0
"revolute",1,8,4,4,0
"chiefship",1,9,3,6,0
"cfjdjbozurogtwzfj'rouxj",0,23,5,18,1
"dorsiventralities",1,17,7,10,0
"tfadzmogyxzzftcvl",0,17,2,15,0
"ochroma",1,7,3,4,0
"prpattosta",0,10,3,7,0
"unri",0,4,2,2,0
"unfart",0,6,2,4,0
"gondivile",0,9,4,5,0
"jamdanis",1,8,3,5,0
"heterodyning",1,12,4,8,0
"peristalses",1,11,4,7,0
"miratoxeness",0,12,5,7,0
"anociation",1,10,6,4,0
"qrrco'lsagghxtum'wmrlwqckyj",0,27,3,24,2
"laue",1,4,3,1,0
"nightriding",1,11,3,8,0
"abruzzi",1,7,3,4,0
"silva",1,5,2,3,0
"dayanim",1,7,3,4,0
"coquilhatville",1,14,6,8,0
"lognesterring",0,13,4,9,0
"leffen",1,6,2,4,0
"unpossibly",1,10,3,7,0
"cansfusionlessly",0,16,5,11,0
"irreversiblenesses",1,18,7,11,0
"ctivelinc",0,9,3,6,0
"perap",0,5,2,3,0
"capacitate",1,10,5,5,0
"pondfulness",0,11,3,8,0
"poleless",1,8,3,5,0
"hcbb'e'ioa",0,10,4,6,2
"chopharrimler",0,13,4,9,0
"nerbuddie",0,9,4,5,0
"jlogeinfdde",0,11,4,7,0
"loyde",1,5,2,3,0
"iibc'qkyksrkaosvkuwjytxa",0,24,6,18,1
"ingnue",1,6,3,3,0
"blatt",1,5,1,4,0
"salinan",1,7,3,4,0
"xwsotsykpquhwo",0,14,3,11,0
"aligurlane",0,10,5,5,0
"trirement",0,9,3,6,0
"scripterons",0,11,3,8,0
"etants",0,6,2,4,0
"forgiellhdringlarbumake",0,23,8,15,0
"lollygags",1,9,2,7,0
"stracent",0,8,2,6,0
"mindofure",0,9,4,5,0
"chedra",0,6,2,4,0
"alamate",0,7,4,3,0
"overpoweringly",1,14,5,9,0
"unidolised",1,10,5,5,0
"pasang",1,6,2,4,0
"epiblastic",1,10,4,6,0
"ndifogouneeapa",0,14,8,6,0
"monsigned",0,9,3,6,0
"impresetties",0,12,5,7,0
"gfttskwlnxxkcohnt''eigjd",0,24,3,21,2
"auximon",0,7,4,3,0
"superoanterior",1,14,7,7,0
"proteinem",0,9,4,5,0
"promotion",1,9,4,5,0
"cowpoke",1,7,3,4,0
"afterhug",0,8,3,5,0
"uncoronaries",0,12,6,6,0
"barna",1,5,2,3,0
"virginality",0,11,4,7,0
"gomes",0,5,2,3,0
"peridinidae",1,11,6,5,0
"xogkstofgmikbjnvqpld",0,20,3,17,0
"demicirque",0,10,5,5,0
"preminis",0,8,3,5,0
"rhizoid",1,7,3,4,0
"scytosis",0,8,2,6,0
"excogitating",1,12,5,7,0
"reflector",1,9,3,6,0
"ving",0,4,1,3,0
"curarinesses",0,12,5,7,0
"disings",0,7,2,5,0
"insatiability",1,13,6,7,0
"pecht",1,5,1,4,0
"lekythos",1,8,2,6,0
"deverbative",1,11,5,6,0
"ilabur",0,6,3,3,0
"kejkbgbuatuogytxknnmwqfptwyy",0,28,5,23,0
"paraphysate",1,11,4,7,0
"zahqnuri",0,8,3,5,0
"chroococcus",1,11,4,7,0
"glucuronide",1,11,5,6,0
"liquesces",1,9,4,5,0
"undercanopy",1,11,4,7,0
"machmetha",0,9,3,6,0
"delphing",0,8,2,6,0
"rtenonontonttrwithancs",0,22,6,16,0
"reavouchments",0,13,5,8,0
"copake",1,6,3,3,0
"metairistical",0,13,6,7,0
"ketal",1,5,2,3,0
"appraiser",1,9,4,5,0
"knitter",1,7,2,5,0
"'cdhndrlzybg",0,12,0,12,1
"sphygmoplast",0,12,2,10,0
"milk",1,4,1,3,0
"kerry",1,5,1,4,0
"pumietetutad",0,12,6,6,0
"gingyctronele",0,13,4,9,0
"scrately",0,8,2,6,0
"wisches",0,7,2,5,0
"hydrometamorphism",1,17,5,12,0
"awwromb'czgejpmvehmsalubssye",0,28,7,21,1
"chemoprotein",0,12,5,7,0
"trebuccanies",0,12,5,7,0
"checklist",1,9,2,7,0
"rhetorise",1,9,4,5,0
"eurocarpies",0,11,6,5,0
"leppiest",0,8,3,5,0
"aej'lkaxvcrlowda",0,16,5,11,1
"nonchine",0,8,3,5,0
"tastefulness",1,12,4,8,0
"footfaultless",0,13,5,8,0
"enntenenodellidu",0,16,7,9,0
"hartourgeous",0,12,6,6,0
"ryfbzzbusdzshmizapvnbe",0,22,4,18,0
"wose",0,4,2,2,0
"unflag",0,6,2,4,0
"insentiency",1,11,4,7,0
"quasipartite",0,12,6,6,0
"bcfxxa'ehg",0,10,2,8,1
"oca",1,3,2,1,0
"gimcrack",1,8,2,6,0
"appender",1,8,3,5,0
"sinciput",1,8,3,5,0
"tricalycural",0,12,4,8,0
"perisoma",1,8,4,4,0
"ovet",0,4,2,2,0
"kinder",1,6,2,4,0
"tortrices",1,9,3,6,0
"amba",1,4,2,2,0
"sambo",1,5,2,3,0
"liendes",0,7,3,4,0
"odenvillaminable",0,16,7,9,0
"microcodilia",0,12,6,6,0
"withy",1,5,1,4,0
"pseudousness",0,12,5,7,0
"aquone",1,6,4,2,0
"lawbook",1,7,3,4,0
"auqjqx",0,6,2,4,0
"rheobase",1,8,4,4,0
"seminto",0,7,3,4,0
"lugubium",0,8,4,4,0
"pareos",1,6,3,3,0
"communicatally",0,14,5,9,0
"balkane",0,7,3,4,0
"pentiodide",1,10,5,5,0
"bulsejet",0,8,3,5,0
"brassfoundings",1,14,4,10,0
"connochaetes",1,12,5,7,0
"pascale",1,7,3,4,0
"effeminately",1,12,5,7,0
"mallin",1,6,2,4,0
"stonyford",1,9,2,7,0
"licastro",1,8,3,5,0
"calmend",0,7,2,5,0
"ame",1,3,2,1,0
"mesostoma",1,9,4,5,0
"bidations",0,9,4,5,0
"hulkily",1,7,2,5,0
"horometer",1,9,4,5,0
"kiredis",0,7,3,4,0
"deutheringlence",0,15,6,9,0
"cwgfnwk",0,7,0,7,0
"eupolyzoan",1,10,5,5,0
"dilutor",1,7,3,4,0
"mordelloid",1,10,4,6,0
"quadratrix",1,10,4,6,0
"hised",0,5,2,3,0
"zanthoxylum",1,11,3,8,0
"tohatchi",1,8,3,5,0
"subun",0,5,2,3,0
"anaerobioses",1,12,7,5,0
"anagers",0,7,3,4,0
"agistment",1,9,3,6,0
"overbless",0,9,3,6,0
"acism",0,5,2,3,0
"alexiler",0,8,4,4,0
"blyioslatele",0,12,5,7,0
"nscyilaledo",0,11,4,7,0
"resensation",0,11,5,6,0
"chite",0,5,2,3,0
"outbacks",1,8,3,5,0
"welldoo",0,7,3,4,0
"ibidingly",0,9,3,6,0
"corallum",1,8,3,5,0
"racreriswng",0,11,3,8,0
"neepandemium",0,12,6,6,0
"mecca",1,5,2,3,0
"poseck",0,6,2,4,0
"tremolando",1,10,4,6,0
"overableness",0,12,5,7,0
"sinistrorse",1,11,4,7,0
"trollo",0,6,2,4,0
"colliculate",1,11,5,6,0
"mylodon",1,7,2,5,0
"firked",1,6,2,4,0
"uromere",1,7,4,3,0
"beabled",0,7,3,4,0
"bromination",1,11,5,6,0
"accessoriness",1,13,5,8,0
"aless",0,5,2,3,0
"orren",1,5,2,3,0
"flashes",1,7,2,5,0
"a'dyyuapudcrlipranmiiy",0,22,8,14,1
"mitiffoleas",0,11,5,6,0
"stular",0,6,2,4,0
"sterization",0,11,5,6,0
"uncolant",0,8,3,5,0
"cizwlsnfvcigezpdi",0,17,4,13,0
"extri",0,5,2,3,0
"vmrozmvedboc'nd",0,15,3,12,1
"jmlgaz'uiuwqkc",0,14,4,10,1
"synangia",1,8,3,5,0
"rescores",1,8,3,5,0
"petechia",1,8,4,4,0
"essentialist",1,12,5,7,0
"yearningly",1,10,3,7,0
"backaw",0,6,2,4,0
"waister",1,7,3,4,0
"pujmeyuuaq",0,10,5,5,0
"chalassoed",0,10,4,6,0
"huckaback",1,9,3,6,0
"benedikt",1,8,3,5,0
"overconfident",1,13,5,8,0
"asianization",1,12,7,5,0
"vinaigued",0,9,5,4,0
"dylana",1,6,2,4,0
"straightedges",1,13,4,9,0
"bbpxyc'avbevoljj",0,16,3,13,1
"trypetid",1,8,2,6,0
"almadan",1,7,3,4,0
"arederickers",0,12,5,7,0
"vituperadvantarctic",0,19,7,12,0
"huzzas",1,6,2,4,0
"calamitotic",0,11,5,6,0
"namopointersificalled",0,21,9,12,0
"bathomeboat",0,11,5,6,0
"hebraicise",1,10,5,5,0
"yhcy",0,4,0,4,0
"glycolipide",1,11,4,7,0
"madzoon",1,7,3,4,0
"kricteingly",0,11,3,8,0
"overplussite",0,12,5,7,0
"heaty",0,5,2,3,0
"itamalate",1,9,5,4,0
"jtfhed",0,6,1,5,0
"pocitulmonatie",0,14,7,7,0
"enticeship",0,10,4,6,0
"truditor",0,8,3,5,0
"pointlessness",1,13,4,9,0
"improbabilities",1,15,7,8,0
"bologically",0,11,4,7,0
"proroubline",0,11,5,6,0
"ogunquit",1,8,4,4,0
"redeliveries",1,12,6,6,0
"paxillae",1,8,4,4,0
"armied",1,6,3,3,0
"contum",0,6,2,4,0
"ptgks",0,5,0,5,0
"datic",0,5,2,3,0
"corers",1,6,2,4,0
"phantasmagory",1,13,4,9,0
"perishability",1,13,5,8,0
"subsoilers",1,10,4,6,0
"toyally",0,7,2,5,0
"communicableness",1,16,6,10,0
"libonucleotide",0,14,7,7,0
"ataxiameter",1,11,6,5,0
"baperycarnicamauseninatisscanend",0,32,13,19,0
"herboat",0,7,3,4,0
"orthographicalnesses",0,20,7,13,0
"saturatory",0,10,4,6,0
"lcbxrrrfwgkeskifboni'db",0,23,4,19,1
"summerhouse",1,11,5,6,0
"tympanoperiotic",1,15,6,9,0
"prosas",0,6,2,4,0
"pyej'''pqaydw",0,13,2,11,3
"inutimuts",0,9,4,5,0
"reers",0,5,2,3,0
"antichlorine",1,12,5,7,0
"brd",0,3,0,3,0
"achafe",1,6,3,3,0
"vicitally",0,9,3,6,0
"italicism",1,9,4,5,0
"hatemonger",1,10,4,6,0
"pedersen",1,8,3,5,0
"occur",1,5,2,3,0
"triethylstilbestrols",0,20,5,15,0
"unnesia",0,7,4,3,0
"gcammisiasseifore",0,17,8,9,0
"tabors",1,6,2,4,0
"palicourea",1,10,6,4,0
"wmdzoezvwrpf",0,12,2,10,0
"plet",0,4,1,3,0
"drenneidlead",0,12,5,7,0
"revaluated",1,10,5,5,0
"preshipping",1,11,3,8,0
"higdon",1,6,2,4,0
"inderallchetenessely",0,20,7,13,0
"ermalinda",1,9,4,5,0
"xthtywkbyhf'",0,12,0,12,1
"arenigging",0,10,4,6,0
"unchangers",0,10,3,7,0
"ypolentawemipan",0,15,6,9,0
"tontaciprcanoming",0,17,6,11,0
"clodhopperish",1,13,4,9,0
"phosphine",1,9,3,6,0
"fountably",0,9,3,6,0
"indiligence",1,11,5,6,0
"nimoliegastrocia",0,16,8,8,0
"anthropoiesis",0,13,6,7,0
"upwheel",1,7,3,4,0
"sylvicolidae",1,12,5,7,0
"splenopexia",1,11,5,6,0
"acroblacrentagermlesse",0,22,8,14,0
"princessly",1,10,2,8,0
"skinfood",1,8,3,5,0
"'l'uihnldbnhdliai",0,17,5,12,2
"winceyette",1,10,4,6,0
"theres",1,6,2,4,0
"nishaicyass",0,11,4,7,0
"nonruminant",1,11,4,7,0
"declassed",1,9,3,6,0
"kirgless",0,8,2,6,0
"unsnapballed",0,12,4,8,0
"quytes",1,6,2,4,0
"britinointipicu",0,15,7,8,0
"chassels",0,8,2,6,0
"chatterygotiativenesses",0,23,9,14,0
"punkest",1,7,2,5,0
"discerptions",1,12,4,8,0
"ribcage",1,7,3,4,0
"dawbry",1,6,1,5,0
"conversating",0,12,4,8,0
"superiologists",0,14,6,8,0
"oscillos",0,8,3,5,0
"bobble",1,6,2,4,0
"trashiness",1,10,3,7,0
"tonina",1,6,3,3,0
"unaccouplit",0,11,5,6,0
"disputtins",0,10,3,7,0
"adansonia",1,9,5,4,0
"edmontifiedness",0,15,6,9,0
"pseudobulb",1,10,4,6,0
"picing",0,6,2,4,0
"bretwalda",1,9,3,6,0
"shoddia",0,7,3,4,0
"ethiodynamogal",0,14,6,8,0
"ilwyciugdd",0,10,3,7,0
"tricovination",0,13,6,7,0
"animatic",1,8,4,4,0
"alondectes",0,10,4,6,0
"followings",1,10,3,7,0
"lambyx",0,6,1,5,0
"tertoveunolodntebicodnte",0,24,10,14,0
"asms",0,4,1,3,0
"platyrrhiny",1,11,2,9,0
"uriveloune",0,10,6,4,0
"untremulant",1,11,4,7,0
"siephobrine",0,11,5,6,0
"unparbiquitang",0,14,6,8,0
"aerenchyma",1,10,4,6,0
"oversubtlety",1,12,4,8,0
"gaminesses",1,10,4,6,0
"klongs",1,6,1,5,0
"precensured",1,11,4,7,0
"bedder",1,6,2,4,0
"atherationality",0,15,7,8,0
"quirement",0,9,4,5,0
"prehenne",0,8,3,5,0
"p'angbburuvhw",0,13,3,10,1
"amoxibusterstandsters",0,21,7,14,0
"circumstantiviral",0,17,6,11,0
"perforator",1,10,4,6,0
"immuration",1,10,5,5,0
"samotherium",1,11,5,6,0
"cfsq",0,4,0,4,0
"cijpksvmtibsls",0,14,2,12,0
"thamnium",1,8,3,5,0
"evulgarlicking",0,14,5,9,0
"nester",1,6,2,4,0
"wrectinglor",0,11,3,8,0
"bumemamanabrwdoupt",0,18,7,11,0
"perceptiveness",1,14,5,9,0
"chounes",0,7,3,4,0
"prosstoa",1,8,3,5,0
"lipsticks",1,9,2,7,0
"hogging",1,7,2,5,0
"lophophorine",1,12,5,7,0
"simul",1,5,2,3,0
"subpolygonatum",0,14,5,9,0
"lite",1,4,2,2,0
"bummer",1,6,2,4,0
"crest",1,5,1,4,0
"cruciating",1,10,4,6,0
"emidlnfiolvc'nebjnxxiq",0,22,6,16,1
"acceleroblasts",0,14,5,9,0
"brittanic",1,9,3,6,0
"porthron",0,8,2,6,0
"interseminates",0,14,6,8,0
"caradon",1,7,3,4,0
"antomorph",0,9,3,6,0
"quomodos",1,8,4,4,0
"nonreplacement",1,14,5,9,0
"baudrick",1,8,3,5,0
"justinianean",1,12,6,6,0
"dottle",1,6,2,4,0
"autocephalus",0,12,6,6,0
"jibwometaploid",0,14,6,8,0
"caroaches",1,9,4,5,0
"spondyls",1,8,1,7,0
"teliferous",1,10,5,5,0
"nonmutually",1,11,4,7,0
"proempiricist",1,13,5,8,0
"populser",0,8,3,5,0
"ammey",0,5,2,3,0
"hogmentanences",0,14,5,9,0
"wwuzrhhid'uuhmvhawsyk",0,21,5,16,1
"phlebiting",0,10,3,7,0
"mesprises",1,9,3,6,0
"inturns",1,7,2,5,0
"dubuncole",0,9,4,5,0
"voiturin",1,8,4,4,0
"reponed",1,7,3,4,0
"chittings",0,9,2,7,0
"recarociaw",0,10,5,5,0
"reborrows",1,9,3,6,0
"supernaculums",1,13,5,8,0
"nonconfluenza",0,13,5,8,0
"waypner",0,7,2,5,0
"kapellmeister",1,13,5,8,0
"vendaval",1,8,3,5,0
"allium",1,6,3,3,0
"polyteridemasils",0,16,6,10,0
"prostindeenwreis",0,16,6,10,0
"girtline",1,8,3,5,0
"reobtains",1,9,4,5,0
"suckbussubgle",0,13,4,9,0
"nonfle",0,6,2,4,0
"nonguests",1,9,3,6,0
"unswearescer",0,12,5,7,0
"sinaitic",1,8,4,4,0
"snarliamenism",0,13,5,8,0
"apocentre",1,9,4,5,0
"c'xoohmgwn",0,10,2,8,1
"scabriusculose",1,14,6,8,0
"zoototemism",1,11,5,6,0
"uilealilunttaerakerapinewelacis",0,31,16,15,0
"limbeck",1,7,2,5,0
"proped",0,6,2,4,0
"chemstrand",1,10,2,8,0
"dicoumarins",1,11,5,6,0
"nodanybyrathanterus",0,19,6,13,0
"nonprever",0,9,3,6,0
"jackhandiest",0,12,4,8,0
"dinnertimes",1,11,4,7,0
"primulida",0,9,4,5,0
"fagottist",1,9,3,6,0
"pugids",0,6,2,4,0
"straightforwardnesses",1,21,6,15,0
"sarus",1,5,2,3,0
"barbamol",0,8,3,5,0
"horeyma",0,7,3,4,0
"focsle",1,6,2,4,0
"oftenness",1,9,3,6,0
"patessnes",0,9,3,6,0
"influents",1,9,3,6,0
"mesembryanthemiasciurus",0,23,9,14,0
"indions",0,7,3,4,0
"maywings",1,8,2,6,0
"district",1,8,2,6,0
"ence",0,4,2,2,0
"overmentasketchicalleggca",0,25,9,16,0
"regrinderbottidros",0,18,6,12,0
"tottier",1,7,3,4,0
"boulanger",1,9,4,5,0
"cataphasias",0,11,5,6,0
"mente",0,5,2,3,0
"zooming",1,7,3,4,0
"tanquiro",0,8,4,4,0
"endpapers",1,9,3,6,0
"motoneuralgias",0,14,7,7,0
"hairweavings",1,12,5,7,0
"factyly",0,7,1,6,0
"uncentral",0,9,3,6,0
"saddlebrained",0,13,5,8,0
"alcanisations",0,13,6,7,0
"mestrocoly",0,10,3,7,0
"proboscidean",1,12,5,7,0
"paideutic",1,9,5,4,0
"stalued",0,7,3,4,0
"rattlingish",0,11,3,8,0
"mahmal",1,6,2,4,0
"ectosarcous",1,11,5,6,0
"leus",0,4,2,2,0
"hyposthenia",1,11,4,7,0
"ptravgylwlawbq'cdminxtkjqalf",0,28,4,24,1
"ui",0,2,2,0,0
"rzolrku'''x''dl",0,15,2,13,5
"uprist",1,6,2,4,0
"harity",0,6,2,4,0
"pronas",0,6,2,4,0
"loloner",0,7,3,4,0
"ananketed",0,9,4,5,0
"migraphia",0,9,4,5,0
"vegenos",0,7,3,4,0
"tchponism",0,9,2,7,0
"sphyraenidae",1,12,5,7,0
"pranonchinderoudninatliommatlllovarethoreringse",0,47,18,29,0
"karli",1,5,2,3,0
"misbrandian",0,11,4,7,0
"flomeds",0,7,2,5,0
"rgebhi",0,6,2,4,0
"baldad",1,6,2,4,0
"yrikquyhktzwcmdxb",0,17,2,15,0
"completestamarany",0,17,6,11,0
"bearer",1,6,3,3,0
"whens",1,5,1,4,0
"hibin",0,5,2,3,0
"nudnick",1,7,2,5,0
"pulvinni",1,8,3,5,0
"phoch",0,5,1,4,0
"mattrass",1,8,2,6,0
"bronchaldazine",0,14,5,9,0
"roccelloid",0,10,4,6,0
"chucklebone",0,11,4,7,0
"wgpkshgflwfy'",0,13,0,13,1
"mesodontist",0,11,4,7,0
"fonvill",0,7,2,5,0
"ponglisedinodw",0,14,5,9,0
"ocjivkflbflilnp'ojpiwtuapwzd",0,28,7,21,1
"supererogatory",1,14,6,8,0
"wory",0,4,1,3,0
"kilter",1,6,2,4,0
"flearbited",0,10,4,6,0
"nmgfoxwjoujbwrrwntc",0,19,3,16,0
"overpretonecobium",0,17,8,9,0
"revette",0,7,3,4,0
"custocks",1,8,2,6,0
"fugitive",1,8,4,4,0
"alishacunthosmins",0,17,6,11,0
"holds",1,5,1,4,0
"hinch",1,5,1,4,0
"unliking",1,8,3,5,0
"unfellowlike",1,12,5,7,0
"dersintis",0,9,3,6,0
"trhacasurs",0,10,3,7,0
"algaeology",1,10,5,5,0
"prrusteedestreereromos",0,22,9,13,0
"orran",1,5,2,3,0
"rachauffeusing",0,14,6,8,0
"freemorphilyeable",0,17,7,10,0
"yatopdwqqsjioxehj",0,17,5,12,0
"unsluices",1,9,4,5,0
"pownies",1,7,3,4,0
"trophic",1,7,2,5,0
"nabalus",1,7,3,4,0
"titian",1,6,3,3,0
"ans",0,3,1,2,0
"unregurgeries",0,13,6,7,0
"squatterproof",1,13,5,8,0
"telepath",1,8,3,5,0
"satiewmarkpoterfuluxes",0,22,9,13,0
"vmrp",0,4,0,4,0
"jtaoqbphkxpv'ojavoeqcvrs",0,24,6,18,1
"tendentiousness",1,15,6,9,0
"coinventing",1,11,4,7,0
"guwznlctttqvqbqkeva",0,19,3,16,0
"macariableness",0,14,6,8,0
"entapophysial",1,13,5,8,0
"buxosens",0,8,3,5,0
"agee",1,4,3,1,0
"unavailful",1,10,5,5,0
"traletrindocuitltyt",0,19,6,13,0
"antieugenic",1,11,6,5,0
"sleswick",1,8,2,6,0
"spheroidisation",1,15,7,8,0
"phithom",1,7,2,5,0
"talker",1,6,2,4,0
"gosporidae",0,10,5,5,0
"undeparter",0,10,4,6,0
"ananda",1,6,3,3,0
"polymerisation",1,14,6,8,0
"wometowess",0,10,4,6,0
"vassily",1,7,2,5,0
"ruteriform",0,10,4,6,0
"curandero",1,9,4,5,0
"sphermenism",0,11,3,8,0
"unford",0,6,2,4,0
"avulte",0,6,3,3,0
"tred",0,4,1,3,0
"acanagen",0,8,4,4,0
"arquated",1,8,4,4,0
"ossmaxmbkmeqlqsvayaurb",0,22,6,16,0
"unrecognised",1,12,5,7,0
"vvforzoummr",0,11,3,8,0
"transubstruckmole",0,17,5,12,0
"circumference",1,13,5,8,0
"yeramt",0,6,2,4,0
"enclitics",1,9,3,6,0
"extrovertibly",0,13,4,9,0
"voidal",0,6,3,3,0
"puddleproof",0,11,4,7,0
"dounperdizesms",0,14,5,9,0
"netter",1,6,2,4,0
"satanology",1,10,4,6,0
"brokenheartener",0,15,6,9,0
"apostatism",1,10,4,6,0
"fomiscaisule",0,12,6,6,0
"keslahas",0,8,3,5,0
"aminta",1,6,3,3,0
"crepis",1,6,2,4,0
"vvjijntjecxnqbd",0,15,2,13,0
"peption",0,7,3,4,0
"uncommersionist",0,15,6,9,0
"nilotic",1,7,3,4,0
"platessigenes",0,13,5,8,0
"weldor",1,6,2,4,0
"neuronym",1,8,3,5,0
"chiai",1,5,3,2,0
"polysin",0,7,2,5,0
"deviationist",1,12,6,6,0
"chinookan",1,9,4,5,0
"lacintrfaenaheruleclopoongiermas",0,32,14,18,0
"acres",1,5,2,3,0
"obeyers",1,7,3,4,0
"ryleyearbad",0,11,4,7,0
"zared",1,5,2,3,0
"crenulation",1,11,5,6,0
"unstaysail",0,10,4,6,0
"newgawen",0,8,3,5,0
"uabjkgqixkevrafpck",0,18,5,13,0
"sculturg",0,8,2,6,0
"fibrisations",0,12,5,7,0
"finianiship",0,11,5,6,0
"birl",1,4,1,3,0
"noninflammatory",1,15,5,10,0
"axiniform",1,9,4,5,0
"abiete",0,6,4,2,0
"tal",1,3,1,2,0
"ur''lmrpafrdrlzcymok'g",0,22,3,19,3
"ovitioenand",0,11,6,5,0
"hyzya",0,5,1,4,0
"assorblas",0,9,3,6,0
"panderma",1,8,3,5,0
"beerbelly",1,9,3,6,0
"madrilitype",0,11,4,7,0
"edallediatoun",0,13,7,6,0
"involucella",0,11,5,6,0
"vltpeslezc''bisnq",0,17,3,14,2
"tkdysbchhbzfiycizppk",0,20,2,18,0
"hokier",1,6,3,3,0
"relimity",0,8,3,5,0
"overfallen",1,10,4,6,0
"m'gjfix''fxfeb'wpqtxye",0,22,3,19,4
"bb",1,2,0,2,0
"premenstrually",1,14,4,10,0
"judgeship",1,9,3,6,0
"xanthophore",1,11,4,7,0
"magindanao",1,10,5,5,0
"naish",1,5,2,3,0
"sempiternizes",0,13,5,8,0
"postdigenemiclinomining",0,23,9,14,0
"fairview",1,8,4,4,0
"scootching",1,10,3,7,0
"tubfish",1,7,2,5,0
"wnos",0,4,1,3,0
"mauvines",1,8,4,4,0
"pxdmzwntbkxpplivijwbuzpdev",0,26,4,22,0
"krambukrounprent",0,16,5,11,0
"aus",0,3,2,1,0
"gymslip",1,7,1,6,0
"duster",1,6,2,4,0
"waxers",1,6,2,4,0
"twistor",1,7,2,5,0
"teruteru",1,8,4,4,0
"nonindulgiate",0,13,6,7,0
"geotechnist",0,11,4,7,0
"mammoni",1,7,3,4,0
"husband",1,7,2,5,0
"qwiazkaitithtvbblvvuef",0,22,7,15,0
"tallinarseille",0,14,6,8,0
"subclinically",1,13,4,9,0
"kynthomasville",0,14,4,10,0
"metopryls",1,9,2,7,0
"podocarp",1,8,3,5,0
"acivensamoly",0,12,5,7,0
"f'ccakugs",0,9,2,7,1
"there",1,5,2,3,0
"apocrystallman",0,14,4,10,0
"actiniarian",1,11,6,5,0
"countertop",1,10,4,6,0
"microsecond",1,11,4,7,0
"meghan",1,6,2,4,0
"ardath",1,6,2,4,0
"cornel",1,6,2,4,0
"dissyish",0,8,2,6,0
"salley",1,6,2,4,0
"ortet",1,5,2,3,0
"unshawl",1,7,2,5,0
"flagstaffs",1,10,2,8,0
"tiees",0,5,3,2,0
"spatterdash",1,11,3,8,0
"nonnachromleadonaraphotogitrupedualluenchecriatheadomissocancryo",0,64,27,37,0
"nephorelike",0,11,5,6,0
"eyrkojpv'lgcygzcux",0,18,3,15,1
"eccring",0,7,2,5,0
"bewig",1,5,2,3,0
"elixed",1,6,3,3,0
"springtown",1,10,2,8,0
"hlon",0,4,1,3,0
"myxospongiae",1,12,5,7,0
"slubbering",1,10,3,7,0
"cnidocyst",1,9,2,7,0
"barr",1,4,1,3,0
"mvaekaoswi",0,10,5,5,0
"telekij'btnltajziwvu'",0,21,6,15,2
"christianography",1,16,5,11,0
"ylcodrmgpckkahxzlpzmcvyhp",0,25,2,23,0
"acroctas",0,8,3,5,0
"lvkkj'asjyzsbgr",0,15,1,14,1
"chaetanotis",0,11,5,6,0
"undereying",1,10,4,6,0
"teleodesmacea",1,13,7,6,0
"mellifluousness",1,15,6,9,0
"voyettyism",0,10,3,7,0
"mor",1,3,1,2,0
"macrocephalous",1,14,6,8,0
"corfiots",1,8,3,5,0
"gnycttv'joaohtntboeaxyjs",0,24,6,18,1
"interwise",0,9,4,5,0
"noncomplementary",1,16,5,11,0
"squire",1,6,3,3,0
"pess'krtdk",0,10,1,9,1
"tralleness",0,10,3,7,0
"porkman",1,7,2,5,0
"spinstrelessly",0,14,3,11,0
"alluids",0,7,3,4,0
"cc",1,2,0,2,0
"hitmen",1,6,2,4,0
"mewls",1,5,1,4,0
"gravagered",0,10,4,6,0
"nonconducture",0,13,5,8,0
"saladroobrigatonical",0,20,9,11,0
"scutelliplantar",1,15,5,10,0
"cetologist",1,10,4,6,0
"ooenbfzluaneodqvjlwqn",0,21,7,14,0
"mamseller",0,9,3,6,0
"mescuzer",0,8,3,5,0
"pseudodramatically",1,18,7,11,0
"gravianism",0,10,4,6,0
"epeehl",0,6,3,3,0
"draba",1,5,2,3,0
"unisomorphic",1,12,5,7,0
"superspecular",0,13,5,8,0
"undefra",0,7,3,4,0
"ancine",0,6,3,3,0
"unworshipful",1,12,4,8,0
"sitlbadnyrs",0,11,2,9,0
"hedonically",1,11,4,7,0
"biirwmrvcwufrcklvntl",0,20,3,17,0
"burnweed",1,8,3,5,0
"thallochlore",1,12,4,8,0
"jarrelled",0,9,3,6,0
"shadine",1,7,3,4,0
"polycythaemic",1,13,4,9,0
"acholous",1,8,4,4,0
"lavon",1,5,2,3,0
"sotols",1,6,2,4,0
"strapontins",1,11,3,8,0
"pemis",0,5,2,3,0
"musketry",1,8,2,6,0
"treptor",0,7,2,5,0
"memorablenesses",1,15,6,9,0
"cmyb",0,4,0,4,0
"ciszek",1,6,2,4,0
"fo'ikojojhzns'dumjskshtpywc'",0,28,5,23,3
"tussled",1,7,2,5,0
"beneighbored",1,12,5,7,0
"parasympathetic",1,15,5,10,0
"repudiations",1,12,6,6,0
"acientaliatone",0,14,8,6,0
"skzlntclbtunvtou",0,16,3,13,0
"epizoplayanimatah",0,17,8,9,0
"lymphogranulomatosis",1,20,7,13,0
"xmnieobmyxciy",0,13,4,9,0
"qvntrtreqkjzzo",0,14,2,12,0
"timne",1,5,2,3,0
"eivnzptjjvgsca",0,14,3,11,0
"gazpi",0,5,2,3,0
"ickhrns",0,7,1,6,0
"pavemental",1,10,4,6,0
"mandington",0,10,3,7,0
"bonaveria",1,9,5,4,0
"taxoseusynanting",0,16,6,10,0
"cically",0,7,2,5,0
"locor",0,5,2,3,0
"timeliine",1,9,5,4,0
"ime",0,3,2,1,0
"jundi",0,5,2,3,0
"inventorying",1,12,4,8,0
"irenidae",0,8,5,3,0
"dorsoabdominalisations",0,22,10,12,0
"zkubqtwcsuqrhef",0,15,3,12,0
"tetioted",0,8,4,4,0
"narras",1,6,2,4,0
"condybooms",0,10,3,7,0
"randalia",1,8,4,4,0
"eausthriota",0,11,6,5,0
"boggling",0,8,2,6,0
"uepaboma",0,8,5,3,0
"jxdarba",0,7,2,5,0
"declaimants",1,11,4,7,0
"galia",0,5,3,2,0
"amaurosis",1,9,5,4,0
"literaryism",1,11,4,7,0
"hauls",1,5,2,3,0
"rowletts",1,8,2,6,0
"poidently",0,9,3,6,0
"cline",1,5,2,3,0
"tetraceratous",1,13,6,7,0
"respiritual",0,11,5,6,0
"anchimbeyebence",0,15,6,9,0
"clacton",1,7,2,5,0
"'cewsuoczdjudwfxqguzhkr",0,23,5,18,1
"cowriter",1,8,3,5,0
"truisms",1,7,2,5,0
"clession",0,8,3,5,0
"undaentrinvia",0,13,6,7,0
"overneglectfulness",1,18,6,12,0
"tv",1,2,0,2,0
"unated",0,6,3,3,0
"jgclginslrl",0,11,1,10,0
"gordan",1,6,2,4,0
"conotonthewalc",0,14,5,9,0
"dolichocracies",0,14,6,8,0
"cornwallis",1,10,3,7,0
"unmartyr",1,8,2,6,0
"farreation",1,10,5,5,0
"insincerite",0,11,5,6,0
"preadolescent",1,13,5,8,0
"ourpologpes",0,11,5,6,0
"centrates",0,9,3,6,0
"exochlegadvist",0,14,5,9,0
"scaul",1,5,2,3,0
"argently",0,8,2,6,0
"precantagitart",0,14,5,9,0
"impicoel",0,8,4,4,0
"bridesman",1,9,3,6,0
"sideless",1,8,3,5,0
"fructiferously",1,14,5,9,0
"cories",1,6,3,3,0
"kados",1,5,2,3,0
"rhoenoun",0,8,4,4,0
"hatbrushes",1,10,3,7,0
"accreted",1,8,3,5,0
"mmedote",0,7,3,4,0
"semnopithecine",1,14,6,8,0
"ombudsperson",1,12,4,8,0
"dagruaeetochybanin",0,18,8,10,0
"zygogeness",0,10,3,7,0
"aporetical",1,10,5,5,0
"mauritanie",1,10,6,4,0
"rangifer",1,8,3,5,0
"rotariat",0,8,4,4,0
"ntoruerveme",0,11,5,6,0
"litigiousness",1,13,6,7,0
"luller",1,6,2,4,0
"scausly",0,7,2,5,0
"croissant",1,9,3,6,0
"milisodymaxua",0,13,6,7,0
"mammalogy",1,9,3,6,0
"orsa",1,4,2,2,0
"europa",1,6,4,2,0
"tinsels",1,7,2,5,0
"enfoncee",1,8,4,4,0
"'pkf'v'gczlyehys",0,16,1,15,3
"homochromatic",1,13,5,8,0
"crewell",0,7,2,5,0
"shulamite",1,9,4,5,0
"subcritical",1,11,4,7,0
"ybislffvbxibx",0,13,2,11,0
"chroporackierpothetic",0,21,8,13,0
"natika",1,6,3,3,0
"picrotoxins",1,11,4,7,0
"bushments",0,9,2,7,0
"reisc",0,5,2,3,0
"haquetted",0,9,4,5,0
"bushkill",1,8,2,6,0
"naphthoquinone",1,14,6,8,0
"foreignness",1,11,4,7,0
"nonhomogeneous",1,14,7,7,0
"counterligament",0,15,6,9,0
"zostomiumittingle",0,17,7,10,0
"cowley",1,6,2,4,0
"posadas",1,7,3,4,0
"migraphylouish",0,14,5,9,0
"taphoniate",0,10,5,5,0
"agquewv'xvoaih",0,14,6,8,1
"stanchering",1,11,3,8,0
"amphimacean",0,11,5,6,0
"lychazvqvilsdnnykgyzkvmusiw",0,27,4,23,0
"vesiculotubular",1,15,7,8,0
"modernisation",1,13,6,7,0
"abbreviates",1,11,5,6,0
"indonesia",1,9,5,4,0
"trinely",1,7,2,5,0
"entwistable",0,11,4,7,0
"zooindism",0,9,4,5,0
"mitlchtrmmouxorbekjj",0,20,5,15,0
"kaph",1,4,1,3,0
"poulaines",1,9,5,4,0
"speedboat",1,9,4,5,0
"labobiforioung",0,14,7,7,0
"borderline",1,10,4,6,0
"neurophily",0,10,4,6,0
"bolis",0,5,2,3,0
"piery",0,5,2,3,0
"aneurs",0,6,3,3,0
"vesturing",1,9,3,6,0
"homophonic",1,10,4,6,0
"crotes",0,6,2,4,0
"pyruline",1,8,3,5,0
"discepheraphinian",0,17,7,10,0
"aldunglerigmies",0,15,6,9,0
"bdutyd",0,6,1,5,0
"rabbanite",1,9,4,5,0
"statute",1,7,3,4,0
"andropov",1,8,3,5,0
"edlsslfgnnr'ifhnfrtucdhiu",0,25,5,20,1
"imaum",1,5,3,2,0
"pironi",1,6,3,3,0
"buckminsterfullerene",1,20,7,13,0
"chaulmoogras",1,12,5,7,0
"storeroom",1,9,4,5,0
"dicteroneshates",0,15,6,9,0
"trebleness",1,10,3,7,0
"uncoveted",1,9,4,5,0
"ieot",0,4,3,1,0
"bungies",1,7,3,4,0
"listening",1,9,3,6,0
"recovery",1,8,3,5,0
"emblebes",0,8,3,5,0
"curuba",1,6,3,3,0
"tertulia",1,8,4,4,0
"namas",1,5,2,3,0
"arist",0,5,2,3,0
"nagyvrad",1,8,2,6,0
"electrothermics",1,15,5,10,0
"jurisprudents",1,13,4,9,0
"gabilight",0,9,3,6,0
"sxvce'nw",0,8,1,7,1
"flagsta",0,7,2,5,0
"mcukozl",0,7,2,5,0
"gypsoplast",1,10,2,8,0
"undampable",1,10,4,6,0
"sharecha",0,8,3,5,0
"wherewitchbackscatterspace",0,26,8,18,0
"wors",0,4,1,3,0
"anagrammats",0,11,4,7,0
"zymogenes",1,9,3,6,0
"mools",1,5,2,3,0
"asexualist",0,10,5,5,0
"othemorrhea",1,11,5,6,0
"bairas",0,6,3,3,0
"dediwxstnjeufvvlnokuvjolqn",0,26,7,19,0
"impetigos",1,9,4,5,0
"totuqude",0,8,4,4,0
"unitarist",0,9,4,5,0
"wiseling",1,8,3,5,0
"rebeccaites",1,11,5,6,0
"metasilia",0,9,5,4,0
"amphibole",1,9,4,5,0
"masochists",1,10,3,7,0
"avitandoff",0,10,4,6,0
"exilarchate",1,11,5,6,0
"elysia",1,6,3,3,0
"causey",1,6,3,3,0
"pablanktonopolatter",0,19,7,12,0
"hulwort",1,7,2,5,0
"gasphoboding",0,12,4,8,0
"rangemen",1,8,3,5,0
"xagbosdsva'",0,11,3,8,1
"yivuxhossrrx'cdyznv",0,19,3,16,1
"ridianised",0,10,5,5,0
"stowninoceria",0,13,6,7,0
"unconcentrative",1,15,6,9,0
"simitar",1,7,3,4,0
"p'guchluaq",0,10,3,7,1
"honestonish",0,11,4,7,0
"inter",0,5,2,3,0
"djiboutian",1,10,5,5,0
"jubougglors",0,11,4,7,0
"cariban",1,7,3,4,0
"harghesion",0,10,4,6,0
"tural",0,5,2,3,0
"iceskate",1,8,4,4,0
"cradnecus",0,9,3,6,0
"blastemas",1,9,3,6,0
"facrevalinte",0,12,5,7,0
"retrojugulators",0,15,6,9,0
"laban",1,5,2,3,0
"ugrianize",1,9,5,4,0
"destrejocer",0,11,4,7,0
"unwallycope",0,11,4,7,0
"qwdmttqqirusmvibizp",0,19,4,15,0
"oeyoqyskdbz",0,11,3,8,0
"droppage",1,8,3,5,0
"precapitalist",1,13,5,8,0
"hluchy",1,6,1,5,0
"rubenise",0,8,4,4,0
"nereis",1,6,3,3,0
"andledge",0,8,3,5,0
"bippectate",0,10,4,6,0
"lapiderwort",0,11,4,7,0
"uninfolded",1,10,4,6,0
"phatogubaus",0,11,5,6,0
"unbedding",1,9,3,6,0
"woodgeld",1,8,3,5,0
"artenmental",0,11,4,7,0
"kylik",0,5,1,4,0
"nonrhythmic",1,11,2,9,0
"ccatialive",0,10,5,5,0
"distressfulness",1,15,4,11,0
"fleetinghouseclean",0,18,8,10,0
"travelerlike",1,12,5,7,0
"havives",0,7,3,4,0
"mushiest",1,8,3,5,0
"jotting",1,7,2,5,0
"stonemple",0,9,3,6,0
"yowlanduridiocyterism",0,21,8,13,0
"easterly",1,8,3,5,0
"anic",0,4,2,2,0
"incorrigibly",1,12,4,8,0
"nonadmirers",1,11,4,7,0
"stomiss",0,7,2,5,0
"crackback",1,9,2,7,0
"stancial",0,8,3,5,0
"eosinophilisms",0,14,6,8,0
"penrod",1,6,2,4,0
"desyl",1,5,1,4,0
"antimodern",1,10,4,6,0
"jayn",1,4,1,3,0
"ouxk",0,4,2,2,0
"battakhin",1,9,3,6,0
"hurobuvftgbqipawyp",0,18,5,13,0
"playlist",1,8,2,6,0
"balnibarbi",1,10,4,6,0
"burnette",0,8,3,5,0
"nsichy",0,6,1,5,0
"nuevo",1,5,3,2,0
"adrenolytic",1,11,4,7,0
"skatikas",1,8,3,5,0
"scourt",0,6,2,4,0
"hadclqacyafidzjzvxgue",0,21,6,15,0
"uncoincidentate",0,15,7,8,0
"snaphthalesteropneumonically",0,28,10,18,0
"ridge",1,5,2,3,0
"cladophyta",0,10,3,7,0
"nops",0,4,1,3,0
"treadlers",1,9,3,6,0
"erodability",1,11,5,6,0
"chambermaid",1,11,4,7,0
"kg'tqr",0,6,0,6,1
"oswin",1,5,2,3,0
"crossion",0,8,3,5,0
"dozily",1,6,2,4,0
"exte",0,4,2,2,0
"algesia",0,7,4,3,0
"zwitte",0,6,2,4,0
"troid",0,5,2,3,0
"phospoorwangiparakpennablemercovising",0,37,14,23,0
"unremonstrative",1,15,6,9,0
"chloroiodide",1,12,6,6,0
"pseudospectral",1,14,5,9,0
"etchiffcy",0,9,2,7,0
"cugblcpnazxo",0,12,3,9,0
"preinsulators",0,13,5,8,0
"anderachart",0,11,4,7,0
"waterbelly",1,10,3,7,0
"zjvjyifknqbhzuivizb'cwlxeqda",0,28,6,22,1
"ramballograpostcapsibilians",0,27,10,17,0
"ingenes",0,7,3,4,0
"skiogram",1,8,3,5,0
"otozoum",1,7,4,3,0
"prematurine",0,11,5,6,0
"brigherruperc",0,13,4,9,0
"brynhild",1,8,1,7,0
"enframe",1,7,3,4,0
"eyjs",0,4,1,3,0
"apiarians",1,9,5,4,0
"albuquerquean",1,13,7,6,0
"dawding",0,7,2,5,0
"cephalos",0,8,3,5,0
"unexaminable",1,12,6,6,0
"defloccule",0,10,4,6,0
"freemarumpies",0,13,6,7,0
"penelopising",1,12,5,7,0
"'ohuugd'ip",0,10,4,6,2
"monand",0,6,2,4,0
"vourfmen",0,8,3,5,0
"anthropocollas",0,14,5,9,0
"mbawtoghis",0,10,3,7,0
"subtraceae",0,10,5,5,0
"portcullis",1,10,3,7,0
"bjyv",0,4,0,4,0
"busked",1,6,2,4,0
"stogeys",1,7,2,5,0
"melinite",1,8,4,4,0
"unenduring",1,10,4,6,0
"cruciated",1,9,4,5,0
"elvaston",1,8,3,5,0
"capelet",1,7,3,4,0
"infantries",1,10,4,6,0
"bedad",1,5,2,3,0
"coudersport",1,11,4,7,0
"biosynthesis",1,12,4,8,0
"peptive",0,7,3,4,0
"sarra",1,5,2,3,0
"danieu",1,6,4,2,0
"pondistealthy",0,13,4,9,0
"dochoenchisms",0,13,4,9,0
"brayton",1,7,2,5,0
"gingerroot",1,10,4,6,0
"schliemann",1,10,3,7,0
"volvedly",0,8,2,6,0
"tomonininse",0,11,5,6,0
"syne",0,4,1,3,0
"mesometed",0,9,4,5,0
"aler",0,4,2,2,0
"bethane",0,7,3,4,0
"proptamtichamicklity",0,20,6,14,0
"ossible",0,7,3,4,0
"sedlik",1,6,2,4,0
"miphganwaeveaumurunostoernag",0,28,13,15,0
"romilly",1,7,2,5,0
"piskitifichanagy",0,16,6,10,0
"burnitorise",0,11,5,6,0
"lingly",0,6,1,5,0
"hospitalization",0,15,7,8,0
"middlesex",1,9,3,6,0
"cielleiopts",0,11,5,6,0
"aseshiastiont",0,13,6,7,0
"muggering",1,9,3,6,0
"piendilshllarisereottidicawads",0,30,12,18,0
"millithrum",1,10,3,7,0
"nqrnoh",0,6,1,5,0
"nugae",1,5,3,2,0
"aucanian",1,8,5,3,0
"hehra",0,5,2,3,0
"labrealitionalibiddy",0,20,9,11,0
"unpragmatical",1,13,5,8,0
"malectrochlorenzier",0,19,7,12,0
"bougruvematentyn",0,16,6,10,0
"hypoplastex",0,11,3,8,0
"auriform",1,8,4,4,0
"brandisher",1,10,3,7,0
"tcawi",1,5,2,3,0
"dbridement",1,10,3,7,0
"unenterprising",1,14,5,9,0
"mulus",0,5,2,3,0
"od",1,2,1,1,0
"fooleerindicle",0,14,7,7,0
"transmigranomian",0,16,6,10,0
"godewyn",1,7,2,5,0
"lomi",0,4,2,2,0
"hkhbifstsrwxqunpc",0,17,2,15,0
"kesomioote",0,10,6,4,0
"superian",0,8,4,4,0
"dampishly",1,9,2,7,0
"flashcards",1,10,2,8,0
"vereditarily",0,12,5,7,0
"snoove",1,6,3,3,0
"lendings",1,8,2,6,0
"rapsislutodrativapuleel",0,23,10,13,0
"scatroinstiterle",0,16,6,10,0
"sawhore",0,7,3,4,0
"didoulesunaconcalelit",0,21,10,11,0
"cereuses",1,8,4,4,0
"feminity",1,8,3,5,0
"bechic",1,6,2,4,0
"uptalk",1,6,2,4,0
"mounte",0,6,3,3,0
"isidium",0,7,4,3,0
"penoid",0,6,3,3,0
"aviha",0,5,3,2,0
"vroqfnkdleabpqgpwz",0,18,3,15,0
"thesterisabibunadingeevikshede",0,30,13,17,0
"uncooperating",1,13,6,7,0
"parthenius",1,10,4,6,0
"biuplogunila",0,12,6,6,0
"sitophyre",0,9,3,6,0
"jlxq",0,4,0,4,0
"vapidism",1,8,3,5,0
"conclamation",1,12,5,7,0
"laudeteria",0,10,6,4,0
"highlands",1,9,2,7,0
"akund",1,5,2,3,0
"breechcloth",1,11,3,8,0
"nonoblast",0,9,3,6,0
"revelociculatation",0,18,9,9,0
"velishableadaloweinagallisany",0,29,13,16,0
"vatoifeunangsipll",0,17,7,10,0
"laything",0,8,2,6,0
"teus",0,4,2,2,0
"intraperineal",1,13,6,7,0
"malvaceae",1,9,5,4,0
"brunotogy",0,9,3,6,0
"hetampbelock",0,12,4,8,0
"juevvxrznnyv",0,12,2,10,0
"gtfvsscurchdcyrqb'",0,18,1,17,1
"plowjogger",1,10,3,7,0
"gypsy",1,5,0,5,0
"altand",0,6,2,4,0
"stists",0,6,1,5,0
"stemmy",1,6,1,5,0
"pledged",1,7,2,5,0
"revator",0,7,3,4,0
"fleah",0,5,2,3,0
"orchese",0,7,3,4,0
"retten",0,6,2,4,0
"jech",0,4,1,3,0
"lotherbesean",0,12,5,7,0
"resis",0,5,2,3,0
"rafaelof",1,8,4,4,0
"tulusabilither",0,14,6,8,0
"'iqsxut",0,7,2,5,1
"brucella",1,8,3,5,0
"pinjays",0,7,2,5,0
"lanistic",0,8,3,5,0
"bargemen",1,8,3,5,0
"florae",1,6,3,3,0
"enflowerablenesses",0,18,7,11,0
"hocalifellysibewer",0,18,7,11,0
"blackage",0,8,3,5,0
"oviparousnesses",0,15,7,8,0
"tion",0,4,2,2,0
"carpopoditic",1,12,5,7,0
"didelphiness",0,12,4,8,0
"izvestia",1,8,4,4,0
"humablency",0,10,3,7,0
"kopelle",0,7,3,4,0
"desarighted",0,11,4,7,0
"lectern",1,7,2,5,0
"reforgeable",1,11,5,6,0
"largenius",0,9,4,5,0
"euously",0,7,4,3,0
"imposthumates",1,13,5,8,0
"bridgeables",1,11,4,7,0
"phiporogaterety",0,15,6,9,0
"ckauareroditins",0,15,7,8,0
"areocentric",1,11,5,6,0
"nonhomogeneousness",0,18,8,10,0
"pachismeserileted",0,17,7,10,0
"cedernghiacoeciosis",0,19,9,10,0
"sutteeism",1,9,4,5,0
"signage",1,7,3,4,0
"elaterometer",1,12,6,6,0
"sheenie",1,7,4,3,0
"counterterm",1,11,4,7,0
"rmyyoqimaazgl",0,13,4,9,0
"homelessnesses",1,14,5,9,0
"upwrencher",0,10,3,7,0
"cnr",1,3,0,3,0
"swillbelly",1,10,2,8,0
"zonr",0,4,1,3,0
"umbloochetes",0,12,5,7,0
"gynoecious",0,10,5,5,0
"coneogrefolgoeucariani",0,22,12,10,0
"supermysteries",1,14,5,9,0
"uralite",1,7,4,3,0
"anom",0,4,2,2,0
"neallispecatichantwidntola",0,26,10,16,0
"darrouzett",1,10,4,6,0
"medromalactivalethodistically",0,29,11,18,0
"fletchedly",0,10,2,8,0
"caryophyllin",1,12,3,9,0
"cincinctnesses",0,14,4,10,0
"snakishness",0,11,3,8,0
"convalustan",0,11,4,7,0
"nimrodic",1,8,3,5,0
"dichlorides",1,11,4,7,0
"hyperiqua",0,9,4,5,0
"ghostily",1,8,2,6,0
"oliphant",1,8,3,5,0
"oviste",0,6,3,3,0
"exauthoritarianism",0,18,9,9,0
"pqnkjbqfc'ijdzkcv",0,17,1,16,1
"bustier",1,7,3,4,0
"pleomorphosis",0,13,5,8,0
"parnellite",1,10,4,6,0
"araeometry",1,10,5,5,0
"laparohysterotomy",1,17,6,11,0
"proctopushed",0,12,4,8,0
"midittles",0,9,3,6,0
"wynuchoutteral",0,14,5,9,0
"renculace",0,9,4,5,0
"overgallamuchillahs",0,19,7,12,0
"diffusednesses",1,14,5,9,0
"designees",1,9,4,5,0
"scended",1,7,2,5,0
"animatronics",1,12,5,7,0
"epigone",1,7,4,3,0
"prepleviewable",0,14,6,8,0
"korah",1,5,2,3,0
"pos",1,3,1,2,0
"sivated",0,7,3,4,0
"consequel",0,9,4,5,0
"norm",1,4,1,3,0
"parearts",0,8,3,5,0
"preadjustments",1,14,4,10,0
"futtock",1,7,2,5,0
"tundish",1,7,2,5,0
"bogexato",0,8,4,4,0
"brachytactyly",1,13,2,11,0
"buckler",1,7,2,5,0
"immortiser",0,10,4,6,0
"gitas",1,5,2,3,0
"lnwfytaccatezjkkg'owcsxgjkg",0,27,4,23,1
"vinegarroon",1,11,5,6,0
"chysts",0,6,0,6,0
"acupuncturist",1,13,5,8,0
"contipopterning",0,15,5,10,0
"bools",1,5,2,3,0
"mixodectes",1,10,4,6,0
"xcoxmyejcxz",0,11,2,9,0
"subtlet",0,7,2,5,0
"absarah",0,7,3,4,0
"decketicand",0,11,4,7,0
"nonprognost",0,11,3,8,0
"unquietable",1,11,6,5,0
"underminding",1,12,4,8,0
"fubar",1,5,2,3,0
"jerald",1,6,2,4,0
"isohydric",1,9,3,6,0
"widespread",1,10,4,6,0
"cuzpllursss",0,11,2,9,0
"hippocration",0,12,5,7,0
"drigaticiolatingwiggler",0,23,9,14,0
"jablon",1,6,2,4,0
"extoum",0,6,3,3,0
"etruscans",1,9,3,6,0
"tjvcbzcuamwpvnuv",0,16,3,13,0
"occurring",1,9,3,6,0
"heliped",0,7,3,4,0
"xenolite",1,8,4,4,0
"nonleguminositol",0,16,7,9,0
"nalats",0,6,2,4,0
"burrow",1,6,2,4,0
"xtcitaxqe",0,9,3,6,0
"esophorbitely",0,13,5,8,0
"nonproducible",1,13,5,8,0
"rrqlj'mfpquftwzhcqvrcqy",0,23,1,22,1
"transmittings",0,13,3,10,0
"prestrean",0,9,3,6,0
"ditoss",0,6,2,4,0
"precomputing",1,12,4,8,0
"kiwqagk'xpnqfhl'k'ypvibobg'jl",0,29,4,25,4
"canas",0,5,2,3,0
"dero",0,4,2,2,0
"okevvy",0,6,2,4,0
"anasarca",1,8,4,4,0
"unprofessionally",1,16,6,10,0
"uneeda",1,6,4,2,0
"frederica",1,9,4,5,0
"trimmerally",0,11,3,8,0
"momently",1,8,2,6,0
"stomorpts",0,9,2,7,0
"euclenbreassies",0,15,7,8,0
"endocele",0,8,4,4,0
"hejanilabilitiona",0,17,9,8,0
"columbar",0,8,3,5,0
"reronium",0,8,4,4,0
"mycolite",0,8,3,5,0
"cludufurantison",0,15,6,9,0
"jixiomper",0,9,4,5,0
"libb",1,4,1,3,0
"vrouws",1,6,2,4,0
"archenemies",1,11,5,6,0
"shortsightedness",1,16,4,12,0
"hessian",1,7,3,4,0
"archimime",1,9,4,5,0
"tecxevfklurjbxop'",0,17,4,13,1
"bakehouse",1,9,5,4,0
"anklebones",1,10,4,6,0
"fbtynoufuskbzqwynfgmivanq",0,25,5,20,0
"nondkic",0,7,2,5,0
"offered",1,7,3,4,0
"uyect'dsvfmotk",0,14,3,11,1
"superstar",1,9,3,6,0
"zbyczhyttxqeaw'b'dzbh",0,21,2,19,2
"sapphisms",1,9,2,7,0
"mutabilities",1,12,6,6,0
"slavonias",0,9,4,5,0
"alysoun",1,7,3,4,0
"cloup",0,5,2,3,0
"acceptablenesses",1,16,6,10,0
"antiricin",1,9,4,5,0
"needleproof",1,11,5,6,0
"homospories",1,11,5,6,0
"uqj'komyzvp",0,11,2,9,1
"strauchted",1,10,3,7,0
"portative",0,9,4,5,0
"outlawins",0,9,4,5,0
"cola",1,4,2,2,0
"burgoo",1,6,3,3,0
"mazateco",1,8,4,4,0
"kd",1,2,0,2,0
"clems",1,5,1,4,0
"gitana",1,6,3,3,0
"avkasvppwf''c",0,13,2,11,2
"scornings",1,9,2,7,0
"lipariontsdinymishmen",0,21,7,14,0
"egomsulatreinierros",0,19,9,10,0
"sulphantimonite",1,15,6,9,0
"condoes",1,7,3,4,0
"conicamole",0,10,5,5,0
"harmaning",1,9,3,6,0
"worthmetelted",0,13,4,9,0
"untathebanthodoubletisms",0,24,9,15,0
"ventiducts",1,10,3,7,0
"tofruid",0,7,3,4,0
"preachments",1,11,3,8,0
"unrefracting",1,12,4,8,0
"osbourn",1,7,3,4,0
"readvances",1,10,4,6,0
"tenchifying",0,11,3,8,0
"'qiwyykkzu",0,10,2,8,1
"vedis",1,5,2,3,0
"philomel",1,8,3,5,0
"spain",1,5,2,3,0
"rhical",0,6,2,4,0
"frogeye",1,7,3,4,0
"bubo",1,4,2,2,0
"supersoler",0,10,4,6,0
"blllaunavingrretes",0,18,6,12,0
"heartthrob",1,10,3,7,0
"marawling",0,9,3,6,0
"nonphysiologically",1,18,6,12,0
"ophilocybin",0,11,4,7,0
"divulgence",1,10,4,6,0
"cydipping",0,9,2,7,0
"reenthrones",1,11,4,7,0
"interwise",0,9,4,5,0
"chronogrammic",1,13,4,9,0
"qfjykuqemjqlthhldpvhiynyvk",0,26,3,23,0
"reaumur",1,7,4,3,0
"microcration",0,12,5,7,0
"litsertingly",0,12,3,9,0
"bridered",0,8,3,5,0
"countertransversely",0,19,6,13,0
"hfoayjytnvbbn",0,13,2,11,0
"preceptories",1,12,5,7,0
"yshhtkq",0,7,0,7,0
"champignons",1,11,3,8,0
"charterioculamite",0,17,8,9,0
"takhan",0,6,2,4,0
"tenetruddys",0,11,3,8,0
"alplerounancocrfr",0,17,6,11,0
"footganger",1,10,4,6,0
"distocles",0,9,3,6,0
"harbon",0,6,2,4,0
"ovenintic",0,9,4,5,0
"dinks",1,5,1,4,0
"leblood",0,7,3,4,0
"shle",0,4,1,3,0
"unsettled",1,9,3,6,0
"obsecrations",1,12,5,7,0
"g'jgbmwqthvwpvlctms'uo'yzv",0,26,2,24,3
"mhakccefanlsoifucdyz",0,20,6,14,0
"precaudal",1,9,4,5,0
"bcjnqtrlrfv'pm'alzd",0,19,1,18,2
"omniscaling",0,11,4,7,0
"achlor",0,6,2,4,0
"laboratories",1,12,6,6,0
"softies",1,7,3,4,0
"nonfusibility",1,13,5,8,0
"guinn",1,5,2,3,0
"ontrititopablerainerontanastogaled",0,34,15,19,0
"lunik",1,5,2,3,0
"xyty'fnhixtxeddtcsv",0,19,2,17,1
"ub'l'lqqvsejrcukvzhlbxple",0,25,4,21,2
"electant",1,8,3,5,0
"kiehl",1,5,2,3,0
"riated",0,6,3,3,0
"hypersensitised",1,15,5,10,0
"heptachronous",1,13,5,8,0
"bllogllsmis",0,11,2,9,0
"nadbus",1,6,2,4,0
"vlftqhupw",0,9,1,8,0
"selva",1,5,2,3,0
"harmereillysinga",0,16,6,10,0
"influenced",1,10,4,6,0
"instateroom",0,11,5,6,0
"pethanegracast",0,14,5,9,0
"hubman",0,6,2,4,0
"hemapo",0,6,3,3,0
"gchilvilly",0,10,2,8,0
"ougamy",1,6,3,3,0
"butleresses",0,11,4,7,0
"cemitaur",0,8,4,4,0
"physicobiological",1,17,7,10,0
"berytidae",1,9,4,5,0
"provocation",1,11,5,6,0
"ingleneuks",1,10,4,6,0
"bailee",1,6,4,2,0
"postadolescences",1,16,6,10,0
"ananite",1,7,4,3,0
"mahatmas",1,8,3,5,0
"teco",1,4,2,2,0
"horsemongers",0,12,4,8,0
"epidote",1,7,4,3,0
"mesoparapteron",1,14,6,8,0
"decivilizing",0,12,5,7,0
"fingerpaints",1,12,4,8,0
"presurmises",1,11,4,7,0
"phras",0,5,1,4,0
"dation",0,6,3,3,0
"apfelstadt",1,10,3,7,0
"ludovico",1,8,4,4,0
"munwarconwg",0,11,3,8,0
"cmzfll",0,6,0,6,0
"gqpaodrn'weozsffqswgr",0,21,4,17,1
"trus",0,4,1,3,0
"cariniana",1,9,5,4,0
"raddi",1,5,2,3,0
"beelting",0,8,3,5,0
"outbury",0,7,3,4,0
"yellowknife",1,11,4,7,0
"formulisms",1,10,3,7,0
"fultioncoologuebartetowzi",0,25,12,13,0
"noodi",0,5,3,2,0
"jerma",0,5,2,3,0
"alco",1,4,2,2,0
"galactometeor",0,13,6,7,0
"gazeucitroganders",0,17,7,10,0
"melloni",0,7,3,4,0
"redeploy",1,8,3,5,0
"hintonesis",0,10,4,6,0
"buckshee",1,8,3,5,0
"qmywafaphv",0,10,2,8,0
"infeighterede",0,13,6,7,0
"hardress",0,8,2,6,0
"hom",1,3,1,2,0
"dolgeville",1,10,4,6,0
"nonrecombinant",1,14,5,9,0
"glm",0,3,0,3,0
"hisqunkoky'rbckweft'mzj'nab",0,27,5,22,3
"qumellie",0,8,4,4,0
"oebatbowjsjunshidxbdmli",0,23,7,16,0
"cangr",0,5,1,4,0
"subdeb",1,6,2,4,0
"casecreate",0,10,5,5,0
"chauncing",1,9,3,6,0
"nonychial",0,9,3,6,0
"cqlzpoirqqtbamrgvjznnmujnmagub",0,30,6,24,0
"constocytosigmativiolaptings",0,28,10,18,0
"fusted",0,6,2,4,0
"woodilurism",0,11,5,6,0
"ooblast",1,7,3,4,0
"alicrande",0,9,4,5,0
"interlocutor",1,12,5,7,0
"bechet",1,6,2,4,0
"eltx",0,4,1,3,0
"seleness",0,8,3,5,0
"nemus",0,5,2,3,0
"tegumentum",1,10,4,6,0
"forklifted",1,10,3,7,0
"nytgtzpvnv",0,10,0,10,0
"hector",1,6,2,4,0
"pyreantesquirer",0,15,6,9,0
"undaily",1,7,3,4,0
"friendship",1,10,3,7,0
"skarless",0,8,2,6,0
"phantic",1,7,2,5,0
"filiety",1,7,3,4,0
"iodis",0,5,3,2,0
"wrjjqzlf",0,8,0,8,0
"underwheels",0,11,4,7,0
"renal",1,5,2,3,0
"didders",1,7,2,5,0
"dzqm'iqbpfjlf",0,13,1,12,1
"proctoral",1,9,3,6,0
"unsymbolineariehs",0,17,7,10,0
"elite",1,5,3,2,0
"fiestralits",0,11,4,7,0
"fenelton",1,8,3,5,0
"vitilitigated",1,13,6,7,0
"footyphytes",0,11,3,8,0
"semiradicalness",1,15,6,9,0
"kuroshio",1,8,4,4,0
"toponymic",1,9,3,6,0
"rosemonopolis",0,13,6,7,0
"asyurelantitiscrystervicelournut",0,32,12,20,0
"rechesentheimpianonoralengs",0,27,11,16,0
"photome",0,7,3,4,0
"swp'bsi'ai",0,10,3,7,2
"keyport",1,7,2,5,0
"peremma",0,7,3,4,0
"sobersidedness",1,14,5,9,0
"retrude",1,7,3,4,0
"afterwit",1,8,3,5,0
"barbecue",1,8,4,4,0
"simule",1,6,3,3,0
"ravaw",0,5,2,3,0
"muckworm",1,8,2,6,0
"voltmentonists",0,14,4,10,0
"commemorational",1,15,7,8,0
"epispadiases",0,12,6,6,0
"orrices",1,7,3,4,0
"etudes",1,6,3,3,0
"oredly",0,6,2,4,0
"scribbleomania",1,14,6,8,0
"misferon",0,8,3,5,0
"multicausality",0,14,6,8,0
"rumaki",1,6,3,3,0
"hesperiphona",1,12,5,7,0
"vapidnesses",1,11,4,7,0
"garners",1,7,2,5,0
"stemonous",0,9,4,5,0
"petroleous",1,10,5,5,0
"bridapona",0,9,4,5,0
"l'oreal",1,7,3,4,1
"cundiflorales",0,13,5,8,0
"benenstein",0,10,4,6,0
"qutownctialap",0,13,5,8,0
"insolubilisation",1,16,8,8,0
"apind",0,5,2,3,0
"ddis",0,4,1,3,0
"reblame",1,7,3,4,0
"nbckrkjvt'",0,10,0,10,1
"pickier",1,7,3,4,0
"brusha",0,6,2,4,0
"meneers",1,7,3,4,0
"windraminia",0,11,5,6,0
"opisthodomus",1,12,5,7,0
"syverson",1,8,2,6,0
"devlen",1,6,2,4,0
"inarguable",1,10,5,5,0
"ultraradically",0,14,5,9,0
"eutaxite",1,8,5,3,0
"overcommunication",1,17,8,9,0
"redrives",1,8,3,5,0
"flumish",0,7,2,5,0
"artensively",0,11,4,7,0
"capulation",0,10,5,5,0
"wirebird",1,8,3,5,0
"slaister",1,8,3,5,0
"chuoy",0,5,2,3,0
"colourtype",1,10,4,6,0
"seriolations",0,12,6,6,0
"turrile",0,7,3,4,0
"vseevzxwrzw",0,11,2,9,0
"bpmwofmrunyrpy",0,14,2,12,0
"kyprbucleshapt",0,14,3,11,0
"classman",1,8,2,6,0
"imod'cbuhvozrmnuxvr",0,19,5,14,1
"burnish",1,7,2,5,0
"veringriunvinton",0,16,6,10,0
"ackneys",0,7,2,5,0
"raropis",0,7,3,4,0
"blankety",1,8,2,6,0
"canistota",1,9,4,5,0
"cyberpunk",1,9,2,7,0
"tonganoxie",1,10,5,5,0
"pampination",1,11,5,6,0
"preedit",1,7,3,4,0
"deflatform",0,10,3,7,0
"miermal",0,7,3,4,0
"uncoifed",1,8,4,4,0
"maxatawny",1,9,3,6,0
"pandreidls",0,10,3,7,0
"shermanesque",1,12,5,7,0
"hetaerist",1,9,4,5,0
"elenchize",1,9,4,5,0
"patrocities",0,11,5,6,0
"nitrogenergirlfried",0,19,7,12,0
"scopate",1,7,3,4,0
"disciss",0,7,2,5,0
"toski",0,5,2,3,0
"ooscicidalskabomarfis",0,21,9,12,0
"cannelated",1,10,4,6,0
"chou",1,4,2,2,0
"monsterhood",1,11,4,7,0
"bunbury",1,7,2,5,0
"hhubt'usqdbugmbjqgdvdhqhuocay",0,29,6,23,1
"hippolytungstate",0,16,5,11,0
"scltgwkhelbeeopmu",0,17,5,12,0
"lithr",0,5,1,4,0
"senatia",0,7,4,3,0
"opisthenar",1,10,4,6,0
"varmint",1,7,2,5,0
"somniloquentness",0,16,6,10,0
"weslophy",0,8,2,6,0
"sphegidae",1,9,4,5,0
"amahorocame",0,11,6,5,0
"triaster",1,8,3,5,0
"scalz",1,5,1,4,0
"wianipigavasequmoravepholiondasuci",0,34,17,17,0
"hackman",1,7,2,5,0
"jaimie",1,6,4,2,0
"years",1,5,2,3,0
"skixwonofbxpbsr",0,15,3,12,0
"entiat",1,6,3,3,0
"tredecillion",1,12,5,7,0
"lavqorplswghnjuseohldhqroo",0,26,7,19,0
"prologing",1,9,3,6,0
"baler",1,5,2,3,0
"mfumbit'lrj'vovnqacy'wlqrdrayf",0,30,5,25,3
"amaliladurisenians",0,18,9,9,0
"motioner",1,8,4,4,0
"forestaysail",1,12,5,7,0
"orsini",1,6,3,3,0
"gynarchy",1,8,1,7,0
"mascularises",0,12,5,7,0
"sntove",0,6,2,4,0
"cannibals",1,9,3,6,0
"mendebsing",0,10,3,7,0
"mushaa",1,6,3,3,0
"hloplkmtczjemxzqxsbqgssvsqk",0,27,2,25,0
"phlebology",1,10,3,7,0
"vappes",0,6,2,4,0
"dunker",1,6,2,4,0
"atevecinittretighos",0,19,8,11,0
"twangings",1,9,2,7,0
"germinable",1,10,4,6,0
"mouthedly",0,9,3,6,0
"homoeochromate",0,14,7,7,0
"unchulle",0,8,3,5,0
"lackeyed",1,8,3,5,0
"cheerlessness",1,13,4,9,0
"rotal",1,5,2,3,0
"lilojhoaezibmbr",0,15,6,9,0
"cloisterellos",0,13,5,8,0
"systoles",1,8,2,6,0
"aga",1,3,2,1,0
"bleaks",1,6,2,4,0
"slatemaker",1,10,4,6,0
"anamiter",0,8,4,4,0
"dopantioutiona",0,14,8,6,0
"cassioners",0,10,4,6,0
"cnftdbcyyc",0,10,0,10,0
"gmeaau'",0,7,4,3,1
"unseraphical",1,12,5,7,0
"hospropiper",0,11,4,7,0
"thy",1,3,0,3,0
"regule",0,6,3,3,0
"buvety",0,6,2,4,0
"malfeasor",1,9,4,5,0
"zaptist",0,7,2,5,0
"phrenes",0,7,2,5,0
"sottiaccar",0,10,4,6,0
"binocular",1,9,4,5,0
"opaline",1,7,4,3,0
"polymixiidae",1,12,6,6,0
"tunicumnus",0,10,4,6,0
"yijdyvljplex",0,12,2,10,0
"corcaseigh",0,10,4,6,0
"xorhziogzbn",0,11,3,8,0
"fistics",0,7,2,5,0
"cabrfalalnhamanonfovisly",0,24,8,16,0
"resails",1,7,3,4,0
"ctrs",0,4,0,4,0
"zfqysbaettcijlfairqavquydk",0,26,7,19,0
"oaklawn",1,7,3,4,0
"unclarity",1,9,3,6,0
"supratrochlear",1,14,5,9,0
"convolypocryosalling",0,20,6,14,0
"gibsonburg",1,10,3,7,0
"ngleauremadamr",0,14,6,8,0
"prouloettes",0,11,5,6,0
"geodesy",1,7,3,4,0
"gynaecocratic",1,13,5,8,0
"zacharia",1,8,4,4,0
"indully",0,7,2,5,0
"sitaiverscofterpsone",0,20,8,12,0
"varietotoluentialis",0,19,10,9,0
"bazzazz",0,7,2,5,0
"inatrbkilem",0,11,4,7,0
"repaper",1,7,3,4,0
"upo'xkhacjee",0,12,5,7,1
"bulid",0,5,2,3,0
"manilas",1,7,3,4,0
"laree",1,5,3,2,0
"undervaulting",1,13,5,8,0
"roceous",0,7,4,3,0
"reminegraveless",0,15,6,9,0
"foreseau",0,8,5,3,0
"stertorious",1,11,5,6,0
"abatjour",1,8,4,4,0
"ngelishod",0,9,3,6,0
"radars",1,6,2,4,0
"helquje",0,7,3,4,0
"entaculli",0,9,4,5,0
"qczrpxvoxeu",0,11,3,8,0
"heortologion",1,12,6,6,0
"lithite",1,7,3,4,0
"santini",1,7,3,4,0
"gabbed",1,6,2,4,0
"missu",0,5,2,3,0
"unexpectable",1,12,5,7,0
"alulosurioplaba",0,15,8,7,0
"beneighbored",1,12,5,7,0
"lwl",1,3,0,3,0
"unmalignant",1,11,4,7,0
"shopharyngonasa",0,15,5,10,0
"trian",0,5,2,3,0
"blticowoo",0,9,4,5,0
"brummie",1,7,3,4,0
"dirige",1,6,3,3,0
"tremendousness",1,14,5,9,0
"firelit",1,7,3,4,0
"sacramentariness",0,16,6,10,0
"expositresses",1,13,5,8,0
"kk",0,2,0,2,0
"'veutz'yf'w'mf",0,14,2,12,4
"atiptoe",1,7,4,3,0
"kelayre",0,7,3,4,0
"shily",1,5,1,4,0
"callused",1,8,3,5,0
"bevomite",0,8,4,4,0
"verdit",1,6,2,4,0
"almerrined",0,10,4,6,0
"citriculturists",1,15,5,10,0
"uezhkirpbwcvo",0,13,4,9,0
"promorouvassurin",0,16,7,9,0
"mussolini",1,9,4,5,0
"rosential",0,9,4,5,0
"hingerbreeder",0,13,5,8,0
"mucilaginae",0,11,6,5,0
"neurorthoptera",1,14,6,8,0
"heterokaryosis",1,14,6,8,0
"auxograph",1,9,4,5,0
"chemoserotherapy",1,16,6,10,0
"wigless",1,7,2,5,0
"fantisferrel",0,12,4,8,0
"emporidenhurrin",0,15,6,9,0
"hagiolater",1,10,5,5,0
"wokenetrun",0,10,4,6,0
"windians",0,8,3,5,0
"nondeciduata",1,12,6,6,0
"britannicus",1,11,4,7,0
"clappress",0,9,2,7,0
"pron",0,4,1,3,0
"betfbidogesoperpemiuminesphd",0,28,11,17,0
"preinterreign",0,13,5,8,0
"caeijcfcmqnul'",0,14,4,10,1
"rys",0,3,0,3,0
"kingfisher",1,10,3,7,0
"rejacketier",0,11,5,6,0
"monregarting",0,12,4,8,0
"uyvvjgsggaktdwgev",0,17,3,14,0
"blatchang",1,9,2,7,0
"joineral",0,8,4,4,0
"connectors",1,10,3,7,0
"interpretableness",1,17,6,11,0
"samessability",0,13,5,8,0
"jamator",0,7,3,4,0
"underpaying",1,11,4,7,0
"wedron",1,6,2,4,0
"hastened",1,8,3,5,0
"brachygrapher",1,13,3,10,0
"tentily",1,7,2,5,0
"diapherome",0,10,5,5,0
"maunch",1,6,2,4,0
"antinoma",0,8,4,4,0
"transvaluer",1,11,4,7,0
"ferrals",0,7,2,5,0
"gribirobistitypirubbertaridgeemocyograseming",0,44,17,27,0
"spellcheck",1,10,2,8,0
"nwp'qyivuc",0,10,2,8,1
"mvssafroevotacy",0,15,5,10,0
"saccharobacillus",1,16,6,10,0
"outbore",1,7,4,3,0
"maxilliped",1,10,4,6,0
"dovehouseman",0,12,6,6,0
"ochrana",1,7,3,4,0
"anilao",1,6,4,2,0
"unpurian",0,8,4,4,0
"pinfolds",1,8,2,6,0
"bromoisie",0,9,5,4,0
"utsan",0,5,2,3,0
"shoetroxime",0,11,5,6,0
"javelining",1,10,4,6,0
"ununified",1,9,5,4,0
"bornites",1,8,3,5,0
"hocumangors",0,11,4,7,0
"asness",0,6,2,4,0
"rial",1,4,2,2,0
"enesids",0,7,3,4,0
"centralisers",1,12,4,8,0
"'fcoextqfjzidd",0,14,3,11,1
"absorber",1,8,3,5,0
"atmolybdenia",0,12,5,7,0
"unmacer",0,7,3,4,0
"innuits",1,7,3,4,0
"arein",0,5,3,2,0
"subillerprollowwales",0,20,7,13,0
"salvia",1,6,3,3,0
"mutums",0,6,2,4,0
"communism",1,9,3,6,0
"umbraculum",1,10,4,6,0
"epitously",0,9,4,5,0
"prophylactodontist",1,18,5,13,0
"almoindexing",0,12,5,7,0
"antecedence",1,11,5,6,0
"galvaniser",1,10,4,6,0
"hatchettolite",1,13,5,8,0
"gier",0,4,2,2,0
"apleta",0,6,3,3,0
"osteostixis",1,11,5,6,0
"lppyjqfagge",0,11,2,9,0
"epigraphies",1,11,5,6,0
"lacunulose",1,10,5,5,0
"abola",0,5,3,2,0
"embra",0,5,2,3,0
"lacar",0,5,2,3,0
"ateste",1,6,3,3,0
"endosiphonate",1,13,6,7,0
"theolatrous",1,11,5,6,0
"sualistiastres",0,14,6,8,0
"jlrvgygqddbcq",0,13,0,13,0
"neckties",1,8,3,5,0
"stic",0,4,1,3,0
"meditatedly",1,11,4,7,0
"lichenography",1,13,4,9,0
"hotshot",1,7,2,5,0
"amboyna",1,7,3,4,0
"'vvxhl'zmgvfislfhkdozczm",0,24,2,22,2
"highboys",1,8,2,6,0
"suce",0,4,2,2,0
"endogastritis",1,13,5,8,0
"unformularize",1,13,6,7,0
"cotid",0,5,2,3,0
"saucissoidal",0,12,6,6,0
"baukaeim'gwocswdiom",0,19,8,11,1
"benge",1,5,2,3,0
"autoimmunities",1,14,8,6,0
"sapphist",1,8,2,6,0
"lockeanism",1,10,4,6,0
"hmkhkf'uomporwiwny",0,18,4,14,1
"phenytoin",1,9,3,6,0
"oneshy",0,6,2,4,0
"ghethfundrial",0,13,4,9,0
"adjoin",1,6,3,3,0
"pibermardale",0,12,5,7,0
"anomerelia",0,10,6,4,0
"orthid",1,6,2,4,0
"cheesecutor",0,11,5,6,0
"ralph",1,5,1,4,0
"outcrying",1,9,3,6,0
"phogal",0,6,2,4,0
"cults",0,5,1,4,0
"rubbit",1,6,2,4,0
"murtaugh",1,8,3,5,0
"bathinette",1,10,4,6,0
"blunda",0,6,2,4,0
"jinglebob",1,9,3,6,0
"paralyse",1,8,3,5,0
"z'omtocakcqg",0,12,3,9,1
"rhythmy",0,7,0,7,0
"sticharions",1,11,4,7,0
"duckboards",1,10,3,7,0
"parvati",1,7,3,4,0
"inoul",0,5,3,2,0
"thoroughgang",0,12,4,8,0
"thanadarko",0,10,4,6,0
"protensional",0,12,5,7,0
"irascibilities",1,14,7,7,0
"thermoreceptor",1,14,5,9,0
"repeal",1,6,3,3,0
"pottering",1,9,3,6,0
"ernerboaria",0,11,6,5,0
"fearer",1,6,3,3,0
"knaster",1,7,2,5,0
"widerately",0,10,4,6,0
"mperes",0,6,2,4,0
"dyirbals",1,8,2,6,0
"overpraise",1,10,5,5,0
"intrepidity",1,11,4,7,0
"vadsore",0,7,3,4,0
"petfood",1,7,3,4,0
"snaillas",0,8,3,5,0
"nobic",0,5,2,3,0
"eny",0,3,1,2,0
"reimprovement",1,13,5,8,0
"phocammerists",0,13,4,9,0
"cclqa",0,5,1,4,0
"pargethishidrads",0,16,5,11,0
"smokeboards",1,11,4,7,0
"proacademic",1,11,5,6,0
"unfattenishment",0,15,5,10,0
"unrichlian",0,10,4,6,0
"pinkeyes",1,8,3,5,0
"thrum",1,5,1,4,0
"hookswingings",0,13,4,9,0
"xanthopsin",1,10,3,7,0
"agroindustries",1,14,6,8,0
"wavefronting",0,12,4,8,0
"romethpans",0,10,3,7,0
"sehllyprongrobegron",0,19,5,14,0
"labournmenta",0,12,5,7,0
"hemationisate",0,13,7,6,0
"dockinders",0,10,3,7,0
"jerrymander",1,11,3,8,0
"grigioni",1,8,4,4,0
"overfaithful",1,12,5,7,0
"hyetometrographic",1,17,6,11,0
"paupered",1,8,4,4,0
"breadnesses",0,11,4,7,0
"sydneysider",1,11,3,8,0
"pecherg",0,7,2,5,0
"abadejo",1,7,4,3,0
"kzvjsyi'f'ghmcvbgvurqua",0,23,4,19,2
"akra",1,4,2,2,0
"presong",1,7,2,5,0
"siberson",1,8,3,5,0
"intice",1,6,3,3,0
"unsulfureousness",1,16,7,9,0
"comor",0,5,2,3,0
"picea",1,5,3,2,0
"racefulness",0,11,4,7,0
"glower",1,6,2,4,0
"nmadjqdnpbanmwxif",0,17,3,14,0
"aquanautics",1,11,6,5,0
"hmfqkpmeqzomnzkhwiqryvirokbqz",0,29,5,24,0
"tootsie",1,7,4,3,0
"delegatees",1,10,5,5,0
"boilermaking",1,12,5,7,0
"frutex",1,6,2,4,0
"zoehemertificatedly",0,19,8,11,0
"chrysopidae",1,11,4,7,0
"ulitises",1,8,4,4,0
"sallowings",0,10,3,7,0
"orchesography",1,13,4,9,0
"noncapital",1,10,4,6,0
"ardoch",1,6,2,4,0
"soundboard",1,10,4,6,0
"dpedeniq",0,8,3,5,0
"insures",1,7,3,4,0
"ferrocking",0,10,3,7,0
"isorberatology",0,14,6,8,0
"fistiaro",0,8,4,4,0
"pseudoscines",1,12,5,7,0
"effectively",1,11,4,7,0
"ebldmba'bni'wout",0,16,5,11,2
"spammiest",1,9,3,6,0
"vacationland",1,12,5,7,0
"latensifier",0,11,5,6,0
"hare",1,4,2,2,0
"allot",1,5,2,3,0
"brownson",1,8,2,6,0
"gillie",1,6,3,3,0
"ultracelsic",0,11,4,7,0
"xjuswuqluwdc'dgwmv'm",0,20,3,17,2
"oceanology",1,10,5,5,0
"yaai",0,4,3,1,0
"slouchily",1,9,3,6,0
"assubjugated",1,12,5,7,0
"'rltnqtautgbgmdisl",0,18,3,15,1
"aquiculturation",0,15,8,7,0
"kopiation",0,9,5,4,0
"somnambulous",1,12,5,7,0
"psychology",1,10,2,8,0
"csdecnlcrjti",0,12,2,10,0
"unynnvvroovv'y",0,14,3,11,1
"annin",0,5,2,3,0
"toevnruv'z'kg",0,13,3,10,2
"spirtle",1,7,2,5,0
"predevelopments",1,15,5,10,0
"statins",1,7,2,5,0
"autarch",1,7,3,4,0
"kakapo",1,6,3,3,0
"electure",0,8,4,4,0
"nkchtiz'g",0,9,1,8,1
"misenta",0,7,3,4,0
"yelk",1,4,1,3,0
"uacpyvfwpfawfn",0,14,3,11,0
"lacies",0,6,3,3,0
"vouchscreectopaths",0,18,6,12,0
"saloonkeeper",1,12,6,6,0
"salicornians",0,12,5,7,0
"relicensed",1,10,4,6,0
"deltahedra",1,10,4,6,0
"zebrinny",1,8,2,6,0
"mojaved",0,7,3,4,0
"epiloguising",1,12,6,6,0
"corillstice",0,11,4,7,0
"vigenish",0,8,3,5,0
"penic",0,5,2,3,0
"phytalus",1,8,2,6,0
"rwutxbgfilzvdm",0,14,2,12,0
"zizania",1,7,4,3,0
"antithetics",1,11,4,7,0
"tridell",1,7,2,5,0
"straightforwards",1,16,4,12,0
"lationary",0,9,4,5,0
"helivints",0,9,3,6,0
"fyzuriuobrucinaxt",0,17,7,10,0
"lallands",1,8,2,6,0
"oraconic",0,8,4,4,0
"drabbier",1,8,3,5,0
"splagiarine",0,11,5,6,0
"yemasser",0,8,3,5,0
"reprivish",0,9,3,6,0
"maceously",0,9,4,5,0
"epithetical",1,11,5,6,0
"chtestangrbashitlayamarinexhoa",0,30,11,19,0
"vnn'qjipnbfgrvjjjyfa",0,20,2,18,1
"thollespes",0,10,3,7,0
"artdolhblnzfogd",0,15,3,12,0
"muzak",1,5,2,3,0
"maintenance",1,11,5,6,0
"airville",1,8,4,4,0
"underlayment",1,12,4,8,0
"radiodiagnosis",1,14,7,7,0
"intersalvable",0,13,5,8,0
"afterhand",1,9,3,6,0
"pite",0,4,2,2,0
"angiocardiography",1,17,7,10,0
"aposis",0,6,3,3,0
"catguts",1,7,2,5,0
"antulcaellia",0,12,6,6,0
"teratism",1,8,3,5,0
"scribner",1,8,2,6,0
"homesteadings",1,13,5,8,0
"jouachals",0,9,4,5,0
"factorisations",1,14,6,8,0
"zmkolnodinlqjnjllrgpsb",0,22,3,19,0
"kowals",0,6,2,4,0
"miscellanea",1,11,5,6,0
"cobblery",1,8,2,6,0
"ntiunc",0,6,2,4,0
"gosport",1,7,2,5,0
"electrocatalysis",1,16,6,10,0
"leptochloride",0,13,5,8,0
"pizzelle",1,8,3,5,0
"homeowner",1,9,4,5,0
"aphoconightombae",0,16,7,9,0
"ingpvakfdewwem",0,14,4,10,0
"gnotobiograph",0,13,5,8,0
"psionics",1,8,3,5,0
"carangidae",1,10,5,5,0
"brachydactyly",1,13,2,11,0
"sorriness",1,9,3,6,0
"cavendish",1,9,3,6,0
"dhekelia",1,8,4,4,0
"quipu",1,5,3,2,0
"nonfactious",1,11,5,6,0
"diestock",1,8,3,5,0
"baaskaap",1,8,4,4,0
"vividest",1,8,3,5,0
"dinnie",1,6,3,3,0
"cuseentzindsmos",0,15,5,10,0
"septentational",0,14,6,8,0
"lcaihhgbrzn",0,11,2,9,0
"bequily",0,7,3,4,0
"pched",0,5,1,4,0
"costae",1,6,3,3,0
"pressel",1,7,2,5,0
"hive",1,4,2,2,0
"ationter",0,8,4,4,0
"redefield",0,9,4,5,0
"swarming",1,8,2,6,0
"jjlqtmjxlnhamjiqskc",0,19,2,17,0
"supertension",1,12,5,7,0
"knuckleballer",1,13,4,9,0
"nonextreme",1,10,4,6,0
"chamal",1,6,2,4,0
"electrobiologist",1,16,7,9,0
"trsyfy",0,6,0,6,0
"selealy",0,7,3,4,0
"motuca",1,6,3,3,0
"enlanklephrear",0,14,5,9,0
"skapat",0,6,2,4,0
"eute",0,4,3,1,0
"nondelsson",0,10,3,7,0
"limulagurdredless",0,17,6,11,0
"mutiniant",0,9,4,5,0
"nonobjections",0,13,5,8,0
"conograuncompressnessnessers",0,28,9,19,0
"moylarcquelittellayodepopechoslart",0,34,13,21,0
"madanis",0,7,3,4,0
"hexabiblos",1,10,4,6,0
"toadflaxes",1,10,4,6,0
"codeveloping",1,12,5,7,0
"grologyn",0,8,2,6,0
"antiphyllum",0,11,3,8,0
"zoophobias",1,10,5,5,0
"gloomeris",0,9,4,5,0
"rudulph",1,7,2,5,0
"sergelisol",0,10,4,6,0
"superluminal",1,12,5,7,0
"saddletownsend",0,14,4,10,0
"repropoeinteritominess",0,22,10,12,0
"defoliates",1,10,5,5,0
"flowerist",1,9,3,6,0
"aslatrulan",0,10,4,6,0
"cardiolysis",1,11,4,7,0
"qns",1,3,0,3,0
"consecertuan",0,12,5,7,0
"intersina",0,9,4,5,0
"triglandular",1,12,4,8,0
"reencountrifixation",0,19,9,10,0
"karela",1,6,3,3,0
"ringsmuth",1,9,2,7,0
"urothicatfulleprous",0,19,8,11,0
"eriodictyon",1,11,5,6,0
"carcinogenesis",1,14,6,8,0
"nonthreaded",1,11,4,7,0
"pmormoerscol",0,12,4,8,0
"othy",0,4,1,3,0
"onoplg",0,6,2,4,0
"cueist",1,6,3,3,0
"superfuses",1,10,4,6,0
"forebodes",1,9,4,5,0
"tintinnabulata",0,14,6,8,0
"aidos",1,5,3,2,0
"chalbootter",0,11,4,7,0
"nephroncus",1,10,3,7,0
"bumbags",1,7,2,5,0
"kuris",1,5,2,3,0
"herbivorousness",1,15,6,9,0
"rosava",0,6,3,3,0
"ckechatul",0,9,3,6,0
"odelle",1,6,3,3,0
"tkdeejuhhzkbvfpsu'kvskteoim",0,27,7,20,1
"deration",0,8,4,4,0
"apriorists",1,10,4,6,0
"composal",0,8,3,5,0
"bridegroom",1,10,4,6,0
"fjshraixvkfcubexxuf",0,19,5,14,0
"ovtadryfyem",0,11,3,8,0
"parrely",0,7,2,5,0
"descheapsidiosmothymatiably",0,27,10,17,0
"deponing",1,8,3,5,0
"despotist",1,9,3,6,0
"remajum",0,7,3,4,0
"zascryt'kaf'le",0,14,3,11,2
"polyme",0,6,2,4,0
"wear",1,4,2,2,0
"shniusettionavotivent",0,21,9,12,0
"mogztvdgbgfezgeg",0,16,3,13,0
"infuneral",1,9,4,5,0
"rak",0,3,1,2,0
"extollingly",1,11,3,8,0
"lametrymentar",0,13,4,9,0
"arbutin",1,7,3,4,0
"laparosplenotomy",1,16,6,10,0
"slockens",1,8,2,6,0
"bitonal",1,7,3,4,0
"qjzdkypyld",0,10,0,10,0
"tues",1,4,2,2,0
"pter",0,4,1,3,0
"nonacquiescement",0,16,7,9,0
"zack",1,4,1,3,0
"muinospisiarteamea",0,18,10,8,0
"aurofocunder",0,12,6,6,0
"pitchfields",0,11,3,8,0
"zrivj'acdrsmtakxppig'",0,21,4,17,2
"lanific",1,7,3,4,0
"ditary",0,6,2,4,0
"pedestrianises",1,14,6,8,0
"chrygonikkim",0,12,3,9,0
"rhea",1,4,2,2,0
"ragley",1,6,2,4,0
"acyetic",1,7,3,4,0
"basoga",1,6,3,3,0
"cesqutttinansus",0,15,5,10,0
"laurister",0,9,4,5,0
"nectar",1,6,2,4,0
"nonprotectively",1,15,5,10,0
"rponmsibludie",0,13,5,8,0
"biogenetical",1,12,6,6,0
"sepiidae",1,8,5,3,0
"renested",1,8,3,5,0
"masty",0,5,1,4,0
"bles",0,4,1,3,0
"uncatastrophically",1,18,6,12,0
"sandplayda",0,10,3,7,0
"nestories",0,9,4,5,0
"administ",0,8,3,5,0
"mastocarpous",0,12,5,7,0
"survivers",1,9,3,6,0
"kamik",1,5,2,3,0
"algeria",1,7,4,3,0
"dinitrile",1,9,4,5,0
"bonelis",0,7,3,4,0
"plenipotentiarize",1,17,8,9,0
"z'lj",0,4,0,4,1
"boorhydromoroupole",0,18,8,10,0
"dectopodishingcgir",0,18,6,12,0
"angikragaphenuneras",0,19,8,11,0
"pomance",0,7,3,4,0
"urgers",1,6,2,4,0
"recordial",0,9,4,5,0
"sper",0,4,1,3,0
"balabsolinatting",0,16,6,10,0
"sbexiongova",0,11,5,6,0
"cgpxifkq'yxic",0,13,2,11,1
"kenesaw",1,7,3,4,0
"probwehr",0,8,2,6,0
"aegopodium",1,10,6,4,0
"jesher",1,6,2,4,0
"parame",0,6,3,3,0
"glossia",0,7,3,4,0
"pfannkuchen",1,11,3,8,0
"grotianism",1,10,4,6,0
"prismation",0,10,4,6,0
"mceounkingmonalanta",0,19,8,11,0
"lutheranism",1,11,4,7,0
"fulettis",0,8,3,5,0
"p'ujyee'qhsof",0,13,4,9,2
"esqueakproofe",0,13,7,6,0
"jalous",0,6,3,3,0
"junyc",0,5,1,4,0
"rzaykshkzggfhrzn",0,16,1,15,0
"meffie",0,6,3,3,0
"mantell",1,7,2,5,0
"senoliadintmy",0,13,5,8,0
"jettisoning",1,11,4,7,0
"laingian",1,8,4,4,0
"unascertainably",1,15,6,9,0
"coapers",0,7,3,4,0
"dayshine",1,8,3,5,0
"glot",0,4,1,3,0
"chaete",0,6,3,3,0
"unaciousness",0,12,6,6,0
"allanky",0,7,2,5,0
"sharawadgi",1,10,4,6,0
"maturaps",0,8,3,5,0
"domeleis",0,8,4,4,0
"uplong",1,6,2,4,0
"superacoochoisters",0,18,8,10,0
"alar",1,4,2,2,0
"oculously",0,9,4,5,0
"collinsia",1,9,4,5,0
"condely",0,7,2,5,0
"camerata",1,8,4,4,0
"underhangman",1,12,4,8,0
"rthos",0,5,1,4,0
"jigin",0,5,2,3,0
"zdvyhbc",0,7,0,7,0
"lasomitecrmerale",0,16,7,9,0
"wlrrsxjpnvqvnh'n",0,16,0,16,1
"euscaro",1,7,4,3,0
"gintopenagholiba",0,16,7,9,0
"rasion",1,6,3,3,0
"sicksburg",0,9,2,7,0
"roughly",1,7,2,5,0
"parotid",1,7,3,4,0
"aculable",0,8,4,4,0
"corridos",1,8,3,5,0
"valvotomy",1,9,3,6,0
"ined",0,4,2,2,0
"vizardedness",0,12,4,8,0
"inogeneses",0,10,5,5,0
"puppodum",1,8,3,5,0
"snamiotini",0,10,5,5,0
"fonginck",0,8,2,6,0
"mafaayh'jldqq'urdngbkzadmtshg",0,29,5,24,2
"eglency",0,7,2,5,0
"diborate",1,8,4,4,0
"natrix",1,6,2,4,0
"nonrumir",0,8,3,5,0
"teseparanaciceeus",0,17,9,8,0
"hanae",1,5,3,2,0
"acise",0,5,3,2,0
"angelian",0,8,4,4,0
"opharlates",0,10,4,6,0
"mimeoned",0,8,4,4,0
"lathiophenonerrably",0,19,7,12,0
"ulbeck",0,6,2,4,0
"chy",0,3,0,3,0
"skivi",0,5,2,3,0
"homotransplants",1,15,4,11,0
"philatelism",1,11,4,7,0
"lunge",1,5,2,3,0
"phalyanodocalon",0,15,6,9,0
"yogity",0,6,2,4,0
"ultrabasic",1,10,4,6,0
"knoll",1,5,1,4,0
"musicianship",1,12,5,7,0
"weatogue",1,8,5,3,0
"colonnade",1,9,4,5,0
"nanotes",0,7,3,4,0
"repartiemolotiogua",0,18,10,8,0
"desacralisation",1,15,7,8,0
"boobie",1,6,4,2,0
"evertebrata",1,11,5,6,0
"redemanding",0,11,4,7,0
"provitamine",0,11,5,6,0
"dese",0,4,2,2,0
"seceder",1,7,3,4,0
"rzvyyxbpjvoqzmuiu",0,17,4,13,0
"typifier",1,8,3,5,0
"epeolatries",1,11,6,5,0
"begetting",1,9,3,6,0
"bvbuuwrvdypessfwbfcvtj",0,22,3,19,0
"preinsinuating",1,14,6,8,0
"rigmarolist",0,11,4,7,0
"phyleus",1,7,2,5,0
"neatened",1,8,4,4,0
"unfertally",0,10,3,7,0
"aliaceae",0,8,6,2,0
"rouserie",0,8,5,3,0
"lotocks",0,7,2,5,0
"cosaurinted",0,11,5,6,0
"huntiegowks",1,11,4,7,0
"metereforman",0,12,5,7,0
"jamblis",0,7,2,5,0
"cnufsneitw'rmwrltv",0,18,3,15,1
"swashbuckler",1,12,3,9,0
"hemelyttra",1,10,3,7,0
"pancreatotomies",1,15,7,8,0
"carednesqual",0,12,5,7,0
"puddingberry",1,12,3,9,0
"surrena",0,7,3,4,0
"serology",1,8,3,5,0
"gless",0,5,1,4,0
"quadruplexing",1,13,5,8,0
"introspectionist",1,16,6,10,0
"fiches",1,6,2,4,0
"nontyrannical",1,13,4,9,0
"chittering",1,10,3,7,0
"arbovale",1,8,4,4,0
"'zfkfujqajq",0,11,2,9,1
"puncerighastiones",0,17,7,10,0
"battalie",0,8,4,4,0
"overtiming",1,10,4,6,0
"inhaustics",0,10,4,6,0
"kozdkjyvwolmyyjnpxl",0,19,2,17,0
"fbwmzibppflfhnwgciwquwj",0,23,3,20,0
"pyrodia",0,7,3,4,0
"discrepance",1,11,4,7,0
"topheling",0,9,3,6,0
"''wfyffsbrx",0,11,0,11,2
"abels",0,5,2,3,0
"wiggier",1,7,3,4,0
"whafabout",1,9,4,5,0
"haggardly",1,9,2,7,0
"nailset",1,7,3,4,0
"gissive",0,7,3,4,0
"triatoma",1,8,4,4,0
"jirery",0,6,2,4,0
"dantoid",0,7,3,4,0
"pemberton",1,9,3,6,0
"uncepallonfrouscrelenza",0,23,9,14,0
"piet",1,4,2,2,0
"plasteanephendity",0,17,6,11,0
"journey",1,7,3,4,0
"sarconstant",0,11,3,8,0
"inexivenesses",0,13,6,7,0
"cruzan",1,6,2,4,0
"vigotanises",0,11,5,6,0
"phicos",0,6,2,4,0
"fagara",1,6,3,3,0
"jshcj",0,5,0,5,0
"tonemes",1,7,3,4,0
"execrations",1,11,5,6,0
"tyndaceanolinerboardescript",0,27,10,17,0
"anaker",0,6,3,3,0
"rgabu'rlvumhcjfj",0,16,3,13,1
"faulchions",1,10,4,6,0
"assocomen",0,9,4,5,0
"unichord",0,8,3,5,0
"changedale",1,10,4,6,0
"expressmen",1,10,3,7,0
"unmisgiving",0,11,4,7,0
"undaters",0,8,3,5,0
"beling",0,6,2,4,0
"brioche",1,7,3,4,0
"neew'tqeldknswaoymwz",0,20,5,15,1
"mildew",1,6,2,4,0
"nonfarm",1,7,2,5,0
"katakinetomeric",1,15,7,8,0
"sgzbtggvnlmkuwu",0,15,2,13,0
"hinterland",1,10,3,7,0
"oryctognostically",1,17,5,12,0
"hypophoran",0,10,3,7,0
"montoya",1,7,3,4,0
"yqweabdwvjoqxu",0,14,4,10,0
"omas",0,4,2,2,0
"endocarditic",1,12,5,7,0
"web",1,3,1,2,0
"pycnichinal",0,11,3,8,0
"angelon",1,7,3,4,0
"teri",1,4,2,2,0
"hydrin",0,6,1,5,0
"ovent",0,5,2,3,0
"inabordable",1,11,5,6,0
"acrogynae",1,9,4,5,0
"taxidriver",1,10,4,6,0
"amadyddvpbaumei",0,15,6,9,0
"cowhand",1,7,2,5,0
"gwcor'nlrx'njs'iqvwdgex",0,23,3,20,3
"referableness",0,13,5,8,0
"max",1,3,1,2,0
"grannieing",1,10,4,6,0
"flodyntonchoolour",0,17,6,11,0
"vwrusycvmsqp'dhisrrnkgkp",0,24,2,22,1
"dissolvings",1,11,3,8,0
"multivagant",1,11,4,7,0
"beerothite",1,10,5,5,0
"vknyh",0,5,0,5,0
"cashilollibles",0,14,5,9,0
"librium",1,7,3,4,0
"anathmerarackerp",0,16,6,10,0
"undering",0,8,3,5,0
"hyperaeolism",1,12,5,7,0
"ordain",1,6,3,3,0
"prewardais",0,10,4,6,0
"lisulaedazlinletipanandvis",0,26,11,15,0
"haemipoeting",0,12,6,6,0
"muonic",1,6,3,3,0
"choppering",1,10,3,7,0
"hebaties",0,8,4,4,0
"unproportionably",1,16,6,10,0
"znbcqxftlsgltciiuwd",0,19,3,16,0
"acknowledgeable",1,15,6,9,0
"complimentalness",1,16,5,11,0
"hibachi",1,7,3,4,0
"pyrogallols",1,11,3,8,0
"butterblast",0,11,3,8,0
"toponymics",1,10,3,7,0
"lionist",0,7,3,4,0
"sweetroot",1,9,4,5,0
"dorsi",1,5,2,3,0
"pronuclearise",0,13,6,7,0
"dzlxqmtrctv'r",0,13,0,13,1
"sermoneutron",0,12,5,7,0
"glassport",1,9,2,7,0
"prge",0,4,1,3,0
"aaybjmgxwwopord",0,15,4,11,0
"postformly",0,10,2,8,0
"trachodont",1,10,3,7,0
"richen",1,6,2,4,0
"antinepotic",1,11,5,6,0
"soochow",1,7,3,4,0
"tragacantha",1,11,4,7,0
"xoqsuymhughqgmzieyrlge",0,22,6,16,0
"superitory",0,10,4,6,0
"spooneymous",0,11,5,6,0
"tactosol",1,8,3,5,0
"rohonoutonsmsstesmprecetota",0,27,10,17,0
"monochrons",0,10,3,7,0
"damager",1,7,3,4,0
"sovranty",1,8,2,6,0
"naian",0,5,3,2,0
"menisperm",1,9,3,6,0
"unbalancement",0,13,5,8,0
"morphically",1,11,3,8,0
"bineumamigest",0,13,6,7,0
"cataract",1,8,3,5,0
"overindividualiser",0,18,9,9,0
"pestologists",1,12,4,8,0
"sola",1,4,2,2,0
"driftwood",1,9,3,6,0
"setales",0,7,3,4,0
"percivilly",0,10,3,7,0
"tiougunilabied",0,14,8,6,0
"fabience",0,8,4,4,0
"darness",0,7,2,5,0
"dermen",0,6,2,4,0
"lophocomi",1,9,4,5,0
"ptemelaies",0,10,5,5,0
"tenn",1,4,1,3,0
"actionizing",1,11,5,6,0
"clubwoofer",0,10,4,6,0
"helene",1,6,3,3,0
"cyllenian",1,9,3,6,0
"turnback",1,8,2,6,0
"plicates",1,8,3,5,0
"voulgently",0,10,3,7,0
"nonenville",0,10,4,6,0
"retreader",0,9,4,5,0
"exasperate",1,10,5,5,0
"flesticerlee",0,12,5,7,0
"padderwentwards",0,15,4,11,0
"rdgvbp",0,6,0,6,0
"hemihydrated",1,12,4,8,0
"sharkish",1,8,2,6,0
"acetimeter",1,10,5,5,0
"aavtech",1,7,3,4,0
"press",1,5,1,4,0
"gyttich",0,7,1,6,0
"coudaredunomy",0,13,6,7,0
"roadsman",1,8,3,5,0
"sfmpgqmqffbrbwta",0,16,1,15,0
"g'wpvekybytglyxawnxgpvxyipg",0,27,3,24,1
"kytoon",1,6,2,4,0
"ahqpcmhplmglvqzw",0,16,1,15,0
"unsocketed",1,10,4,6,0
"nondesert",1,9,3,6,0
"bonduc",1,6,2,4,0
"bladrol",0,7,2,5,0
"sluookt'",0,8,3,5,1
"antias",0,6,3,3,0
"mammered",1,8,3,5,0
"iliadromic",0,10,5,5,0
"scratchingly",1,12,2,10,0
"targeted",1,8,3,5,0
"demothemigativacy",0,17,7,10,0
"solic",0,5,2,3,0
"phimorulo",0,9,4,5,0
"gdlev",0,5,1,4,0
"cryptivelluli",0,13,4,9,0
"unbelieffulness",1,15,6,9,0
"engrails",1,8,3,5,0
"protohymenopterous",1,18,7,11,0
"unfidelity",1,10,4,6,0
"bilathus",0,8,3,5,0
"yously",0,6,2,4,0
"corporally",1,10,3,7,0
"saristrisymalignasepg",0,21,7,14,0
"hopaunog",0,8,4,4,0
"endoproctous",1,12,5,7,0
"shuquiescalita",0,14,7,7,0
"sxivistkvkrah",0,13,3,10,0
"hobson",1,6,2,4,0
"unritually",1,10,4,6,0
"haxesun",0,7,3,4,0
"cuspidae",0,8,4,4,0
"foofflu",0,7,3,4,0
"adorned",1,7,3,4,0
"ingots",1,6,2,4,0
"miraculise",1,10,5,5,0
"radicates",1,9,4,5,0
"reagireionomartolihdonwaga",0,26,13,13,0
"occupable",1,9,4,5,0
"auscultate",1,10,5,5,0
"uriniparous",1,11,6,5,0
"sandra",1,6,2,4,0
"bickie",1,6,3,3,0
"hepatologeryope",0,15,7,8,0
"harmonides",1,10,4,6,0
"absceporiopass",0,14,6,8,0
"babblers",1,8,2,6,0
"chiquite",0,8,4,4,0
"homeristakhands",0,15,5,10,0
"hoimo",0,5,3,2,0
"miasklleraphablinixterucll",0,26,9,17,0
"teleostome",1,10,5,5,0
"frsinnette",0,10,3,7,0
"rhabdomine",0,10,4,6,0
"phantom",1,7,2,5,0
"forcella",0,8,3,5,0
"vacuous",1,7,4,3,0
"xbpshvklriv'rxlb'auih",0,21,4,17,2
"kalakh",1,6,2,4,0
"lockmaster",1,10,3,7,0
"blous",0,5,2,3,0
"keen",1,4,2,2,0
"tetanigenous",1,12,6,6,0
"clu",1,3,1,2,0
"ephonquatia",0,11,6,5,0
"baganatious",0,11,6,5,0
"zygomaticino",0,12,5,7,0
"schiarendenlecogaacourphl",0,25,10,15,0
"nonstandardised",1,15,5,10,0
"samuela",1,7,4,3,0
"coenenchymatal",0,14,5,9,0
"oxismerlaphemeresses",0,20,8,12,0
"aphelnset",0,9,3,6,0
"njzva",0,5,1,4,0
"ignatianist",1,11,5,6,0
"angelocracy",1,11,4,7,0
"bournochies",0,11,5,6,0
"connemara",1,9,4,5,0
"culturist",1,9,3,6,0
"skinny",1,6,1,5,0
"tanglefish",1,10,3,7,0
"crowstep",1,8,2,6,0
"cevbxyqshjcidjqq",0,16,2,14,0
"euy'ejb'wdn",0,11,3,8,2
"boospurtagers",0,13,5,8,0
"baxton",0,6,2,4,0
"sund",0,4,1,3,0
"clypeastrina",1,12,4,8,0
"docudrama",1,9,4,5,0
"larris",0,6,2,4,0
"alliterate",1,10,5,5,0
"greed",1,5,2,3,0
"quadripulmonary",1,15,6,9,0
"swaybacked",1,10,3,7,0
"gallantriidae",0,13,6,7,0
"telacoller",0,10,4,6,0
"paddleballs",1,11,3,8,0
"precipitated",1,12,5,7,0
"tralliance",0,10,4,6,0
"soldans",1,7,2,5,0
"microinch",1,9,3,6,0
"succantiid",0,10,4,6,0
"fribblery",1,9,2,7,0
"skatognifer",0,11,4,7,0
"awesomeness",1,11,5,6,0
"pbzormndhbascfoijvfveiwlcei",0,27,8,19,0
"raphic",0,6,2,4,0
"top",1,3,1,2,0
"lonole",0,6,3,3,0
"domiciles",1,9,4,5,0
"stereoscopically",1,16,6,10,0
"fiopy",0,5,2,3,0
"hapelisbronginestinescin",0,24,9,15,0
"slicatotacytrropiesaivagethexiremmarwurellecllesth",0,50,19,31,0
"sensitivities",1,13,6,7,0
"barning",0,7,2,5,0
"ogcocephalan",0,12,5,7,0
"repandolobate",1,13,6,7,0
"stoneworker",1,11,4,7,0
"cathedra",1,8,3,5,0
"wits",1,4,1,3,0
"noncircumvallated",1,17,6,11,0
"pataries",0,8,4,4,0
"architectonica",1,14,6,8,0
"condolencies",0,12,5,7,0
"ftoxomaumarobulor",0,17,8,9,0
"hereof",1,6,3,3,0
"afright",1,7,2,5,0
"imposaltsburt",0,13,4,9,0
"tincalendarme",0,13,5,8,0
"culnes",0,6,2,4,0
"giycsljigtxxdcdmdujstnnph'qxsk",0,30,3,27,1
"cline",1,5,2,3,0
"regious",0,7,4,3,0
"docimasies",1,10,5,5,0
"rebalanoid",0,10,5,5,0
"nonsynoptical",1,13,4,9,0
"euploeinae",1,10,7,3,0
"fluffe",0,6,2,4,0
"annueler",1,8,4,4,0
"eschaunge",1,9,4,5,0
"vill",1,4,1,3,0
"xybnhmsntm'l",0,12,0,12,1
"bepijolfundentins",0,17,6,11,0
"feeses",1,6,3,3,0
"tecpanec",1,8,3,5,0
"latedockbial",0,12,5,7,0
"chinah",0,6,2,4,0
"cowbirds",1,8,2,6,0
"concipient",1,10,4,6,0
"nonobserve",0,10,4,6,0
"overspend",1,9,3,6,0
"pyromoreticopick",0,16,6,10,0
"chodulupemilainchede",0,20,9,11,0
"kinnor",1,6,2,4,0
"noach",1,5,2,3,0
"menardakerectarathum",0,20,8,12,0
"zytsvaziuzc'",0,12,3,9,1
"undercoat",1,9,4,5,0
"photomapping",1,12,4,8,0
"limier",1,6,3,3,0
"beglerbey",1,9,3,6,0
"swat",1,4,1,3,0
"aepyov",0,6,3,3,0
"cater",0,5,2,3,0
"explaining",1,10,4,6,0
"mimmocky",1,8,2,6,0
"oxyproducibly",0,13,4,9,0
"normoblast",1,10,3,7,0
"capitalise",0,10,5,5,0
"retardates",1,10,4,6,0
"manat",1,5,2,3,0
"pkoddlsvtyjcu",0,13,2,11,0
"bowmanstown",1,11,3,8,0
"delevitis",0,9,4,5,0
"predeliberation",1,15,7,8,0
"utopian",1,7,4,3,0
"trainmaster",1,11,4,7,0
"christinesmative",0,16,6,10,0
"pianmbats",0,9,3,6,0
"sukers",0,6,2,4,0
"transfusionisms",0,15,5,10,0
"qpgpftck'qprm",0,13,0,13,1
"mundify",1,7,2,5,0
"efenely",0,7,3,4,0
"calley",1,6,2,4,0
"qegbsrkl",0,8,1,7,0
"cybernetic",1,10,3,7,0
"castigator",1,10,4,6,0
"ktk",0,3,0,3,0
"yancewoodgmentragaries",0,22,9,13,0
"discommode",1,10,4,6,0
"chaementartrusses",0,17,6,11,0
"neurod",0,6,3,3,0
"wannie",0,6,3,3,0
"tressee",0,7,3,4,0
"roundhands",1,10,3,7,0
"odontia",0,7,4,3,0
"deches",0,6,2,4,0
"sarcological",1,12,5,7,0
"smiang",0,6,2,4,0
"allianced",1,9,4,5,0
"shiftshop",0,9,2,7,0
"animals",1,7,3,4,0
"cornopionage",0,12,6,6,0
"cvdbaf",0,6,1,5,0
"stephentolamin",0,14,5,9,0
"frendemiobited",0,14,6,8,0
"nonobjective",1,12,5,7,0
"slaughteries",1,12,5,7,0
"unbellachiversaxopipfies",0,24,10,14,0
"shoggled",1,8,2,6,0
"translucences",1,13,4,9,0
"revelations",1,11,5,6,0
"gimmie",1,6,3,3,0
"steatocystic",0,12,4,8,0
"knpgnlgvbw",0,10,0,10,0
"kxdiob'tft",0,10,2,8,1
"capito",1,6,3,3,0
"titanic",1,7,3,4,0
"cletan",0,6,2,4,0
"labarum",1,7,3,4,0
"wdxnpjbyfgodkmkldwimmepjm",0,25,3,22,0
"amphioxidae",1,11,6,5,0
"coompfrbxe",0,10,3,7,0
"sporter",1,7,2,5,0
"tenges",1,6,2,4,0
"quakership",1,10,4,6,0
"butauma",0,7,4,3,0
"granulations",1,12,5,7,0
"ments",0,5,1,4,0
"svea",1,4,2,2,0
"mancunian",1,9,4,5,0
"aing",0,4,2,2,0
"assarid",0,7,3,4,0
"schluter",1,8,2,6,0
"vessess",0,7,2,5,0
"chropteres",0,10,3,7,0
"blennia",0,7,3,4,0
"gibbettsville",0,13,4,9,0
"distained",1,9,4,5,0
"hiyas",1,5,2,3,0
"microticists",0,12,4,8,0
"uttery",0,6,2,4,0
"hmonge",0,6,2,4,0
"naianisymachatroryfjaper",0,24,9,15,0
"argasid",1,7,3,4,0
"eternancy",0,9,3,6,0
"pensionat",1,9,4,5,0
"edriophthalmology",0,17,6,11,0
"blynnette",0,9,2,7,0
"woodcarvers",1,11,4,7,0
"indigenousness",1,14,6,8,0
"qyiqnbojzwnb",0,12,2,10,0
"somnolism",1,9,3,6,0
"parliamentarism",1,15,6,9,0
"nereus",1,6,3,3,0
"strigiles",1,9,3,6,0
"wondreat",0,8,3,5,0
"pentachlorophyllic",0,18,5,13,0
"noctiluca",1,9,4,5,0
"nailer",1,6,3,3,0
"yteaijivhiw",0,11,5,6,0
"owheuchleresatided",0,18,8,10,0
"spondylid",1,9,2,7,0
"vucer",0,5,2,3,0
"sprup",0,5,1,4,0
"calamelmiturvantivers",0,21,8,13,0
"eleen",1,5,3,2,0
"oxbxtfkgzgwtzy",0,14,1,13,0
"affixion",1,8,4,4,0
"nidiavormaskis",0,14,6,8,0
"celtoman",0,8,3,5,0
"schobe",0,6,2,4,0
"ctzqnm'iwgpxanvqhqtivfyowartpj",0,30,5,25,1
"consulships",1,11,3,8,0
"tyronierisman",0,13,5,8,0
"eyepatch",1,8,3,5,0
"culminations",1,12,5,7,0
"mosch",0,5,1,4,0
"lightplane",1,10,3,7,0
"fablenesses",0,11,4,7,0
"kmbzgttpkpln",0,12,0,12,0
"chdhrdbgxlvjmpiioklfxups'",0,25,4,21,1
"ophthalmotome",0,13,5,8,0
"canstick",1,8,2,6,0
"neisanction",0,11,5,6,0
"nonfeudation",0,12,6,6,0
"foredesignment",1,14,5,9,0
"yqokmqqjim",0,10,2,8,0
"rubineous",1,9,5,4,0
"ungambolled",1,11,4,7,0
"neuring",0,7,3,4,0
"salamandrina",1,12,5,7,0
"nontion",0,7,3,4,0
"fdjufefuprgngih",0,15,4,11,0
"madelia",1,7,4,3,0
"bockpolicarculaen",0,17,7,10,0
"sycephium",0,9,3,6,0
"fretwise",1,8,3,5,0
"featherway",1,10,4,6,0
"highness",1,8,2,6,0
"animadversiveness",1,17,7,10,0
"uncto",0,5,2,3,0
"initiator",1,9,5,4,0
"superassumingness",0,17,6,11,0
"arctosiphunchecksiess",0,21,7,14,0
"varidgessporedness",0,18,6,12,0
"equingly",0,8,3,5,0
"glyll",0,5,0,5,0
"carnitine",1,9,4,5,0
"noma",1,4,2,2,0
"aniss",0,5,2,3,0
"sleets",1,6,2,4,0
"wooleated",0,9,5,4,0
"grammaticism",1,12,4,8,0
"termly",1,6,1,5,0
"acitiladet",0,10,5,5,0
"shanney",1,7,2,5,0
"unstage",0,7,3,4,0
"kertacowhorne",0,13,5,8,0
"flkkacfgmllew",0,13,2,11,0
"weasel",1,6,3,3,0
"saurischians",1,12,5,7,0
"waddie",1,6,3,3,0
"acifs",0,5,2,3,0
"saturant",1,8,3,5,0
"whephyereestitiondefon",0,22,9,13,0
"tnseasureren",0,12,5,7,0
"backstitching",1,13,3,10,0
"peripeteian",1,11,6,5,0
"npccmrvxrnexvomatvzwzehxhaye",0,28,6,22,0
"terrell",1,7,2,5,0
"choccies",1,8,3,5,0
"stocklocks",1,10,2,8,0
"sedatingly",0,10,3,7,0
"trajects",1,8,2,6,0
"distrackilgispes",0,16,5,11,0
"sympositiformnad",0,16,5,11,0
"spilogale",1,9,4,5,0
"reedstop",1,8,3,5,0
"timondablendo",0,13,5,8,0
"bentiness",1,9,3,6,0
"retingly",0,8,2,6,0
"dism",0,4,1,3,0
"urochord",1,8,3,5,0
"gooseflesh",1,10,4,6,0
"toyer",1,5,2,3,0
"'b'mosmlqrxfzywj'",0,17,1,16,3
"porina",1,6,3,3,0
"tricyanica",0,10,4,6,0
"polliflore",0,10,4,6,0
"compuserve",1,10,4,6,0
"entoaxilla",0,10,5,5,0
"acso'igcxlqwezrggict",0,20,5,15,1
"eeoekcuqg",0,9,5,4,0
"cockroach",1,9,3,6,0
"saratogas",1,9,4,5,0
"axfeeloadesoles",0,15,8,7,0
"corsleted",1,9,3,6,0
"hyarded",0,7,2,5,0
"justiceship",1,11,4,7,0
"indwinoddhisaut",0,15,6,9,0
"kaliyuga",1,8,4,4,0
"unpurse",1,7,3,4,0
"minessesquawleyyounternappetunupramps",0,37,14,23,0
"fyqpjsewlvchazbg",0,16,2,14,0
"beziers",1,7,3,4,0
"emanating",1,9,4,5,0
"sudras",1,6,2,4,0
"ireland",1,7,3,4,0
"nonassonant",1,11,4,7,0
"winchancushkar",0,14,4,10,0
"bristoloching",0,13,4,9,0
"uncoacted",1,9,4,5,0
"dimitrov",1,8,3,5,0
"impressment",1,11,3,8,0
"rodleighballsburg",0,17,5,12,0
"szsv",0,4,0,4,0
"ethoxyethane",1,12,5,7,0
"oresticler",0,10,4,6,0
"maccarated",0,10,4,6,0
"unnichering",0,11,4,7,0
"adourithated",0,12,6,6,0
"pretritables",0,12,4,8,0
"septemvir",1,9,3,6,0
"unchambered",1,11,4,7,0
"pertainable",0,11,5,6,0
"unklismoning",0,12,4,8,0
"thersander",1,10,3,7,0
"endolabyrinthitis",1,17,6,11,0
"overcommercializes",1,18,8,10,0
"gcjamtuivy'tlj",0,14,3,11,1
"steinites",0,9,4,5,0
"cushinesses",1,11,4,7,0
"shopkeep",1,8,3,5,0
"olirxtnslwmrscocp",0,17,3,14,0
"tikes",1,5,2,3,0
"unobservatorium",0,15,7,8,0
"maceheads",0,9,4,5,0
"ultralisation",0,13,6,7,0
"hubertusburg",1,12,4,8,0
"extraornaturate",0,15,7,8,0
"secunderfests",0,13,4,9,0
"whaserfeo",0,9,4,5,0
"stegosauria",1,11,6,5,0
"theverexplostic",0,15,5,10,0
"iphition",1,8,4,4,0
"gehm",0,4,1,3,0
"fangert",0,7,2,5,0
"superformal",1,11,4,7,0
"batinsive",0,9,4,5,0
"divisionism",1,11,5,6,0
"scarrow",1,7,2,5,0
"petiolular",1,10,5,5,0
"percrafficeous",0,14,6,8,0
"amildar",1,7,3,4,0
"nonpopulati",0,11,5,6,0
"metaxite",1,8,4,4,0
"cound",0,5,2,3,0
"coccolithophoridae",1,18,8,10,0
"sunbathers",1,10,3,7,0
"relerd",0,6,2,4,0
"backcock",0,8,2,6,0
"phthalyl",1,8,1,7,0
"caingangs",1,9,3,6,0
"cortinider",0,10,4,6,0
"rqctxjlhdqwzbibd'uy",0,19,2,17,1
"willis",1,6,2,4,0
"californ",0,8,3,5,0
"unbitio",0,7,4,3,0
"cpjhxqczqtxocxk",0,15,1,14,0
"shifgaagpnavki",0,14,5,9,0
"fubb",0,4,1,3,0
"jmaqsg'jctscl",0,13,1,12,1
"cohe",1,4,2,2,0
"dihydractuarise",0,15,6,9,0
"anechoic",1,8,4,4,0
"hotpontol",0,9,3,6,0
"adelphoi",1,8,4,4,0
"bipaliidae",1,10,6,4,0
"wvcxcrfspsej",0,12,1,11,0
"indistinctible",1,14,5,9,0
"spinning",1,8,2,6,0
"goniatitid",1,10,5,5,0
"wiq'piekfgfwylpegfjp",0,20,4,16,1
"tradedness",0,10,3,7,0
"ycfhj'qi'mqouklaojpqzsu",0,23,6,17,2
"abundevoke",0,10,5,5,0
"laciniose",1,9,5,4,0
"fourche",1,7,3,4,0
"abobjectives",0,12,5,7,0
"pw'cmmbxjmcdkjqyhpxvp",0,21,0,21,1
"baragon",0,7,3,4,0
"lethologica",1,11,5,6,0
"isochromide",0,11,5,6,0
"lususes",1,7,3,4,0
"unmasmallopotoglencimors",0,24,9,15,0
"taxiing",1,7,3,4,0
"mosylvallaceae",0,14,6,8,0
"pelagia",1,7,4,3,0
"hairdo",1,6,3,3,0
"jfzmjzk",0,7,0,7,0
"trasteverine",1,12,5,7,0
"halpern",1,7,2,5,0
"wat",1,3,1,2,0
"flanigan",1,8,3,5,0
"ntenyciecki",0,11,4,7,0
"wailuku",1,7,4,3,0
"pedagoguishnesses",1,17,7,10,0
"rectified",1,9,4,5,0
"malcoman",0,8,3,5,0
"junaezdov'c'yqlomsduhqpc",0,24,6,18,2
"dopa",1,4,2,2,0
"sharns",1,6,1,5,0
"weedful",1,7,3,4,0
"adamster",0,8,3,5,0
"spelaeothems",1,12,5,7,0
"thiotenmanid",0,12,5,7,0
"wiskelochurroopincheenanchoovy",0,30,12,18,0
"intercomprehensibility",1,22,8,14,0
"pellach",1,7,2,5,0
"unchosneli",0,10,4,6,0
"cerotion",0,8,4,4,0
"scrimshanders",1,13,3,10,0
"outbleated",1,10,5,5,0
"reus",1,4,2,2,0
"aetograminnebrut",0,16,7,9,0
"obly",0,4,1,3,0
"concordant",1,10,3,7,0
"ivinontoses",0,11,5,6,0
"fireworm",1,8,3,5,0
"unrelish",0,8,3,5,0
"slidingly",1,9,2,7,0
"infundish",0,9,3,6,0
"daclassa",1,8,3,5,0
"fucose",1,6,3,3,0
"palmerin",1,8,3,5,0
"mythogreen",1,10,3,7,0
"musculospiral",1,13,5,8,0
"notus",1,5,2,3,0
"fleur",1,5,2,3,0
"reaccommodated",1,14,6,8,0
"punct",1,5,1,4,0
"gosh",1,4,1,3,0
"urodelinquellencer",0,18,8,10,0
"also",1,4,2,2,0
"nfgvdadqfdgncv",0,14,1,13,0
"diminution",1,10,5,5,0
"contaminator",1,12,5,7,0
"semiliberating",0,14,6,8,0
"litonarog",0,9,4,5,0
"preassurance",1,12,5,7,0
"cuts",1,4,1,3,0
"keavy",1,5,2,3,0
"herzegovinian",1,13,6,7,0
"actively",1,8,3,5,0
"apaoruchacanps",0,14,6,8,0
"ctsoebzbnunjsawze",0,17,5,12,0
"unsorrowing",1,11,4,7,0
"salums",0,6,2,4,0
"bekissing",1,9,3,6,0
"iridoptosis",1,11,5,6,0
"hemiamblyocarpous",0,17,7,10,0
"microfilarial",1,13,6,7,0
"surthunbraccer",0,14,4,10,0
"transcient",0,10,3,7,0
"proxygent",0,9,2,7,0
"unencumbered",1,12,5,7,0
"yilb",0,4,1,3,0
"abraids",1,7,3,4,0
"scevubawqkklcbcasrltay",0,22,5,17,0
"applier",1,7,3,4,0
"tarkio",1,6,3,3,0
"cymbalaria",1,10,4,6,0
"bulldogism",1,10,3,7,0
"ptilimnium",1,10,4,6,0
"tidivating",1,10,4,6,0
"delapidate",1,10,5,5,0
"ayroctatophromesignetic",0,23,9,14,0
"sinis",1,5,2,3,0
"aldide",1,6,3,3,0
"wvunnrvxqdgdqmsbjjledctrkx'tb",0,29,2,27,1
"cloquentecheve",0,14,6,8,0
"hyperrealisable",0,15,6,9,0
"adx'yuzqwcdo",0,12,3,9,1
"scibdhqrpjjfadqix'",0,18,3,15,1
"stercourse",0,10,4,6,0
"daten",0,5,2,3,0
"dlxyfm",0,6,0,6,0
"exrghcl'nuyfdecmn",0,17,3,14,1
"drooker",0,7,3,4,0
"wonalls",0,7,2,5,0
"quadrinomically",0,15,6,9,0
"twotiess",0,8,3,5,0
"holotron",0,8,3,5,0
"reconvolterothionancane",0,23,10,13,0
"ghetti",1,6,2,4,0
"speums",0,6,2,4,0
"princonvent",0,11,3,8,0
"resuping",0,8,3,5,0
"supentriabiale",0,14,7,7,0
"selenidera",1,10,5,5,0
"apologetic",1,10,5,5,0
"squill",1,6,2,4,0
"wncjeophvomzcxglzsgrfh",0,22,3,19,0
"prad",1,4,1,3,0
"chemiluminescences",1,18,7,11,0
"semedediannars",0,14,6,8,0
"linkeditor",1,10,4,6,0
"'mporbcocrf'qryxrofqclsk",0,24,3,21,2
"dicente",0,7,3,4,0
"airtime",1,7,4,3,0
"projectile",1,10,4,6,0
"ethmolith",1,9,3,6,0
"ophilianida",0,11,6,5,0
"nonthers",0,8,2,6,0
"extensionally",1,13,5,8,0
"midlife",1,7,3,4,0
"skulpaneoana",0,12,6,6,0
"dithelette",0,10,4,6,0
"gjelled",0,7,2,5,0
"coer",1,4,2,2,0
"mosque",1,6,3,3,0
"japonaiserieses",0,15,8,7,0
"backtracanthic",0,14,4,10,0
"hiptraxecrum",0,12,4,8,0
"prociphilus",1,11,4,7,0
"nagittlelindlebombs",0,19,6,13,0
"alle",1,4,2,2,0
"chesting",1,8,2,6,0
"thremmatological",0,16,6,10,0
"carpocratian",1,12,5,7,0
"negotiatress",1,12,5,7,0
"lithogenous",1,11,5,6,0
"oreodon",1,7,4,3,0
"hsxs'iznetihpcgrompfta",0,22,5,17,1
"provencalizes",0,13,5,8,0
"boumdienne",1,10,5,5,0
"gablencorrettisteroceliolatteringeridgehate",0,43,18,25,0
"niarada",1,7,4,3,0
"unicite",0,7,4,3,0
"czepreing",0,9,3,6,0
"deliquium",1,9,5,4,0
"euphemispheric",0,14,6,8,0
"spuffle",1,7,2,5,0
"hsbc",1,4,0,4,0
"kittrell",1,8,2,6,0
"brittly",1,7,1,6,0
"inged",0,5,2,3,0
"lao",1,3,2,1,0
"vaga",0,4,2,2,0
"turken",1,6,2,4,0
"godius",0,6,3,3,0
"armentis",0,8,3,5,0
"forepresentative",0,16,7,9,0
"ultrasonography",1,15,5,10,0
"spieled",1,7,3,4,0
"mazirds",0,7,2,5,0
"berklike",0,8,3,5,0
"foprineshuiedariomigetlyo",0,25,12,13,0
"plkeriomarsutemeis",0,18,8,10,0
"smationg",0,8,3,5,0
"mmxlnch",0,7,0,7,0
"croconate",1,9,4,5,0
"myographies",1,11,4,7,0
"inulas",1,6,3,3,0
"listserv",1,8,2,6,0
"subornion",0,9,4,5,0
"synonymous",1,10,3,7,0
"coboss",1,6,2,4,0
"basiscopic",1,10,4,6,0
"semimanagerial",1,14,7,7,0
"opical",0,6,3,3,0
"sheer",1,5,2,3,0
"sclerotics",1,10,3,7,0
"callychusne",0,11,3,8,0
"transparentness",1,15,4,11,0
"tutania",1,7,4,3,0
"waling",1,6,2,4,0
"spherometer",1,11,4,7,0
"costlew",1,7,2,5,0
"vqq'rkgsugdxqfkljyv'xniza",0,25,3,22,2
"underspend",1,10,3,7,0
"litous",0,6,3,3,0
"heteromon",0,9,4,5,0
"astee",0,5,3,2,0
"surucucus",1,9,4,5,0
"demarciasville",0,14,6,8,0
"lustrations",1,11,4,7,0
"uninherited",1,11,5,6,0
"taylesses",0,9,3,6,0
"moloffdma",0,9,3,6,0
"deflow",1,6,2,4,0
"transvestisms",1,13,3,10,0
"unctic",0,6,2,4,0
"balted",0,6,2,4,0
"antatis",0,7,3,4,0
"apatan",1,6,3,3,0
"waxfist",0,7,2,5,0
"balator",0,7,3,4,0
"ysawfuopxtwonlqu",0,16,5,11,0
"edin",1,4,2,2,0
"lazaret",1,7,3,4,0
"nonaccentual",1,12,5,7,0
"kyasfnxsexhf",0,12,2,10,0
"firious",0,7,4,3,0
"physiatric",1,10,3,7,0
"'fxz",0,4,0,4,1
"croaker",1,7,3,4,0
"prahu",1,5,2,3,0
"sticksman",0,9,2,7,0
"flche",1,5,1,4,0
"nonornamental",0,13,5,8,0
"reenia",0,6,4,2,0
"dionysian",1,9,4,5,0
"knawel",1,6,2,4,0
"scot",1,4,1,3,0
"unchar",0,6,2,4,0
"creedon",1,7,3,4,0
"heter",0,5,2,3,0
"fores",0,5,2,3,0
"shan",1,4,1,3,0
"kirium",0,6,3,3,0
"ofosww",0,6,2,4,0
"muldes",0,6,2,4,0
"ungroupable",1,11,5,6,0
"almswomen",1,9,3,6,0
"cotlands",1,8,2,6,0
"affix",1,5,2,3,0
"longthene",0,9,3,6,0
"crepituses",1,10,4,6,0
"obstupefy",1,9,3,6,0
"rosaceae",1,8,5,3,0
"divisionists",1,12,5,7,0
"colobansated",0,12,5,7,0
"jhcgjzghidghmrcpmkgx",0,20,1,19,0
"macushclodontensteperidae",0,25,10,15,0
"clopticidsworter",0,16,5,11,0
"diagrammaticalizes",0,18,8,10,0
"nongratulation",0,14,6,8,0
"chalicotheres",1,13,5,8,0
"lswosmerds",0,10,2,8,0
"wimbivorcinualness",0,18,7,11,0
"parognitosponderoppers",0,22,8,14,0
"neralships",0,10,3,7,0
"harcempeymedrdiccte",0,19,6,13,0
"atelognathia",1,12,6,6,0
"mugnon",0,6,2,4,0
"lycographilomy",0,14,4,10,0
"shininess",1,9,3,6,0
"unemasculatory",1,14,6,8,0
"mam",1,3,1,2,0
"disi",0,4,2,2,0
"vilificatured",0,13,6,7,0
"davallaria",0,10,5,5,0
"nkenkmrhk'qwsmircotcyabpc",0,25,4,21,1
"fraus",1,5,2,3,0
"hesperithen",0,11,4,7,0
"nectars",1,7,2,5,0
"sar",0,3,1,2,0
"sleech",1,6,2,4,0
"goldsmith",1,9,2,7,0
"rodomontevere",0,13,6,7,0
"molestationary",0,14,6,8,0
"ctey",0,4,1,3,0
"subsecretive",0,12,5,7,0
"justicon",0,8,3,5,0
"dafterativita",0,13,6,7,0
"vicentric",0,9,3,6,0
"fbavvownbuqhe",0,13,4,9,0
"thermione",0,9,4,5,0
"hsnihzjzkyadctyayxhsvacj",0,24,4,20,0
"epopees",1,7,4,3,0
"sulidae",1,7,4,3,0
"gnomonia",1,8,4,4,0
"autoirrigations",0,15,8,7,0
"hetherward",1,10,3,7,0
"prarenovifomelats",0,17,7,10,0
"lorita",1,6,3,3,0
"plagioliparite",1,14,7,7,0
"dnuxjhzqhospa",0,13,3,10,0
"angst",1,5,1,4,0
"malacocotyleal",0,14,6,8,0
"arawak",1,6,3,3,0
"structs",0,7,1,6,0
"trigla",1,6,2,4,0
"gleis",1,5,2,3,0
"thealcum",0,8,3,5,0
"basmati",1,7,3,4,0
"tangible",1,8,3,5,0
"vzqirkarqzk",0,11,2,9,0
"ormeranshing",0,12,4,8,0
"bestemistalkeraing",0,18,7,11,0
"caudaite",1,8,5,3,0
"olufilhugoqzyjwemoxvwctt",0,24,7,17,0
"bromocyanid",1,11,4,7,0
"chlamydiaceae",1,13,6,7,0
"crcan",0,5,1,4,0
"dorsothoracic",1,13,5,8,0
"fzjzkh'rglbzuzneqjrfntcqkcrf",0,28,2,26,1
"rupestrine",1,10,4,6,0
"cooniest",1,8,4,4,0
"hairebirdsbor",0,13,5,8,0
"drowstophist",0,12,3,9,0
"unquerulously",1,13,6,7,0
"pwvnep'xt",0,9,1,8,1
"veyoilgrkevcprmurwp",0,19,5,14,0
"pauline",1,7,4,3,0
"camote",1,6,3,3,0
"photodensitometer",1,17,7,10,0
"lemniscate",1,10,4,6,0
"chokies",1,7,3,4,0
"unemendable",1,11,5,6,0
"ultalse",0,7,3,4,0
"nonartific",0,10,4,6,0
"wination",0,8,4,4,0
"berlitz",1,7,2,5,0
"iia",1,3,3,0,0
"sequency",1,8,3,5,0
"counterirritants",1,16,6,10,0
"combonomopliac",0,14,6,8,0
"babish",0,6,2,4,0
"telegrammatic",1,13,5,8,0
"glyted",0,6,1,5,0
"nonswillo",0,9,3,6,0
"leucinores",0,10,5,5,0
"uncountenanced",1,14,6,8,0
"morrisonville",1,13,5,8,0
"monocystotomy",0,13,4,9,0
"kqshpdsg",0,8,0,8,0
"kerful",0,6,2,4,0
"chloramphenicol",1,15,5,10,0
"champarts",1,9,2,7,0
"vociferative",1,12,6,6,0
"ebtl'rhrlpmojp",0,14,2,12,1
"tdcc",1,4,0,4,0
"phantasus",1,9,3,6,0
"wrightsboro",1,11,3,8,0
"rigidified",1,10,5,5,0
"nonpararision",0,13,6,7,0
"irdxylqeapkdkumfy'jdz",0,21,4,17,1
"simorydhacr",0,11,3,8,0
"dishallucination",1,16,7,9,0
"ikhmttvocveb",0,12,3,9,0
"elytron",1,7,2,5,0
"romanchhydnockwards",0,19,4,15,0
"lucubrated",1,10,4,6,0
"yammerkleysburg",0,15,4,11,0
"straint",1,7,2,5,0
"dengue",1,6,3,3,0
"sampras",1,7,2,5,0
"bfg",0,3,0,3,0
"sigfocur",0,8,3,5,0
"sculling",1,8,2,6,0
"spines",1,6,2,4,0
"pointing",1,8,3,5,0
"ekvpreulrv'jnquetrypupraq",0,25,7,18,1
"novartis",1,8,3,5,0
"xerophthalmus",0,13,4,9,0
"sabellarmen",0,11,4,7,0
"afeeaokp",0,8,5,3,0
"netiomendin",0,11,5,6,0
"brassfounded",0,12,4,8,0
"symploceus",0,10,3,7,0
"cathaminarisochairing",0,21,9,12,0
"uniocular",1,9,5,4,0
"didogals",0,8,3,5,0
"wisconsinites",1,13,5,8,0
"strobiliferous",1,14,6,8,0
"abutilon",1,8,4,4,0
"howder",1,6,2,4,0
"deadpanners",1,11,4,7,0
"nonsuggestive",1,13,5,8,0
"watersmeet",1,10,4,6,0
"metrostyle",1,10,3,7,0
"metries",0,7,3,4,0
"hopedale",1,8,4,4,0
"woodward",1,8,3,5,0
"quzoxynchatabs",0,14,4,10,0
"mknomdsyphzgovrbrobd",0,20,3,17,0
"inveterateness",1,14,6,8,0
"allinvelbacenel",0,15,6,9,0
"ethnocentrics",0,13,4,9,0
"restipulated",1,12,5,7,0
"pjrvxmduepbdqrwbflnxzgcczh",0,26,2,24,0
"deepon",0,6,3,3,0
"pediculus",1,9,4,5,0
"couperator",1,10,5,5,0
"fala",1,4,2,2,0
"smac",0,4,1,3,0
"clemated",0,8,3,5,0
"trackmaster",1,11,3,8,0
"kickwheel",1,9,3,6,0
"wristwatches",1,12,3,9,0
"matricultures",0,13,5,8,0
"janissarians",0,12,5,7,0
"purreastationists",0,17,7,10,0
"lyle",1,4,1,3,0
"rxpatimars",0,10,3,7,0
"w'hsvxlrsupogddaa'uhfbnnx",0,25,5,20,2
"ramequins",1,9,4,5,0
"hobing",0,6,2,4,0
"ndwjcmjtpi",0,10,1,9,0
"lle",0,3,1,2,0
"blusher",1,7,2,5,0
"zoroastra",1,9,4,5,0
"accid",0,5,2,3,0
"schantz",1,7,1,6,0
"fathia",0,6,3,3,0
"sterplangemishirulatche",0,23,8,15,0
"kynded",1,6,1,5,0
"spritsails",1,10,3,7,0
"individed",1,9,4,5,0
"alismoid",1,8,4,4,0
"jdppuowutxjz''",0,14,3,11,2
"yoglions",0,8,3,5,0
"baudin",1,6,3,3,0
"libergraphoticatedness",0,22,8,14,0
"protosauria",0,11,6,5,0
"jassuspirian",0,12,5,7,0
"kran",0,4,1,3,0
"tradura",0,7,3,4,0
"simons",1,6,2,4,0
"nlazhwo",0,7,2,5,0
"esticulational",0,14,7,7,0
"jebel",1,5,2,3,0
"cous",0,4,2,2,0
"tributor",0,8,3,5,0
"belak",1,5,2,3,0
"erruconisech",0,12,5,7,0
"lorets",0,6,2,4,0
"extraverting",1,12,4,8,0
"mocarorse",0,9,4,5,0
"cyprio",1,6,2,4,0
"technocratemen",0,14,5,9,0
"harold",1,6,2,4,0
"cardiotoxicities",1,16,8,8,0
"bernstein",1,9,3,6,0
"coagulase",1,9,5,4,0
"necrotise",1,9,4,5,0
"reedley",1,7,3,4,0
"pleight",0,7,2,5,0
"baljane",0,7,3,4,0
"sgik'nzrwmgl",0,12,1,11,1
"tism",0,4,1,3,0
"cgbasweznssdnq",0,14,2,12,0
"dsqjtfxmxzkbnneqfvxuhuijecc",0,27,5,22,0
"tectness",0,8,2,6,0
"intrudance",1,10,4,6,0
"acant",0,5,2,3,0
"palaeophysis",0,12,5,7,0
"lestrigonian",1,12,5,7,0
"ibmanquisinghe",0,14,6,8,0
"justifier",1,9,4,5,0
"ogaticyles",0,10,4,6,0
"izhvpsedfkpbwiekduex",0,20,6,14,0
"outissue",1,8,5,3,0
"finsteafisectarorallioore",0,25,12,13,0
"scirrhi",1,7,2,5,0
"pxzv",0,4,0,4,0
"astrionics",1,10,4,6,0
"ncd",1,3,0,3,0
"dactylonychoclassical",0,21,6,15,0
"fornof",1,6,2,4,0
"septemdecenary",1,14,5,9,0
"bengalines",1,10,4,6,0
"wilhlem",1,7,2,5,0
"gunlock",1,7,2,5,0
"extractive",1,10,4,6,0
"tamar",1,5,2,3,0
"tiremen",1,7,3,4,0
"groeneng",0,8,3,5,0
"iostes",0,6,3,3,0
"intermeddlesomeness",1,19,7,12,0
"impartations",1,12,5,7,0
"lations",0,7,3,4,0
"aidmkumjxxwbqpblm",0,17,3,14,0
"antivaccinationisms",1,19,8,11,0
"piliner",0,7,3,4,0
"turkman",1,7,2,5,0
"sanopurulent",1,12,5,7,0
"leucosticte",1,11,5,6,0
"sondlt",0,6,1,5,0
"naris",1,5,2,3,0
"silverinesses",1,13,5,8,0
"lialoption",0,10,5,5,0
"stockado",1,8,3,5,0
"millersburg",1,11,3,8,0
"baileyton",1,9,4,5,0
"neuropsychologies",1,17,7,10,0
"pinz",1,4,1,3,0
"wisecretiscussiblenesses",0,24,9,15,0
"clangorously",1,12,4,8,0
"prepriced",1,9,3,6,0
"pringuadia",0,10,5,5,0
"vantenacceophzoptrique",0,22,9,13,0
"stantised",0,9,3,6,0
"illexiscaqus",0,12,5,7,0
"mitanise",0,8,4,4,0
"tipped",1,6,2,4,0
"meery",0,5,2,3,0
"ishmul",1,6,2,4,0
"bansmolicatimunouls",0,19,8,11,0
"exogencedenuncturkhous",0,22,9,13,0
"entracte",1,8,3,5,0
"ijmv'ahh",0,8,2,6,1
"northerly",1,9,2,7,0
"qumalepese",0,10,5,5,0
"rescinders",1,10,3,7,0
"terron",0,6,2,4,0
"foley",1,5,2,3,0
"trickiest",1,9,3,6,0
"anasarca",1,8,4,4,0
"hyperrankness",0,13,3,10,0
"verdicts",1,8,2,6,0
"alak",0,4,2,2,0
"rotalinity",0,10,4,6,0
"scharaga",1,8,3,5,0
"mahratta",1,8,3,5,0
"blokemacants",0,12,4,8,0
"mjjydenbuetlsmrutlotdcli",0,24,6,18,0
"kanya",1,5,2,3,0
"forgimmundes",0,12,4,8,0
"isobronts",1,9,3,6,0
"stebbins",1,8,2,6,0
"increatic",0,9,4,5,0
"postmillers",0,11,3,8,0
"pelota",1,6,3,3,0
"tetisoftis",0,10,4,6,0
"unbuttressless",0,14,4,10,0
"equinonest",0,10,5,5,0
"unharmonist",0,11,4,7,0
"bussmatorveser",0,14,5,9,0
"suashromedition",0,15,7,8,0
"triggering",1,10,3,7,0
"orlewise",1,8,4,4,0
"prouty",1,6,2,4,0
"mokiestada",0,10,5,5,0
"adorne",1,6,3,3,0
"calcazardon",0,11,4,7,0
"dises",0,5,2,3,0
"mertibilism",0,11,4,7,0
"chakut",0,6,2,4,0
"cladogram",1,9,3,6,0
"ostentineae",0,11,6,5,0
"hyperkalemia",1,12,5,7,0
"ulas",0,4,2,2,0
"potawatomically",0,15,6,9,0
"mnisturning",0,11,3,8,0
"trunnion",1,8,3,5,0
"pytlqczzverx",0,12,1,11,0
"reitemizing",1,11,5,6,0
"grouchiness",1,11,4,7,0
"apostrophied",1,12,5,7,0
"stalin",1,6,2,4,0
"sequentially",1,12,5,7,0
"coroplast",1,9,3,6,0
"illywhacker",1,11,3,8,0
"phythernetroter",0,15,4,11,0
"porphyrogenitus",1,15,5,10,0
"percoil",0,7,3,4,0
"svengeants",0,10,3,7,0
"smellings",1,9,2,7,0
"danae",1,5,3,2,0
"jbcjdmc",0,7,0,7,0
"pythagoreanism",1,14,5,9,0
"mantineia",1,9,5,4,0
"unparasarikos",0,13,6,7,0
"wusb'xjlxatvdzl",0,15,2,13,1
"thaeousnesporliololisagricaratioed",0,34,17,17,0
"drachexodontialness",0,19,7,12,0
"lucratively",1,11,4,7,0
"unhon",0,5,2,3,0
"jasperation",0,11,5,6,0
"gephyrophobia",1,13,5,8,0
"selpicarin",0,10,4,6,0
"obstreperated",1,13,5,8,0
"khartum",1,7,2,5,0
"crisp",1,5,1,4,0
"homotherapies",0,13,6,7,0
"synderesis",1,10,3,7,0
"promachus",1,9,3,6,0
"undepravediggering",0,18,7,11,0
"ephraim",1,7,3,4,0
"fumatory",1,8,3,5,0
"cyter",0,5,1,4,0
"criticist",0,9,3,6,0
"proprecedents",0,13,4,9,0
"unhospitableness",1,16,6,10,0
"brooddecas",0,10,4,6,0
"panetela",1,8,4,4,0
"crimizen",0,8,3,5,0
"mised",0,5,2,3,0
"cockpit",1,7,2,5,0
"unodoridae",0,10,6,4,0
"chana",1,5,2,3,0
"trabanes",0,8,3,5,0
"frlein",1,6,2,4,0
"paymaster",1,9,3,6,0
"subordinational",0,15,7,8,0
"commingled",1,10,3,7,0
"tencelassars",0,12,4,8,0
"walyaqhrewbncjqqlasrirc",0,23,5,18,0
"succot",1,6,2,4,0
"rct'oaai'agn",0,12,5,7,2
"hair",1,4,2,2,0
"clavicornia",1,11,5,6,0
"saral",0,5,2,3,0
"wajvpmquaujd",0,12,4,8,0
"cracinae",1,8,4,4,0
"override",1,8,4,4,0
"sandbars",1,8,2,6,0
"malacopod",1,9,4,5,0
"mdenopart",0,9,3,6,0
"adle",0,4,2,2,0
"actualist",1,9,4,5,0
"wiosssuin",0,9,4,5,0
"quarantinable",1,13,6,7,0
"ascendance",1,10,4,6,0
"winghetergomes",0,14,5,9,0
"naxos",1,5,2,3,0
"dilantrdgedihon",0,15,5,10,0
"ppbtcvrjdpshj",0,13,0,13,0
"resophysicodelword",0,18,6,12,0
"bushland",1,8,2,6,0
"fishnessemianism",0,16,6,10,0
"semitangents",0,12,4,8,0
"plasmodesmata",1,13,5,8,0
"tennant",1,7,2,5,0
"gastrodisc",1,10,3,7,0
"forfar",1,6,2,4,0
"bemellif",0,8,3,5,0
"cargian",1,7,3,4,0
"shrillness",1,10,2,8,0
"ethmophysal",1,11,3,8,0
"perfumery",1,9,3,6,0
"wagulfres",0,9,3,6,0
"trallian",1,8,3,5,0
"innascibility",1,13,5,8,0
"slavophiles",1,11,4,7,0
"implasher",0,9,3,6,0
"raunion",1,7,4,3,0
"'g",0,2,0,2,1
"admines",0,7,3,4,0
"angellike",1,9,4,5,0
"piazza",1,6,3,3,0
"bipartisan",1,10,4,6,0
"seastrand",1,9,3,6,0
"meilichius",1,10,5,5,0
"cashtown",1,8,2,6,0
"chowanoc",1,8,3,5,0
"flummer",1,7,2,5,0
"haloperidols",1,12,5,7,0
"ngusabexoooniatifivelicynstivehootacuaterr",0,42,20,22,0
"nonwriter",1,9,3,6,0
"vst'tkppybzfe",0,13,1,12,1
"unchiner",0,8,3,5,0
"gnatter",1,7,2,5,0
"bolderian",1,9,4,5,0
"tsszbjrlfifo",0,12,2,10,0
"spilogale",1,9,4,5,0
"benedic",1,7,3,4,0
"polydipsic",1,10,3,7,0
"productuality",0,13,5,8,0
"knessets",1,8,2,6,0
"haverable",0,9,4,5,0
"peroxyllextrastidifelevin",0,25,9,16,0
"phicallyimaelicalycantinnist",0,28,10,18,0
"eptiress",0,8,3,5,0
"dngedaraln",0,10,3,7,0
"worlock",1,7,2,5,0
"rease",0,5,3,2,0
"pllocthiespiobug",0,16,6,10,0
"joselenogrammatum",0,17,7,10,0
"trainbearers",1,12,5,7,0
"wund",0,4,1,3,0
"slowwitted",1,10,3,7,0
"lucer",0,5,2,3,0
"sfo",1,3,1,2,0
"clp'dmzayrjqqaxgvq",0,18,2,16,1
"oversaving",1,10,4,6,0
"auton",0,5,3,2,0
"antanandro",1,10,4,6,0
"upped",1,5,2,3,0
"griffis",1,7,2,5,0
"diprotodonata",0,13,6,7,0
"superrimoon",0,11,5,6,0
"fratencotomycheaddefignesion",0,28,11,17,0
"lifschitz",1,9,2,7,0
"educables",1,9,4,5,0
"unostensible",1,12,5,7,0
"ronoaleoullancnteyphotis",0,24,10,14,0
"medon",1,5,2,3,0
"fyhvzcun",0,8,1,7,0
"josh",1,4,1,3,0
"heterologously",1,14,6,8,0
"lyity",0,5,1,4,0
"receivers",1,9,4,5,0
"duodecillios",0,12,6,6,0
"wncoctroominidsiditee",0,21,9,12,0
"paleron",0,7,3,4,0
"mendous",0,7,3,4,0
"phenolise",1,9,4,5,0
"aniwpmum",0,8,3,5,0
"reanalyser",0,10,4,6,0
"latium",1,6,3,3,0
"silit",0,5,2,3,0
"manhattanizations",1,17,7,10,0
"synch",1,5,0,5,0
"antiaphthic",1,11,4,7,0
"ethlephronidae",0,14,6,8,0
"unseparatist",0,12,5,7,0
"schmoosii",0,9,4,5,0
"unbuckle",1,8,3,5,0
"permeameter",1,11,5,6,0
"overhappy",1,9,3,6,0
"upsilon",1,7,3,4,0
"domestic",1,8,3,5,0
"infuthenogences",0,15,6,9,0
"scissures",1,9,3,6,0
"coarefarapoiketaivellika",0,24,13,11,0
"counelos",0,8,4,4,0
"optionalism",0,11,5,6,0
"stangilong",0,10,3,7,0
"zmzkxeevq",0,9,2,7,0
"enwindowing",0,11,4,7,0
"iushsajghqjvtmf",0,15,3,12,0
"streator",1,8,3,5,0
"unvisor",1,7,3,4,0
"mitmentes",0,9,3,6,0
"assortedness",0,12,4,8,0
"cynosurus",1,9,3,6,0
"ruinousness",1,11,5,6,0
"phephs",0,6,1,5,0
"curveball",1,9,3,6,0
"whrwlsfnmdtubx'bpcaaldqe",0,24,4,20,1
"auburta",1,7,4,3,0
"scruction",0,9,3,6,0
"dinte",0,5,2,3,0
"unpatinated",1,11,5,6,0
"skaneateless",0,12,5,7,0
"dolma",1,5,2,3,0
"baretullism",0,11,4,7,0
"tered",0,5,2,3,0
"taku",1,4,2,2,0
"volapukee",0,9,5,4,0
"tinward",0,7,2,5,0
"keyhountermedicaean",0,19,9,10,0
"dsmsuqjlagawkfg",0,15,3,12,0
"aracara",0,7,4,3,0
"kmhqfefploblh",0,13,2,11,0
"storthingumbob",0,14,4,10,0
"phid",0,4,1,3,0
"millioned",1,9,4,5,0
"starboarding",1,12,4,8,0
"quadrisyllabizing",0,17,6,11,0
"prbicioncontuow",0,15,6,9,0
"undercurl",1,9,3,6,0
"beladying",1,9,3,6,0
"jovialness",1,10,4,6,0
"phy",0,3,0,3,0
"altism",0,6,2,4,0
"uyhzmigskbbbp",0,13,2,11,0
"dissour",1,7,3,4,0
"weariedness",1,11,5,6,0
"decern",1,6,2,4,0
"sugarcoated",1,11,5,6,0
"befouled",1,8,4,4,0
"owol",0,4,2,2,0
"bjchtelerere",0,12,4,8,0
"kobs",1,4,1,3,0
"whitterick",1,10,3,7,0
"gammockiness",0,12,4,8,0
"bumpositics",0,11,4,7,0
"tailoress",1,9,4,5,0
"'iyvrkekx'hmqaut'ukqujrvcli",0,27,7,20,3
"semimanufactured",1,16,7,9,0
"nondevelopable",1,14,6,8,0
"blocksburg",1,10,2,8,0
"juverk",0,6,2,4,0
"cornworm",1,8,2,6,0
"jewite",0,6,3,3,0
"jareb",1,5,2,3,0
"superphysicposing",1,17,5,12,0
"stitilngy",0,9,2,7,0
"embring",0,7,2,5,0
"unpleasantnesses",1,16,6,10,0
"salinities",1,10,5,5,0
"child",1,5,1,4,0
"ettoes",0,6,3,3,0
"idou",1,4,3,1,0
"superinquefortunis",0,18,8,10,0
"zolainry",0,8,3,5,0
"freitier",1,8,4,4,0
"tules",1,5,2,3,0
"stactometers",1,12,4,8,0
"angiotelectasia",1,15,8,7,0
"bivinyl",1,7,2,5,0
"jaildom",1,7,3,4,0
"recrush",1,7,2,5,0
"ceratodus",1,9,4,5,0
"yelma",0,5,2,3,0
"kalate",0,6,3,3,0
"paywalkingly",0,12,3,9,0
"atiuripin",0,9,5,4,0
"coreligionism",0,13,6,7,0
"accreditor",0,10,4,6,0
"gammoner",1,8,3,5,0
"husewguolj",0,10,4,6,0
"mersion",1,7,3,4,0
"yarungymnionexivauncephipradelaim",0,33,14,19,0
"reinfusional",0,12,6,6,0
"quadrivia",1,9,5,4,0
"dannemora",1,9,4,5,0
"primitive",1,9,4,5,0
"kalamazoo",1,9,5,4,0
"mideast",1,7,3,4,0
"pothanger",1,9,3,6,0
"phyllo",1,6,1,5,0
"gxkrjbfhyglamdgpzfttj'",0,22,1,21,1
"rewedegerus",0,11,5,6,0
"alienicolar",0,11,6,5,0
"scania",1,6,3,3,0
"diory",0,5,2,3,0
"phiotowilon",0,11,5,6,0
"oddball",1,7,2,5,0
"runnishly",0,9,2,7,0
"megasporophyll",1,14,4,10,0
"bathwater",1,9,3,6,0
"bfhxqrtbkzjnqz",0,14,0,14,0
"autovaccination",1,15,8,7,0
"propalatable",0,12,5,7,0
"saigon",1,6,3,3,0
"hiloten",0,7,3,4,0
"hemigale",1,8,4,4,0
"ratistradotharthdthetraposposather",0,34,11,23,0
"okqgk'otec",0,10,3,7,1
"tiaunlotrickpte",0,15,6,9,0
"muiptffnefjauahdbysfndh",0,23,6,17,0
"undichotomous",1,13,6,7,0
"skibobbed",1,9,3,6,0
"seepage",1,7,4,3,0
"cnrqxvcracwcc'kuyfhpf'n",0,23,2,21,2
"forcipressure",1,13,5,8,0
"hospodar",1,8,3,5,0
"belemnid",1,8,3,5,0
"chagall",1,7,2,5,0
"crustlelike",0,11,4,7,0
"microswitch",1,11,3,8,0
"squooshier",0,10,5,5,0
"'zsumkiuxwftqxopmmbf",0,20,4,16,1
"vilinmectistopoguital",0,21,9,12,0
"amabil",1,6,3,3,0
"unstableness",1,12,4,8,0
"conoptimulative",0,15,7,8,0
"oxgallongorance",0,15,6,9,0
"acierage",1,8,5,3,0
"demulsoid",0,9,4,5,0
"alethtemung",0,11,4,7,0
"hfctgtvsaakca",0,13,3,10,0
"uwbiqrkjusoizwx",0,15,5,10,0
"saugerties",1,10,5,5,0
"amelsd",0,6,2,4,0
"djenhfunjxsbnqjbs",0,17,2,15,0
"midandealachilie",0,16,8,8,0
"veridicalities",1,14,7,7,0
"emailed",1,7,4,3,0
"sparked",1,7,2,5,0
"proscutellar",1,12,4,8,0
"jacobin",1,7,3,4,0
"ayrship",0,7,2,5,0
"seepproof",1,9,4,5,0
"derograme",0,9,4,5,0
"pretaster",1,9,3,6,0
"vasiferous",1,10,5,5,0
"cierienill",0,10,5,5,0
"unconcurring",1,12,4,8,0
"diaphoret",0,9,4,5,0
"notionate",1,9,5,4,0
"clydebank",1,9,2,7,0
"neuroethologies",1,15,8,7,0
"labolt",1,6,2,4,0
"wapperjawed",1,11,4,7,0
"overrares",0,9,4,5,0
"miscibility",1,11,4,7,0
"squier",1,6,3,3,0
"poverish",1,8,3,5,0
"camids",0,6,2,4,0
"anned",0,5,2,3,0
"sibyllist",1,9,2,7,0
"imnae",0,5,3,2,0
"nonrecipiency",1,13,5,8,0
"cyclothymia",1,11,3,8,0
"interishinida",0,13,6,7,0
"dessationkelis",0,14,6,8,0
"axtollitta",0,10,4,6,0
"lichenins",1,9,3,6,0
"babasarson",0,10,4,6,0
"determinant",1,11,4,7,0
"sennet",1,6,2,4,0
"icaleutic",0,9,5,4,0
"lilast",0,6,2,4,0
"antipodals",1,10,4,6,0
"tribologist",1,11,4,7,0
"herrle",1,6,2,4,0
"unbrakes",1,8,3,5,0
"thermoelement",1,13,5,8,0
"electroencephalodiscus",0,22,9,13,0
"myall",1,5,1,4,0
"quadrioxalate",1,13,7,6,0
"coady",1,5,2,3,0
"cointresses",0,11,4,7,0
"botany",1,6,2,4,0
"tumblerful",1,10,3,7,0
"unburnt",1,7,2,5,0
"controls",1,8,2,6,0
"outsentries",1,11,5,6,0
"sologication",0,12,6,6,0
"chorzuw",1,7,2,5,0
"subpimpish",0,10,3,7,0
"limnophobia",1,11,5,6,0
"rety",0,4,1,3,0
"ys'fiajhuuk",0,11,4,7,1
"vydfoqxunvotnd'lijsyhkkqlneqnv",0,30,5,25,1
"rosined",1,7,3,4,0
"irremissive",1,11,5,6,0
"arctangent",1,10,3,7,0
"nidgett",0,7,2,5,0
"fsufx'ximpxajnfyhgjdv",0,21,3,18,1
"luted",1,5,2,3,0
"puistic",0,7,3,4,0
"goombays",1,8,3,5,0
"nade",0,4,2,2,0
"etle",0,4,2,2,0
"placently",0,9,2,7,0
"ninepenny",1,9,3,6,0
"menkt",0,5,1,4,0
"estrangelos",1,11,4,7,0
"pokey",1,5,2,3,0
"somer",0,5,2,3,0
"hypnum",1,6,1,5,0
"credit",1,6,2,4,0
"tranquiallying",0,14,5,9,0
"mimicry",1,7,2,5,0
"uncantagonidae",0,14,7,7,0
"acoelous",1,8,5,3,0
"nonnationals",1,12,5,7,0
"apophthegmatises",1,16,6,10,0
"angly",0,5,1,4,0
"macromethod",1,11,4,7,0
"ketti",1,5,2,3,0
"odedilomatyt",0,12,5,7,0
"satiety",1,7,3,4,0
"linasssmptrtid",0,14,3,11,0
"soapboamburl",0,12,5,7,0
"sraagrkbhubpkefwkacdn",0,21,5,16,0
"mutescences",0,11,4,7,0
"ep'epezxmvlvfhna",0,16,4,12,1
"anche",0,5,2,3,0
"lisesolosasanida",0,16,8,8,0
"mycoplasmal",1,11,3,8,0
"d'otbdd'hhexsoc",0,15,3,12,2
"thela",0,5,2,3,0
"concleilimoloulsis",0,18,8,10,0
"angelologies",1,12,6,6,0
"leavers",1,7,3,4,0
"heydon",1,6,2,4,0
"desolateness",1,12,5,7,0
"kitchen",1,7,2,5,0
"ffidooxopi",0,10,5,5,0
"norlina",1,7,3,4,0
"iey",1,3,2,1,0
"circuiteer",1,10,5,5,0
"wildsville",1,10,3,7,0
"grubberstmorigible",0,18,6,12,0
"ginalondicas",0,12,5,7,0
"anticonvulsives",1,15,6,9,0
"equilobate",1,10,6,4,0
"isolability",1,11,5,6,0
"sudeccerhagen",0,13,5,8,0
"sphaeritidae",0,12,6,6,0
"machinelike",1,11,5,6,0
"jolly",1,5,1,4,0
"ftransmmuescite",0,15,5,10,0
"nonmetalaquence",0,15,7,8,0
"absconder",1,9,3,6,0
"vories",1,6,3,3,0
"commonplace",1,11,4,7,0
"duedal",0,6,3,3,0
"pleurobrachiidae",1,16,8,8,0
"overtraded",1,10,4,6,0
"ombe",0,4,2,2,0
"huenerathospial",0,15,7,8,0
"isthmist",0,8,2,6,0
"cusic",0,5,2,3,0
"repaginated",1,11,5,6,0
"bupptlpxgsiolpcradwp",0,20,4,16,0
"por",0,3,1,2,0
"interosseous",1,12,6,6,0
"rative",0,6,3,3,0
"arrish",1,6,2,4,0
"preconcafforeweirtz",0,19,7,12,0
"iuka",1,4,3,1,0
"annueler",1,8,4,4,0
"schecker",0,8,2,6,0
"gyro",1,4,1,3,0
"copraxean",0,9,4,5,0
"zooerasty",1,9,4,5,0
"encloser",1,8,3,5,0
"erdrozoisognaceae",0,17,9,8,0
"bedye",1,5,2,3,0
"apocynth",0,8,2,6,0
"demonsociably",0,13,5,8,0
"absolutions",1,11,5,6,0
"brawaridisepao",0,14,7,7,0
"cardialesi",0,10,5,5,0
"broomweed",1,9,4,5,0
"superator",0,9,4,5,0
"angelfish",1,9,3,6,0
"alexipharmics",1,13,5,8,0
"wvcdxktdzxallsmhkwn",0,19,1,18,0
"darkening",1,9,3,6,0
"anglify",1,7,2,5,0
"groundhead",0,10,4,6,0
"hamper",1,6,2,4,0
"reckoning",1,9,3,6,0
"crewlipongsys",0,13,3,10,0
"peptonasal",0,10,4,6,0
"unwalkable",1,10,4,6,0
"gallabiya",1,9,4,5,0
"polytechnics",1,12,3,9,0
"surnamentoft",0,12,4,8,0
"exicredoro",0,10,5,5,0
"jardon",1,6,2,4,0
"ectophyte",1,9,3,6,0
"duplexer",1,8,3,5,0
"psylitariable",0,13,5,8,0
"footmarkab",0,10,4,6,0
"ptiainlscothares",0,16,6,10,0
"gejzcuqxaubvotehykypf",0,21,6,15,0
"urlaveiophacad",0,14,7,7,0
"zlazc",0,5,1,4,0
"piecruda",0,8,4,4,0
"unfasten",1,8,3,5,0
"degelds",0,7,2,5,0
"rabanna",1,7,3,4,0
"malae",0,5,3,2,0
"xtvpqjvqlfd",0,11,0,11,0
"adinvention",1,11,5,6,0
"halverson",1,9,3,6,0
"angenesvillae",0,13,6,7,0
"amvxgwxrl",0,9,1,8,0
"ophidiinae",0,10,6,4,0
"rouser",1,6,3,3,0
"bemixt",1,6,2,4,0
"allenateboming",0,14,6,8,0
"gorefish",1,8,3,5,0
"expulser",1,8,3,5,0
"flini",0,5,2,3,0
"minotaur",1,8,4,4,0
"gastrotrichlorphons",0,19,5,14,0
"leptivenebworton",0,16,6,10,0
"tibourbou",1,9,5,4,0
"physaria",1,8,3,5,0
"baitfishes",1,10,4,6,0
"fontanelle",1,10,4,6,0
"egueiite",1,8,6,2,0
"taramosalatas",1,13,6,7,0
"tepan",0,5,2,3,0
"tholing",1,7,2,5,0
"nonbook",1,7,3,4,0
"farler",1,6,2,4,0
"m'xuycy",0,7,1,6,1
"iatrogeny",1,9,4,5,0
"copic",0,5,2,3,0
"chackler",1,8,2,6,0
"peristrephical",1,14,5,9,0
"dendritically",1,13,4,9,0
"deplichannua",0,12,5,7,0
"massachus",0,9,3,6,0
"hulliest",1,8,3,5,0
"hathuns",0,7,2,5,0
"bespangling",1,11,3,8,0
"thion",0,5,2,3,0
"pithecanthropy",0,14,4,10,0
"xatpoqactbkzmewzquuzhwteex",0,26,8,18,0
"concupies",1,9,4,5,0
"punitiveness",1,12,5,7,0
"eviration",1,9,5,4,0
"rejectamenta",1,12,5,7,0
"b'iymdhpbycgovsbwmnzbr'xsa",0,26,3,23,2
"rhinry",0,6,1,5,0
"ovectiess",0,9,4,5,0
"paraffin",1,8,3,5,0
"duckweed",1,8,3,5,0
"rainiest",1,8,4,4,0
"perturbednesses",0,15,5,10,0
"apanage",1,7,4,3,0
"confestus",0,9,3,6,0
"strained",1,8,3,5,0
"wreatine",0,8,4,4,0
"tull",1,4,1,3,0
"hyme",0,4,1,3,0
"semiable",0,8,4,4,0
"sketchbook",1,10,3,7,0
"nonlepidopteral",1,15,6,9,0
"warses",0,6,2,4,0
"radca",0,5,2,3,0
"ultimogeniture",1,14,7,7,0
"klapp",1,5,1,4,0
"os'mabrswpo",0,11,3,8,1
"gharial",1,7,3,4,0
"gunnies",1,7,3,4,0
"diothelete",0,10,5,5,0
"pipistrels",1,10,3,7,0
"tidgaticas",0,10,4,6,0
"poulanganese",0,12,6,6,0
"skiddooed",1,9,4,5,0
"spinescent",1,10,3,7,0
"mmiftog",0,7,2,5,0
"quination",0,9,5,4,0
"keyway",1,6,2,4,0
"loewhgtmxyvr'wpoegjfc",0,21,4,17,1
"quieses",0,7,4,3,0
"sabellasions",0,12,5,7,0
"intioing",0,8,4,4,0
"haemorrhoidectomy",1,17,7,10,0
"syenodiment",0,11,4,7,0
"reexportant",0,11,4,7,0
"missayings",1,10,3,7,0
"unwatching",1,10,3,7,0
"incrossbreed",1,12,4,8,0
"ezwkzlckscgbkwiqxxbhaupmx",0,25,4,21,0
"narcostemmate",0,13,5,8,0
"espanola",1,8,4,4,0
"ebrdppu",0,7,2,5,0
"dilater",1,7,3,4,0
"antevens",0,8,3,5,0
"contracoralliable",0,17,7,10,0
"giefer",1,6,3,3,0
"roly",0,4,1,3,0
"recushion",1,9,4,5,0
"dermococcus",1,11,4,7,0
"ells",1,4,1,3,0
"ardowarinompee",0,14,7,7,0
"amabelle",1,8,4,4,0
"stabilisator",1,12,5,7,0
"steiger",1,7,3,4,0
"ilatrouctientelogenhsnkller",0,27,10,17,0
"contilbas",0,9,3,6,0
"ckkils",0,6,1,5,0
"xsjcqdbwvartqqlizdkcbukzfu'rx",0,29,4,25,1
"pseudosolution",1,14,7,7,0
"stomate",1,7,3,4,0
"preemptory",1,10,3,7,0
"barranquitas",1,12,5,7,0
"simplificators",1,14,5,9,0
"londony",1,7,2,5,0
"encinal",1,7,3,4,0
"nikethamide",1,11,5,6,0
"muckobowemidphongelisang",0,24,9,15,0
"levistone",0,9,4,5,0
"oppressionist",1,13,5,8,0
"subinflamed",0,11,4,7,0
"herodiagnosticises",0,18,8,10,0
"superathletes",1,13,5,8,0
"inclewestasms",0,13,4,9,0
"unkenness",0,9,3,6,0
"waggling",1,8,2,6,0
"lisaticieninnes",0,15,7,8,0
"galactosaemia",1,13,7,6,0
"brtinprs",0,8,1,7,0
"osteoplasm",0,10,4,6,0
"socinianizer",0,12,6,6,0
"ddnames",0,7,2,5,0
"hamostombloid",0,13,5,8,0
"ardblessia",0,10,4,6,0
"entfaoilff",1,10,4,6,0
"bedsock",1,7,2,5,0
"smastanotaca",0,12,5,7,0
"jamlin",0,6,2,4,0
"omela",0,5,3,2,0
"loundered",1,9,4,5,0
"alskss",0,6,1,5,0
"ckalus",0,6,2,4,0
"apetian",0,7,4,3,0
"blorducklletingatanataredictlidridotenblerdaidgidrbbrgexictidssehrotartrvslineroskomaniloiven",0,93,33,60,0
"bipupillate",1,11,5,6,0
"ygmckn'cy",0,9,0,9,1
"hamer",1,5,2,3,0
"rpsah",0,5,1,4,0
"annishegst",0,10,3,7,0
"daybreak",1,8,3,5,0
"ckilppere",0,9,3,6,0
"predikant",1,9,3,6,0
"choroidal",1,9,4,5,0
"osetioerr",0,9,5,4,0
"rhizopogon",1,10,4,6,0
"jluubmsegpz",0,11,3,8,0
"vanampramang",0,12,4,8,0
"untingisomicies",0,15,7,8,0
"uppe",0,4,2,2,0
"spanner",1,7,2,5,0
"pleasurer",1,9,4,5,0
"supercommentary",1,15,5,10,0
"subcolony",1,9,3,6,0
"gasoles",0,7,3,4,0
"slimulacidae",0,12,6,6,0
"ponties",1,7,3,4,0
"fowlstown",1,9,2,7,0
"woodcarvings",1,12,4,8,0
"brewed",1,6,2,4,0
"ligandified",0,11,5,6,0
"spairs",0,6,2,4,0
"rader",0,5,2,3,0
"unformule",0,9,4,5,0
"oporto",1,6,3,3,0
"xerographically",1,15,5,10,0
"earthlies",1,9,4,5,0
"coggie",1,6,3,3,0
"asteartamp",0,10,4,6,0
"viclvegbttlbxjxg",0,16,2,14,0
"semiproduct",0,11,4,7,0
"tholobates",1,10,4,6,0
"mailrooms",1,9,4,5,0
"coroebuck",0,9,4,5,0
"inell",0,5,2,3,0
"ballses",1,7,2,5,0
"tollination",0,11,5,6,0
"owerance",1,8,4,4,0
"unmellow",1,8,3,5,0
"calboomenaldalowshetonamete",0,27,12,15,0
"peoria",1,6,4,2,0
"pyospermous",0,11,4,7,0
"neclowsogriaroal",0,16,7,9,0
"carinthia",1,9,4,5,0
"nifes",1,5,2,3,0
"caphor",0,6,2,4,0
"gemmipara",1,9,4,5,0
"sobrieties",1,10,5,5,0
"roemisties",0,10,5,5,0
"strigiformes",1,12,4,8,0
"uapreranonesheneyioerabintutesoicoy",0,35,18,17,0
"jbqkwwshfjoloxiwtozk",0,20,4,16,0
"kalapooia",1,9,6,3,0
"doctors",1,7,2,5,0
"illoguerrate",0,12,6,6,0
"platinichloridae",0,16,7,9,0
"coverorthwateraces",0,18,7,11,0
"nonchanneled",1,12,4,8,0
"higgs",1,5,1,4,0
"supercerebrally",1,15,5,10,0
"trinitis",0,8,3,5,0
"cutags",0,6,2,4,0
"knockwursts",1,11,2,9,0
"terrance",1,8,3,5,0
"deserveniest",0,12,5,7,0
"hydrodictyaceae",1,15,6,9,0
"phrante",0,7,2,5,0
"aggravates",1,10,4,6,0
"abnesses",0,8,3,5,0
"diversional",1,11,5,6,0
"beggarwoman",1,11,4,7,0
"acrotreta",1,9,4,5,0
"chestes",0,7,2,5,0
"serscepheerrnahi",0,16,6,10,0
"chickening",1,10,3,7,0
"unabstentious",1,13,6,7,0
"minaniles",0,9,4,5,0
"taliphthalishiri",0,16,6,10,0
"temvimarid",0,10,4,6,0
"unsarepre",0,9,4,5,0
"kakiemon",1,8,4,4,0
"dikers",1,6,2,4,0
"mariande",1,8,4,4,0
"of'lhrzrnvgigytw'q",0,18,2,16,2
"chocatapers",0,11,4,7,0
"unnocerastigmatise",0,18,8,10,0
"wephalus",0,8,3,5,0
"kaleb",1,5,2,3,0
"crotalid",1,8,3,5,0
"nonmutability",1,13,5,8,0
"camokophots",0,11,4,7,0
"schlater",1,8,2,6,0
"smnijqiagynu",0,12,4,8,0
"vpfzdanrthuyaagplogugm",0,22,6,16,0
"creadweedbandificary",0,20,8,12,0
"nonralised",0,10,4,6,0
"compervos",0,9,3,6,0
"ically",0,6,2,4,0
"subvertively",0,12,4,8,0
"litterbug",1,9,3,6,0
"natricinae",1,10,5,5,0
"venes",0,5,2,3,0
"remantle",1,8,3,5,0
"patrico",1,7,3,4,0
"argotin",0,7,3,4,0
"rdngter",0,7,1,6,0
"impetulancewoods",0,16,7,9,0
"accsdwjgmhynx'ghrpyus'qeisj",0,27,4,23,2
"bastian",1,7,3,4,0
"anola",0,5,3,2,0
"stahlhelm",1,9,2,7,0
"combustions",1,11,4,7,0
"hypnoidization",1,14,6,8,0
"predeclared",1,11,4,7,0
"cochise",1,7,3,4,0
"geminaria",0,9,5,4,0
"usa",1,3,2,1,0
"orfe",1,4,2,2,0
"somniloquisms",1,13,5,8,0
"unordiableissals",0,16,7,9,0
"predebates",0,10,4,6,0
"ropillable",0,10,4,6,0
"pickadillies",1,12,5,7,0
"eocndeycwqabjk",0,14,4,10,0
"dotrel",1,6,2,4,0
"befishattineffaragrimus",0,23,9,14,0
"hyperdeifying",1,13,4,9,0
"quatite",0,7,4,3,0
"undecently",1,10,3,7,0
"distensions",1,11,4,7,0
"lambrequins",1,11,4,7,0
"injucundity",1,11,4,7,0
"hfcdylbrommyqiiuujf",0,19,5,14,0
"rootwalt",1,8,3,5,0
"benedetto",1,9,4,5,0
"vfeylsskwrbyzhitmvy",0,19,2,17,0
"shakudo",1,7,3,4,0
"hypernatraemia",1,14,6,8,0
"looping",1,7,3,4,0
"cagancord'indippis",0,18,6,12,1
"terrailer",0,9,4,5,0
"hyrambic",0,8,2,6,0
"geayost",0,7,3,4,0
"retrodict",1,9,3,6,0
"redistinguishability",0,20,8,12,0
"amadercharaswongee",0,18,8,10,0
"pandolent",0,9,3,6,0
"ubh",0,3,1,2,0
"megadeationate",0,14,8,6,0
"gry",1,3,0,3,0
"postcarotid",1,11,4,7,0
"shevron",0,7,2,5,0
"guanay",1,6,3,3,0
"nictating",1,9,3,6,0
"viabilities",1,11,6,5,0
"nimious",1,7,4,3,0
"cayu",0,4,2,2,0
"himirdiomimae",0,13,7,6,0
"wases",1,5,2,3,0
"teolitier",0,9,5,4,0
"pretiring",1,9,3,6,0
"pregallycetherocheher",0,21,7,14,0
"merri",1,5,2,3,0
"karl",1,4,1,3,0
"respiritleatherianises",0,22,10,12,0
"qvpyamkkzepmozkdrdjejvqhuu",0,26,6,20,0
"cvpddlg'd",0,9,0,9,1
"lothatustaterresensthys",0,23,7,16,0
"divinitrical",0,12,5,7,0
"stration",0,8,3,5,0
"cromerian",1,9,4,5,0
"commandering",0,12,4,8,0
"wisecrack",1,9,3,6,0
"dovevinsonal",0,12,5,7,0
"eodiscid",1,8,4,4,0
"smiddied",1,8,3,5,0
"rgisseur",1,8,3,5,0
"iridochoroiditis",1,16,8,8,0
"nonapprehensible",1,16,6,10,0
"pneumonologic",0,13,6,7,0
"uryemarindramays",0,16,6,10,0
"batement",1,8,3,5,0
"decendo",0,7,3,4,0
"dolma",1,5,2,3,0
"dowelltown",1,10,3,7,0
"deksc",0,5,1,4,0
"stibbles",1,8,2,6,0
"leopoldville",1,12,5,7,0
"counmolo",0,8,4,4,0
"'tgmetshyqscly",0,14,1,13,1
"unmilled",1,8,3,5,0
"chispreticism",0,13,4,9,0
"tobelief",0,8,4,4,0
"ay",1,2,1,1,0
"incs",0,4,1,3,0
"tttid",0,5,1,4,0
"schizogenesis",1,13,5,8,0
"hymisathos",0,10,3,7,0
"hircinous",1,9,4,5,0
"immutoriacaletably",0,18,8,10,0
"megaloglossia",1,13,6,7,0
"dreadfeet",0,9,4,5,0
"doxorubicin",1,11,5,6,0
"milfay",1,6,2,4,0
"misquote",1,8,4,4,0
"xasclhcwnngdyhe",0,15,2,13,0
"meinie",1,6,4,2,0
"schoolbooks",1,11,4,7,0
"obola",1,5,3,2,0
"incommunicide",0,13,6,7,0
"hoosing",0,7,3,4,0
"glower",1,6,2,4,0
"asmodeus",1,8,4,4,0
"marchereberanking",0,17,6,11,0
"iwifps",0,6,2,4,0
"pviudanrtepzoyqql",0,17,5,12,0
"'aridragzthlzkdqqiwohxtps",0,25,5,20,1
"synoetic",1,8,3,5,0
"conitridineston",0,15,6,9,0
"justiciary",1,10,4,6,0
"nearish",1,7,3,4,0
"bartonia",1,8,4,4,0
"einthoven",1,9,4,5,0
"analcimite",1,10,5,5,0
"amp",1,3,1,2,0
"oniscus",1,7,3,4,0
"forbite",1,7,3,4,0
"enjoymentrobenza",0,16,6,10,0
"oversusceptible",1,15,6,9,0
"aeluroidea",1,10,7,3,0
"pages",1,5,2,3,0
"chie",0,4,2,2,0
"booklear",1,8,4,4,0
"rangian",0,7,3,4,0
"lamellibranchs",1,14,4,10,0
"pufi",0,4,2,2,0
"preassement",0,11,4,7,0
"hayrack",1,7,2,5,0
"cilypconchamensotrlintphed",0,26,7,19,0
"outmagic",1,8,4,4,0
"antifascists",1,12,4,8,0
"monocornithecaleorhizations",0,27,12,15,0
"alethiological",1,14,7,7,0
"pronoma",0,7,3,4,0
"slouchiness",1,11,4,7,0
"coemployment",1,12,4,8,0
"econansispocaleconiant",0,22,10,12,0
"ilmtnaxewfgq'u",0,14,4,10,1
"couplickanteaprome",0,18,8,10,0
"oqznsjkt'wqx'p",0,14,1,13,2
"clineum",0,7,3,4,0
"driploverners",0,13,4,9,0
"tnpjsuwuqy",0,10,2,8,0
"mussitation",1,11,5,6,0
"warpowers",1,9,3,6,0
"exploration",1,11,5,6,0
"psend",1,5,1,4,0
"vivisector",1,10,4,6,0
"smri",0,4,1,3,0
"amphiprions",0,11,4,7,0
"pigsney",1,7,2,5,0
"quild",0,5,2,3,0
"epitheliosporangioprecipitally",0,30,13,17,0
"praly",0,5,1,4,0
"martsen",1,7,2,5,0
"ijgjfwqn'tu",0,11,2,9,1
"lundquists",0,10,3,7,0
"nonsubtleties",1,13,5,8,0
"pathacin",0,8,3,5,0
"villard",1,7,2,5,0
"brylloothwiforlfianpimanes",0,26,9,17,0
"aerographics",1,12,5,7,0
"suhuaro",1,7,4,3,0
"gradly",0,6,1,5,0
"plazatteadersequelysese",0,23,10,13,0
"treadheartesis",0,14,6,8,0
"alves",1,5,2,3,0
"darkley",0,7,2,5,0
"snr",1,3,0,3,0
"meanspiritednesses",1,18,7,11,0
"bead",1,4,2,2,0
"hnqvhzteqjgigf'rmreq",0,20,3,17,1
"tom",1,3,1,2,0
"interforce",1,10,4,6,0
"cosmopolites",1,12,5,7,0
"ghent",1,5,1,4,0
"idiotisms",1,9,4,5,0
"detally",0,7,2,5,0
"nonmannerlessness",0,17,5,12,0
"sorediform",1,10,4,6,0
"ther",0,4,1,3,0
"diaphancy",0,9,3,6,0
"intrusionist",1,12,5,7,0
"torchers",1,8,2,6,0
"boutonniares",1,12,6,6,0
"eqixpous'xcdjjprivmoqgz",0,23,6,17,1
"qestxjedvrki",0,12,3,9,0
"rotographed",1,11,4,7,0
"retaxingly",0,10,3,7,0
"gunxs'",0,6,1,5,1
"magocisa",0,8,4,4,0
"archdiocesian",0,13,6,7,0
"donge",0,5,2,3,0
"vindicatorily",1,13,5,8,0
"flm",0,3,0,3,0
"daller",0,6,2,4,0
"rguyvluibpkxmhoneqrztdifh",0,25,6,19,0
"photyphostudicalisating",0,23,8,15,0
"adlumines",0,9,4,5,0
"illimicra",0,9,4,5,0
"ymmt'nbdyagy",0,12,1,11,1
"albertin",1,8,3,5,0
"rhabdom",1,7,2,5,0
"intented",1,8,3,5,0
"melanconiaceae",1,14,8,6,0
"aphasic",1,7,3,4,0
"winegrologue",0,12,6,6,0
"toxodontidae",0,12,6,6,0
"malodia",0,7,4,3,0
"thoracobronchophous",0,19,7,12,0
"unsulphurised",1,13,5,8,0
"'achhjoczzgvuzz",0,15,3,12,1
"priapic",1,7,3,4,0
"syzygetically",1,13,3,10,0
"avechy",0,6,2,4,0
"scammificatasaccouries",0,22,10,12,0
"phocide",0,7,3,4,0
"marshinesses",1,12,4,8,0
"inconcierge",0,11,5,6,0
"nonhostily",0,10,3,7,0
"oblique",1,7,4,3,0
"housecleaner",1,12,6,6,0
"gallabia",1,8,4,4,0
"trvinde",0,7,2,5,0
"pewholder",1,9,3,6,0
"mulleecate",0,10,5,5,0
"''asdqoknpdirtc",0,15,3,12,2
"comale",0,6,3,3,0
"reinaugurated",1,13,7,6,0
"funguish",0,8,3,5,0
"ichy",0,4,1,3,0
"selachidae",0,10,5,5,0
"untrantist",0,10,3,7,0
"bisayabiliter",0,13,6,7,0
"fzzoawzd",0,8,2,6,0
"eschin",0,6,2,4,0
"chorded",1,7,2,5,0
"zgwjcyhrfsx",0,11,0,11,0
"cogo",0,4,2,2,0
"noncastigating",1,14,5,9,0
"sclerotizations",1,15,6,9,0
"tuition",1,7,4,3,0
"harunobu",1,8,4,4,0
"goldarnedest",1,12,4,8,0
"umbine",0,6,3,3,0
"elentimuls",0,10,4,6,0
"unpagrest",0,9,3,6,0
"djiv",0,4,1,3,0
"secretor",1,8,3,5,0
"unclaimed",1,9,4,5,0
"apotropaism",1,11,5,6,0
"contextual",1,10,4,6,0
"coccolithophragma",0,17,6,11,0
"aleintind",0,9,4,5,0
"digonous",1,8,4,4,0
"dians",0,5,2,3,0
"trucaenesses",0,12,5,7,0
"cus",0,3,1,2,0
"actinozoa",1,9,5,4,0
"gowmbqtisisaczd",0,15,4,11,0
"nethermost",1,10,3,7,0
"outcrafties",1,11,5,6,0
"ances",0,5,2,3,0
"distilland",1,10,3,7,0
"ramversistings",0,14,4,10,0
"qnjxhqpkiocmuulhopovhq",0,22,6,16,0
"sulfamethane",0,12,5,7,0
"calamostachys",1,13,4,9,0
"trichoepithelioma",1,17,8,9,0
"coollybag",0,9,3,6,0
"urerereg",0,8,4,4,0
"revascularizations",1,18,8,10,0
"scaithless",1,10,3,7,0
"blesul",0,6,2,4,0
"chaetopodous",1,12,6,6,0
"coulle",0,6,3,3,0
"tacles",0,6,2,4,0
"matl",0,4,1,3,0
"warrennessean",0,13,5,8,0
"liveborn",1,8,3,5,0
"entrainesses",0,12,5,7,0
"tunhood",0,7,3,4,0
"dattochlorinax",0,14,5,9,0
"cowskin",1,7,2,5,0
"lamoureux",1,9,5,4,0
"prognosy",0,8,2,6,0
"devland",1,7,2,5,0
"uredospores",1,11,5,6,0
"poliorcetics",1,12,5,7,0
"thiourea",1,8,5,3,0
"untouchable",1,11,5,6,0
"remens",1,6,2,4,0
"dusty",1,5,1,4,0
"lupis",1,5,2,3,0
"bohora",1,6,3,3,0
"ppeqklfighzyimygroelh",0,21,5,16,0
"sftngquejklfl'",0,14,2,12,1
"cushier",1,7,3,4,0
"eal",1,3,2,1,0
"sweepingly",1,10,3,7,0
"melanotis",1,9,4,5,0
"lodens",1,6,2,4,0
"nonarticulator",0,14,6,8,0
"leukoplasmagala",0,15,7,8,0
"swordfish",1,9,2,7,0
"nuryton",0,7,2,5,0
"cdmgxckobz",0,10,1,9,0
"qnsluzpzba",0,10,2,8,0
"prelabour",1,9,4,5,0
"dqfleffjto'agjtfl",0,17,3,14,1
"trales",0,6,2,4,0
"finney",1,6,2,4,0
"diadems",1,7,3,4,0
"zeytslbaxcng",0,12,2,10,0
"admiraunces",1,11,5,6,0
"tisbe",1,5,2,3,0
"psychasthenic",1,13,3,10,0
"reorganisation",1,14,7,7,0
"fayworloverlusivalroaker",0,24,10,14,0
"mumbell",0,7,2,5,0
"erinssts",0,8,2,6,0
"hvn",0,3,0,3,0
"wheatears",1,9,4,5,0
"entempest",1,9,3,6,0
"pyrophotography",1,15,4,11,0
"unsoul",1,6,3,3,0
"lcqplgixs'bllgqoi",0,17,3,14,1
"gossipmongering",1,15,5,10,0
"isman",1,5,2,3,0
"intrathorne",0,11,4,7,0
"pericycle",1,9,3,6,0
"chlorinising",1,12,4,8,0
"tonnishness",1,11,3,8,0
"saeima",1,6,4,2,0
"timist",1,6,2,4,0
"lakewood",1,8,4,4,0
"zoophagan",1,9,4,5,0
"pauricidae",0,10,6,4,0
"formwisemicron",0,14,5,9,0
"minerowalat",0,11,5,6,0
"neufchetel",1,10,4,6,0
"harebottled",0,11,4,7,0
"tappishnesses",0,13,4,9,0
"fraunded",0,8,3,5,0
"ujn",0,3,1,2,0
"jamms",0,5,1,4,0
"preceremonial",1,13,6,7,0
"vently",0,6,1,5,0
"bblidd",0,6,1,5,0
"repleteness",1,11,4,7,0
"neoytterbium",1,12,5,7,0
"enforte",0,7,3,4,0
"ganaycrodinugarinolesaths",0,25,10,15,0
"udiararomeffrdsicha",0,19,8,11,0
"zestfulnesses",1,13,4,9,0
"loggia",1,6,3,3,0
"wollop",1,6,2,4,0
"parjhyvjyuuk",0,12,3,9,0
"sayarbobiserbolutrosoxyllamfoly",0,31,11,20,0
"lumnilogistilise",0,16,7,9,0
"toyyrepbxmhwxk",0,14,2,12,0
"metheglins",1,10,3,7,0
"midedoos",0,8,4,4,0
"ekxkoicppu",0,10,4,6,0
"atepun",0,6,3,3,0
"fuxwiolalertinqutsias",0,21,9,12,0
"hoppergrass",1,11,3,8,0
"nqofbp",0,6,1,5,0
"superb",1,6,2,4,0
"dews",1,4,1,3,0
"laicity",1,7,3,4,0
"dissimilable",0,12,5,7,0
"appeaching",1,10,4,6,0
"exuviating",1,10,5,5,0
"catte",0,5,2,3,0
"absconded",1,9,3,6,0
"ristic",0,6,2,4,0
"ophthalmia",1,10,4,6,0
"luminodynamism",1,14,5,9,0
"remonstrangula",0,14,5,9,0
"introspective",1,13,5,8,0
"kingpins",1,8,2,6,0
"limacologies",1,12,6,6,0
"balsamy",1,7,2,5,0
"thoracica",1,9,4,5,0
"antichristianism",1,16,6,10,0
"hubbubs",1,7,2,5,0
"coproduct",1,9,3,6,0
"lddyxysoisfztt",0,14,2,12,0
"enterpriseless",1,14,5,9,0
"evaristus",1,9,4,5,0
"nonier",0,6,3,3,0
"patio",1,5,3,2,0
"creilunip",0,9,4,5,0
"alcestis",1,8,3,5,0
"ousel",1,5,3,2,0
"correllow",0,9,3,6,0
"gcohhbrnrub",0,11,2,9,0
"chaetosomatidae",1,15,8,7,0
"ruckoponotativelifords",0,22,9,13,0
"qcakmzsxahgsqrmcf'",0,18,2,16,1
"fanya",1,5,2,3,0
"preoculateness",0,14,6,8,0
"boerne",1,6,3,3,0
"slyn",0,4,0,4,0
"overproporting",0,14,5,9,0
"representationalistic",1,21,9,12,0
"bipaleomachyme",0,14,6,8,0
"wife",1,4,2,2,0
"sestiad",1,7,3,4,0
"pitarenerecliorenalyamunck",0,26,11,15,0
"inconium",0,8,4,4,0
"pricket",1,7,2,5,0
"redliness",0,9,3,6,0
"hopping",1,7,2,5,0
"lactors",0,7,2,5,0
"statutoriness",1,13,5,8,0
"unpacify",0,8,3,5,0
"colonese",0,8,4,4,0
"glazia",0,6,3,3,0
"unhasps",1,7,2,5,0
"lity",0,4,1,3,0
"appertain",1,9,4,5,0
"hypersuadabilities",0,18,8,10,0
"unpursue",0,8,4,4,0
"notaeal",1,7,4,3,0
"drewsey",1,7,2,5,0
"gambade",1,7,3,4,0
"lost",1,4,1,3,0
"lacewing",1,8,3,5,0
"yciryplqikqo",0,12,3,9,0
"epike",0,5,3,2,0
"mesophaga",0,9,4,5,0
"deutschmarking",0,14,4,10,0
"yixeuiffxzjjetonzxmagksokq",0,26,8,18,0
"lyardiaphs",0,10,3,7,0
"chokehold",1,9,3,6,0
"whang",1,5,1,4,0
"regoliths",1,9,3,6,0
"britza",0,6,2,4,0
"fryd",1,4,0,4,0
"soliotonseiandevacompling",0,25,11,14,0
"nonresist",0,9,3,6,0
"reinitiating",1,12,6,6,0
"jargonisingly",0,13,4,9,0
"unmanacles",1,10,4,6,0
"ldsnigsm",0,8,1,7,0
"marbardabling",0,13,4,9,0
"mtx",1,3,0,3,0
"copiums",0,7,3,4,0
"j'uhzkigtoiohjwwca",0,18,6,12,1
"lipotrophy",1,10,3,7,0
"uneregl",0,7,3,4,0
"surfboard",1,9,3,6,0
"sica",0,4,2,2,0
"antiferous",0,10,5,5,0
"prestrainedly",0,13,4,9,0
"erythroxylaceous",1,16,6,10,0
"'zn",0,3,0,3,1
"ontonagon",1,9,4,5,0
"niaselanesiltsptad",0,18,7,11,0
"effluencies",0,11,5,6,0
"neury",0,5,2,3,0
"daalder",1,7,3,4,0
"larth",0,5,1,4,0
"chongjin",1,8,2,6,0
"sinope",1,6,3,3,0
"apocritariness",0,14,6,8,0
"contranspositologist",0,20,7,13,0
"boaumbrounme",0,12,6,6,0
"begly",0,5,1,4,0
"weins",0,5,2,3,0
"arrange",1,7,3,4,0
"frostily",1,8,2,6,0
"tkckwoiyfsbe",0,12,3,9,0
"'lfnzmfxsiecki",0,14,3,11,1
"divnxpdinssgwwqsn",0,17,2,15,0
"comices",1,7,3,4,0
"aesthesiveness",0,14,6,8,0
"peging",0,6,2,4,0
"supremum",1,8,3,5,0
"isoquinonic",0,11,6,5,0
"kq",0,2,0,2,0
"aushar",1,6,3,3,0
"infulness",0,9,3,6,0
"anticonfederationism",1,20,9,11,0
"restousplancy",0,13,4,9,0
"buen",0,4,2,2,0
"gelsmrjbcrmbvymhr''ft",0,21,1,20,2
"pilosity",1,8,3,5,0
"'kj'mbp",0,7,0,7,2
"theing",0,6,2,4,0
"viagra",1,6,3,3,0
"cvskftu'latyilzuhrmzkay",0,23,5,18,1
"saming",0,6,2,4,0
"lementlerymelibrails",0,20,7,13,0
"graphiacolduckmang",0,18,6,12,0
"retraining",1,10,4,6,0
"proenforce",0,10,4,6,0
"taediums",1,8,4,4,0
"standoffishly",1,13,3,10,0
"aticonophodeopamy",0,17,8,9,0
"achtenpheul",0,11,4,7,0
"tentaculite",1,11,5,6,0
"tenneedilioneturonoceleron",0,26,13,13,0
"bableness",0,9,3,6,0
"likerish",1,8,3,5,0
"southes",0,7,3,4,0
"barytine",1,8,3,5,0
"ture",0,4,2,2,0
"fanzine",1,7,3,4,0
"yrent",1,5,1,4,0
"irresolubly",1,11,4,7,0
"chlorobromides",1,14,5,9,0
"lhdenjcnahg",0,11,2,9,0
"billyoh",1,7,2,5,0
"rowanberry",1,10,3,7,0
"reconstitutional",0,16,7,9,0
"remittee",1,8,4,4,0
"protoselachii",1,13,6,7,0
"acnosis",0,7,3,4,0
"misquott",0,8,3,5,0
"schwinged",0,9,2,7,0
"drawgate",1,8,3,5,0
"agoginonbouquism",0,16,8,8,0
"noneventfully",0,13,4,9,0
"mann",1,4,1,3,0
"includenny",0,10,3,7,0
"demoiser",0,8,4,4,0
"misliking",1,9,3,6,0
"congruency",1,10,3,7,0
"cricket",1,7,2,5,0
"lxjqoglmwlgkorxetugd",0,20,4,16,0
"lutheraniser",1,12,5,7,0
"chxdnkmrs'kfzrgtwhkfzamnvfg",0,27,1,26,1
"ajfijvrhfkcuvdmcvcyyfvxsk",0,25,3,22,0
"ungaugenic",0,10,5,5,0
"saticisendometer",0,16,7,9,0
"canglings",0,9,2,7,0
"parakihis",0,9,4,5,0
"woodbinds",1,9,3,6,0
"coryate",1,7,3,4,0
"nonparalytic",1,12,4,8,0
"pahach",0,6,2,4,0
"huvsrsthnvnyf",0,13,1,12,0
"cardic",0,6,2,4,0
"pils",1,4,1,3,0
"bigg",1,4,1,3,0
"borollarofototionion",0,20,10,10,0
"unexactment",0,11,4,7,0
"kllmxalcuya",0,11,3,8,0
"nonelevation",1,12,6,6,0
"invilliness",0,11,4,7,0
"patt",1,4,1,3,0
"odalwoman",1,9,4,5,0
"palingeneses",1,12,5,7,0
"dazeawnnbid",0,11,4,7,0
"cheesevat",1,9,4,5,0
"trappic",0,7,2,5,0
"cedens",1,6,2,4,0
"unsheer",1,7,3,4,0
"mpeg",1,4,1,3,0
"cocciform",1,9,3,6,0
"ecoclimates",1,11,5,6,0
"toomer",1,6,3,3,0
"mediopectoral",1,13,6,7,0
"unnestled",1,9,3,6,0
"sinkhorn",0,8,2,6,0
"reaccomplishment",1,16,5,11,0
"mosher",1,6,2,4,0
"anagre",0,6,3,3,0
"groverras",0,9,3,6,0
"homophone",1,9,4,5,0
"petrarchy",0,9,2,7,0
"enfranchial",0,11,4,7,0
"celton",0,6,2,4,0
"lussier",1,7,3,4,0
"pigouts",1,7,3,4,0
"ernani",1,6,3,3,0
"cophripte",0,9,3,6,0
"nonnasan",0,8,3,5,0
"transomed",1,9,3,6,0
"roccus",1,6,2,4,0
"sames",1,5,2,3,0
"tynan",1,5,1,4,0
"uninconvenienti",0,15,7,8,0
"lampadaries",1,11,5,6,0
"linesser",0,8,3,5,0
"embrasured",1,10,4,6,0
"cypsilies",0,9,3,6,0
"heine",1,5,3,2,0
"reculustilinipefish",0,19,8,11,0
"fistier",1,7,3,4,0
"tabardieu",0,9,5,4,0
"demagogy",1,8,3,5,0
"pinacoteca",1,10,5,5,0
"delubra",1,7,3,4,0
"clarinettist",1,12,4,8,0
"m'zeofp'wgubn",0,13,3,10,2
"sfdwatvsplv",0,11,1,10,0
"coaricalidae",0,12,7,5,0
"incandescency",1,13,4,9,0
"atmjolidable",0,12,5,7,0
"fertilio",0,8,4,4,0
"privatdozent",1,12,4,8,0
"kpeidxekubnpw",0,13,4,9,0
"utuionssapacost",0,15,7,8,0
"dale",1,4,2,2,0
"hiplett",0,7,2,5,0
"schowd",0,6,1,5,0
"scavengery",1,10,3,7,0
"cercidelition",0,13,6,7,0
"plutology",1,9,3,6,0
"venuing",0,7,3,4,0
"mallinctiva",0,11,4,7,0
"unroundings",0,11,4,7,0
"urodella",1,8,4,4,0
"thinocoridae",1,12,6,6,0
"mantelpiece",1,11,5,6,0
"caressa",1,7,3,4,0
"debushes",0,8,3,5,0
"miff",1,4,1,3,0
"shameter",0,8,3,5,0
"infume",1,6,3,3,0
"mhvrsefvzulv",0,12,2,10,0
"crumblinesses",1,13,4,9,0
"alakekua",0,8,5,3,0
"bathyscapes",1,11,3,8,0
"cyphr",0,5,0,5,0
"caulome",1,7,4,3,0
"iotorriwsjoynglo",0,16,6,10,0
"gastrocnemial",1,13,5,8,0
"partyless",0,9,2,7,0
"psammon",1,7,2,5,0
"mwbydhbzqelggkdogswwfpby''manc",0,30,3,27,2
"drivas",0,6,2,4,0
"mcewensville",1,12,4,8,0
"fingboherpuzin",0,14,5,9,0
"suemplimansver",0,14,5,9,0
"txou",0,4,2,2,0
"zbqyths'cc'uxtbi",0,16,2,14,2
"hypatie",1,7,3,4,0
"phyleutro",0,9,3,6,0
"penthes",0,7,2,5,0
"molluts",0,7,2,5,0
"lynchburg",1,9,1,8,0
"deconoicomaria",0,14,8,6,0
"hurrymarkate",0,12,4,8,0
"aframerism",0,10,4,6,0
"ronstadt",1,8,2,6,0
"aysnjbdmmpca'yizja",0,18,4,14,1
"teanguomarrapalls",0,17,7,10,0
"larinae",1,7,4,3,0
"sheepherdia",0,11,5,6,0
"grecism",1,7,2,5,0
"mexia",1,5,3,2,0
"catholicos",1,10,4,6,0
"anness",0,6,2,4,0
"chatoyants",1,10,3,7,0
"windlass",1,8,2,6,0
"nonfilmcoats",0,12,4,8,0
"dgs",0,3,0,3,0
"catlett",1,7,2,5,0
"rebenediktat",0,12,5,7,0
"striolets",0,9,3,6,0
"sweemutestercies",0,16,7,9,0
"sclerotizations",1,15,6,9,0
"fette",0,5,2,3,0
"nondefinitively",1,15,6,9,0
"pem",1,3,1,2,0
"azeglio",1,7,4,3,0
"sivatherioid",1,12,6,6,0
"noninformation",1,14,6,8,0
"jaggarefalatioecissically",0,25,11,14,0
"miscopists",0,10,3,7,0
"forescutic",0,10,4,6,0
"tteli'xjjzdexfaeloprglf",0,23,6,17,1
"chusolitickiatahum",0,18,8,10,0
"florellatorship",0,15,5,10,0
"expenses",1,8,3,5,0
"atic",0,4,2,2,0
"aroure",0,6,4,2,0
"meshed",1,6,2,4,0
"gling",0,5,1,4,0
"hagablalell",0,11,4,7,0
"argentarius",1,11,5,6,0
"zygos",0,5,1,4,0
"postremote",1,10,4,6,0
"tvqqt",0,5,0,5,0
"waffly",1,6,1,5,0
"unmetheotabund",0,14,6,8,0
"brigantine",1,10,4,6,0
"buonarroti",1,10,5,5,0
"ascertainably",1,13,5,8,0
"palaeotechnological",0,19,9,10,0
"ak'wmaidakciua",0,14,7,7,1
"na'aumxpzupucsjbmsgrzobhfvt",0,27,6,21,1
"subcantor",1,9,3,6,0
"shelling",1,8,2,6,0
"trampageous",0,11,5,6,0
"unpolishedness",1,14,5,9,0
"ddancazinincexpitiounteranehengs",0,32,13,19,0
"procurate",1,9,4,5,0
"photoptus",0,9,3,6,0
"distooksy",0,9,3,6,0
"amalita",1,7,4,3,0
"ichorous",1,8,4,4,0
"steils",1,6,2,4,0
"skegness",1,8,2,6,0
"refundability",1,13,5,8,0
"submetaphoric",1,13,5,8,0
"tachymonds",0,10,2,8,0
"cottaging",1,9,3,6,0
"rakingly",1,8,2,6,0
"ovelomisheaf",0,12,6,6,0
"cistrons",1,8,2,6,0
"triboelectrifies",0,16,7,9,0
"eelcatcher",1,10,4,6,0
"sarcenet",1,8,3,5,0
"perapterrom",0,11,4,7,0
"sextantis",1,9,3,6,0
"resinlike",1,9,4,5,0
"socas",1,5,2,3,0
"lvjzk'nucwok",0,12,2,10,1
"lzayjfrivksvjtkbmmbasx",0,22,3,19,0
"bondie",1,6,3,3,0
"permutationist",1,14,6,8,0
"theorical",1,9,4,5,0
"asclerodize",0,11,5,6,0
"foamless",1,8,3,5,0
"motivations",1,11,5,6,0
"mactra",1,6,2,4,0
"sedes",1,5,2,3,0
"lancasaticophopinhs",0,19,7,12,0
"pacr",0,4,1,3,0
"sunmunopitliest",0,15,6,9,0
"smioper",0,7,3,4,0
"hoit",1,4,2,2,0
"hyperquisarravian",0,17,7,10,0
"ichthus",1,7,2,5,0
"adxyz'xpohuvldjjswwbfmivqgazdg",0,30,5,25,1
"nijholt",1,7,2,5,0
"smithied",1,8,3,5,0
"phediourorocadiceies",0,20,11,9,0
"chaise",1,6,3,3,0
"etesarytichictieplete",0,21,9,12,0
"diacromyminiggly",0,16,5,11,0
"colchick",0,8,2,6,0
"vermingly",0,9,2,7,0
"rebemire",1,8,4,4,0
"nonans",0,6,2,4,0
"oxyethyl",1,8,2,6,0
"merchandi",0,9,3,6,0
"carmine",1,7,3,4,0
"hosieries",1,9,5,4,0
"stir",1,4,1,3,0
"burtis",1,6,2,4,0
"nonimprovement",1,14,5,9,0
"trammon",1,7,2,5,0
"befrumpier",0,10,4,6,0
"trimman",0,7,2,5,0
"threats",1,7,2,5,0
"libertinage",1,11,5,6,0
"mobs",1,4,1,3,0
"cce",0,3,1,2,0
"senheil",0,7,3,4,0
"avoeradmakins",0,13,6,7,0
"hematisfilen",0,12,5,7,0
"tahoka",1,6,3,3,0
"impoporness",0,11,4,7,0
"bapopeunforalernt",0,17,7,10,0
"nonbelligerent",1,14,5,9,0
"ghastnesses",1,11,3,8,0
"aleoros",0,7,4,3,0
"bonavisboic",0,11,5,6,0
"macratanichy",0,12,4,8,0
"aydlachian",0,10,4,6,0
"herseyed",0,8,3,5,0
"welbie",1,6,3,3,0
"pindins",0,7,2,5,0
"kne",0,3,1,2,0
"parmillaquoities",0,16,8,8,0
"radioamplifier",1,14,7,7,0
"perikarya",1,9,4,5,0
"haten",0,5,2,3,0
"pruencer",0,8,3,5,0
"archos",0,6,2,4,0
"parcloses",1,9,3,6,0
"stalah",0,6,2,4,0
"trippe",1,6,2,4,0
"tectraville",0,11,4,7,0
"griqualander",1,12,5,7,0
"composters",1,10,3,7,0
"earthwomen",1,10,4,6,0
"supprection",0,11,4,7,0
"imprenable",1,10,4,6,0
"carneyed",1,8,3,5,0
"classines",0,9,3,6,0
"verberative",1,11,5,6,0
"arnelle",1,7,3,4,0
"anknes",0,6,2,4,0
"rrdjwrkkwsgj'",0,13,0,13,1
"buzz",1,4,1,3,0
"chauntingly",0,11,3,8,0
"meposkizefodopandantore",0,23,10,13,0
"entepicondylar",1,14,5,9,0
"uroschesis",1,10,4,6,0
"hopatepuldintaralaner",0,21,9,12,0
"macaglia",1,8,4,4,0
"semideaf",1,8,4,4,0
"znnbvmgrmshuwlpevt",0,18,2,16,0
"dthfysutmicqvd",0,14,2,12,0
"careys",1,6,2,4,0
"equidistantial",1,14,7,7,0
"abduced",1,7,3,4,0
"acoromaluilkl",0,13,6,7,0
"zzkeaclzvtigodhpba",0,18,5,13,0
"steedman",1,8,3,5,0
"trevets",1,7,2,5,0
"souldan",1,7,3,4,0
"cholecystectomy",1,15,4,11,0
"spanas",0,6,2,4,0
"omens",1,5,2,3,0
"fngahc'hsxt",0,11,1,10,1
"branford",1,8,2,6,0
"uneitrychen",0,11,4,7,0
"subalternational",0,16,7,9,0
"emoul",0,5,3,2,0
"best",1,4,1,3,0
"cosuffers",0,9,3,6,0
"tearooms",1,8,4,4,0
"tident",0,6,2,4,0
"strander",1,8,2,6,0
"phyticalinic",0,12,4,8,0
"carayetoachymbindienus",0,22,9,13,0
"cabbageheadedness",1,17,7,10,0
"achyranthes",1,11,3,8,0
"pangea",1,6,3,3,0
"'vefhnosdibp'qoxcqvlwmohfm",0,26,5,21,2
"hylicist",1,8,2,6,0
"hospitages",1,10,4,6,0
"inirritant",0,10,4,6,0
"platidamenorprottradjechd",0,25,8,17,0
"psjinuxbizwrg",0,13,3,10,0
"vices",1,5,2,3,0
"straitesimas",0,12,5,7,0
"rvgfhabveebsvnd",0,15,3,12,0
"thettern",0,8,2,6,0
"oosover",0,7,4,3,0
"burgoo",1,6,3,3,0
"retwine",1,7,3,4,0
"epheliaceous",0,12,7,5,0
"chiffchaff",1,10,2,8,0
"zfqxvyvmzapgpjcmkudinhowltwv",0,28,4,24,0
"rhabdomeres",1,11,4,7,0
"sanguillurethreutilization",0,26,12,14,0
"molis",0,5,2,3,0
"abernation",0,10,5,5,0
"entmegrally",0,11,3,8,0
"verras",1,6,2,4,0
"uddohoot",0,8,4,4,0
"trochoric",0,9,3,6,0
"bror",0,4,1,3,0
"similacks",0,9,3,6,0
"unshowerer",0,10,4,6,0
"disement",0,8,3,5,0
"kettering",1,9,3,6,0
"isochron",1,8,3,5,0
"nyxis",1,5,1,4,0
"laddish",1,7,2,5,0
"daxachirbetrokerate",0,19,8,11,0
"uq'uccuysvsjdhybtwjg'xs'apzsn",0,29,4,25,3
"pizilorascers",0,13,5,8,0
"trustworthier",1,13,4,9,0
"ufqciobekejnls",0,14,5,9,0
"zelophobia",1,10,5,5,0
"unlamenter",0,10,4,6,0
"anaphy",0,6,2,4,0
"shiploid",0,8,3,5,0
"dandelabration",0,14,6,8,0
"bodewash",1,8,3,5,0
"emplecton",1,9,3,6,0
"overthoud",0,9,4,5,0
"clavashi",0,8,3,5,0
"yaird",1,5,2,3,0
"chuging",0,7,2,5,0
"odoric",1,6,3,3,0
"poxidizens",0,10,4,6,0
"rhagionidae",1,11,6,5,0
"merryville",1,10,3,7,0
"calandre",1,8,3,5,0
"mauritian",1,9,5,4,0
"stricklings",0,11,2,9,0
"arjjpidxorupznu",0,15,5,10,0
"endoaorton",0,10,5,5,0
"middleborough",1,13,5,8,0
"kkjxuxfkeyvhewdu",0,16,4,12,0
"woodleaf",1,8,4,4,0
"clfus",0,5,1,4,0
"retiarian",1,9,5,4,0
"briny",1,5,1,4,0
"colopexia",1,9,5,4,0
"tropein",1,7,3,4,0
"staria",0,6,3,3,0
"isvwyujjvvddgshxc",0,17,2,15,0
"hyaenodont",1,10,4,6,0
"benuenessenthery",0,16,6,10,0
"mult",0,4,1,3,0
"mahalla",1,7,3,4,0
"fairmount",1,9,4,5,0
"zloty",1,5,1,4,0
"reseals",1,7,3,4,0
"myrtie",1,6,2,4,0
"chainlike",1,9,4,5,0
"inexposal",0,9,4,5,0
"polyamide",1,9,4,5,0
"armipotence",1,11,5,6,0
"clitate",0,7,3,4,0
"scrogs",1,6,1,5,0
"baceachen",0,9,4,5,0
"balanging",0,9,3,6,0
"velma",1,5,2,3,0
"myall",1,5,1,4,0
"scolytoids",1,10,3,7,0
"dehwar",1,6,2,4,0
"sausnes",0,7,3,4,0
"qjjpevantlt'piepoeawhvxs",0,24,7,17,1
"electrogamia",0,12,6,6,0
"regatively",0,10,4,6,0
"mrkuareluzhuxvadotprj",0,21,7,14,0
"yscqwdy",0,7,0,7,0
"cocarpacked",0,11,4,7,0
"simargandmaking",0,15,5,10,0
"hhdrqdhnl",0,9,0,9,0
"vqmkkhxrea",0,10,2,8,0
"actentinesotrack",0,16,6,10,0
"overshot",1,8,3,5,0
"ia'ujqixzupzqzizvog'ze",0,22,8,14,2
"bannerets",1,9,3,6,0
"prmw'lhaebsvqqn",0,15,2,13,1
"insecticides",1,12,5,7,0
"ysxxpygpiosjjyxqnmcmipjcyp",0,26,3,23,0
"declimatize",1,11,5,6,0
"portifory",1,9,3,6,0
"buzzardsville",0,13,4,9,0
"ichthyophagi",1,12,4,8,0
"runoff",1,6,2,4,0
"humbug",1,6,2,4,0
"nologiculor",0,11,5,6,0
"filipinization",1,14,7,7,0
"wonnie",1,6,3,3,0
"pagers",1,6,2,4,0
"lmjzimqzx'eucmkpld",0,18,3,15,1
"icnosocher",0,10,4,6,0
"unbuckram",0,9,3,6,0
"postcolonium",0,12,5,7,0
"pinomnrutithouspe",0,17,7,10,0
"ropro",0,5,2,3,0
"serpentarianism",0,15,6,9,0
"landreeve",1,9,4,5,0
"slumberings",1,11,3,8,0
"disannulation",0,13,6,7,0
"rockmart",1,8,2,6,0
"prcotinetapithie",0,16,7,9,0
"tarkashi",0,8,3,5,0
"freen",0,5,2,3,0
"schlornegrave",0,13,4,9,0
"weingly",0,7,2,5,0
"perinduinn",0,10,4,6,0
"deskman",1,7,2,5,0
"cheezinke",0,9,4,5,0
"unolareens",0,10,5,5,0
"suncems",0,7,2,5,0
"varietist",1,9,4,5,0
"gonochorismal",1,13,5,8,0
"potorthylipticuseinceriallasterammerminsing",0,43,16,27,0
"indowed",1,7,3,4,0
"compline",1,8,3,5,0
"borderer",1,8,3,5,0
"beck",1,4,1,3,0
"entomophobia",1,12,6,6,0
"centeno",1,7,3,4,0
"sai",1,3,2,1,0
"moulin",1,6,3,3,0
"diagenesis",1,10,5,5,0
"hjordis",1,7,2,5,0
"septmoncel",1,10,3,7,0
"stenotheriidae",0,14,7,7,0
"stclair",1,7,2,5,0
"epionychium",1,11,5,6,0
"gelya",1,5,2,3,0
"geb",1,3,1,2,0
"wirralee",0,8,4,4,0
"emendations",1,11,5,6,0
"sirphegce",0,9,3,6,0
"muddlehead",1,10,4,6,0
"staminous",0,9,4,5,0
"rackworks",1,9,2,7,0
"chaldani",0,8,3,5,0
"ymca",1,4,1,3,0
"hamme",0,5,2,3,0
"yvcekgrrkwrbdzjpmzixsbpfdd",0,26,2,24,0
"gempiyhsffdwqvmadvnnuqg",0,23,4,19,0
"biops",0,5,2,3,0
"desmosol",0,8,3,5,0
"aliunde",1,7,4,3,0
"scarth",1,6,1,5,0
"saddier",0,7,3,4,0
"decoad",0,6,3,3,0
"sunfield",1,8,3,5,0
"nonlaminated",1,12,5,7,0
"organograph",0,11,4,7,0
"promptnesses",1,12,3,9,0
"usance",1,6,3,3,0
"iridosmine",1,10,5,5,0
"wireworm",1,8,3,5,0
"orionholing",0,11,5,6,0
"overal",0,6,3,3,0
"cremates",1,8,3,5,0
"camparations",0,12,5,7,0
"roomthiness",1,11,4,7,0
"tritidog",0,8,3,5,0
"invills",0,7,2,5,0
"goldskirt",0,9,2,7,0
"inexpleble",1,10,4,6,0
"stemona",1,7,3,4,0
"iagmrparoqrru",0,13,5,8,0
"toponym",1,7,2,5,0
"phos",0,4,1,3,0
"wanecrudi",0,9,4,5,0
"fei",1,3,2,1,0
"birdwing",1,8,2,6,0
"fogyism",1,7,2,5,0
"commandress",1,11,3,8,0
"leakiness",1,9,4,5,0
"pllllelys",0,9,1,8,0
"nusistoguatabophydicam",0,22,9,13,0
"roberson",1,8,3,5,0
"precludes",1,9,3,6,0
"catocathartidae",0,15,7,8,0
"surreptitiousness",1,17,7,10,0
"pratfalling",1,11,3,8,0
"layptinjus",0,10,3,7,0
"electrobiologist",1,16,7,9,0
"companionage",1,12,6,6,0
"uncertitudes",0,12,5,7,0
"upknell",1,7,2,5,0
"smectic",1,7,2,5,0
"burkundauze",1,11,5,6,0
"pachyrhizus",1,11,3,8,0
"tiocrph",0,7,2,5,0
"tubicinate",1,10,5,5,0
"auxotox",1,7,4,3,0
"spirits",1,7,2,5,0
"nymphotoxemia",0,13,5,8,0
"nevoie",0,6,4,2,0
"pseudon",0,7,3,4,0
"dysadaptation",1,13,5,8,0
"sibers",0,6,2,4,0
"elands",1,6,2,4,0
"nodiform",1,8,3,5,0
"lolling",1,7,2,5,0
"perigastritis",1,13,5,8,0
"propionitril",1,12,5,7,0
"clucke",0,6,2,4,0
"rumming",0,7,2,5,0
"lagagobitherovel",0,16,7,9,0
"wass",0,4,1,3,0
"spatangoidean",1,13,6,7,0
"geoatinginolichoverreinutring",0,29,13,16,0
"kaivalya",1,8,4,4,0
"padle",1,5,2,3,0
"satang",1,6,2,4,0
"otorhinolaryngological",1,22,9,13,0
"helcotic",1,8,3,5,0
"wardmotes",1,9,3,6,0
"unilluminated",1,13,6,7,0
"prioriferozale",0,14,7,7,0
"natale",1,6,3,3,0
"intervisor",0,10,4,6,0
"biferously",0,10,4,6,0
"theanthropicality",0,17,6,11,0
"guraliquenella",0,14,7,7,0
"tilletiaceous",1,13,7,6,0
"fliest",1,6,2,4,0
"forecoleneratismounbace",0,23,11,12,0
"violiv",0,6,3,3,0
"nocturia",1,8,4,4,0
"topsiloid",0,9,4,5,0
"twaceodoacouete",0,15,9,6,0
"maitaky",0,7,3,4,0
"rounduplicated",0,14,6,8,0
"ves",0,3,1,2,0
"bracon",1,6,2,4,0
"spachinogasinthaunthovitonchallenubinoly",0,40,15,25,0
"hasetted",0,8,3,5,0
"innumerated",0,11,5,6,0
"xysuyodgfqdsmoc",0,15,3,12,0
"mesmbes",0,7,2,5,0
"psilophyton",1,11,3,8,0
"unvotegnarigoverseaeidivored",0,28,14,14,0
"rqddyiyifrqjflw",0,15,2,13,0
"bovendetemenes",0,14,6,8,0
"km'expgsxardec",0,14,3,11,1
"hammerman",1,9,3,6,0
"rollerblader",1,12,4,8,0
"boxking",0,7,2,5,0
"seminonconformist",1,17,6,11,0
"adipescent",1,10,4,6,0
"nonpliant",1,9,3,6,0
"cogency",1,7,2,5,0
"bush",1,4,1,3,0
"laconialese",0,11,6,5,0
"zzvyzuaklhrcoe",0,14,4,10,0
"advential",1,9,4,5,0
"sympathect",0,10,2,8,0
"jece",0,4,2,2,0
"geminates",1,9,4,5,0
"swedes",1,6,2,4,0
"rosensate",0,9,4,5,0
"noncoercible",1,12,5,7,0
"paramnesia",1,10,5,5,0
"bissicis",0,8,3,5,0
"scorchings",1,10,2,8,0
"volipresence",1,12,5,7,0
"ducatoons",1,9,4,5,0
"solifluction",1,12,5,7,0
"oarsmanship",1,11,4,7,0
"incliners",1,9,3,6,0
"medalled",1,8,3,5,0
"vixednessing",0,12,4,8,0
"cynege",0,6,2,4,0
"septerium",1,9,4,5,0
"'tlcxnjpwtozcqi",0,15,2,13,1
"freightscot",0,11,3,8,0
"khomeiney",0,9,4,5,0
"osmunds",1,7,2,5,0
"semihobos",1,9,4,5,0
"doletawescid",0,12,5,7,0
"demolition",1,10,5,5,0
"recalibration",1,13,6,7,0
"invariation",0,11,6,5,0
"capayees",0,8,4,4,0
"snakier",1,7,3,4,0
"etymic",1,6,2,4,0
"archaeologists",1,14,6,8,0
"weinman",1,7,3,4,0
"nonamenability",1,14,6,8,0
"gjdgebioyeswirundbdxgclcqh",0,26,6,20,0
"igivlwy'qji'jycmluwb",0,20,4,16,2
"troutperches",1,12,4,8,0
"unslapped",1,9,3,6,0
"walworth",1,8,2,6,0
"villageless",1,11,4,7,0
"indecigrad",0,10,4,6,0
"inedibleness",0,12,5,7,0
"scamparnium",0,11,4,7,0
"tuberculturally",0,15,5,10,0
"zibet",1,5,2,3,0
"hepcat",1,6,2,4,0
"lungfish",1,8,2,6,0
"gephtrin",0,8,2,6,0
"semicolognese",0,13,6,7,0
"overdomes",0,9,4,5,0
"toolbox",1,7,3,4,0
"fustian",1,7,3,4,0
"moprs",0,5,1,4,0
"prespontaneously",1,16,6,10,0
"anemochoric",1,11,5,6,0
"chyagheces",0,10,3,7,0
"rerdrd",0,6,1,5,0
"pinostor",0,8,3,5,0
"competitor",1,10,4,6,0
"sacculation",1,11,5,6,0
"chinstrap",1,9,2,7,0
"stanze",1,6,2,4,0
"dessipriseintiagryonotcas",0,25,10,15,0
"immunosuppression",1,17,7,10,0
"pectomycium",0,11,4,7,0
"arcumble",0,8,3,5,0
"linguals",1,8,3,5,0
"thestius",1,8,3,5,0
"pleatless",1,9,3,6,0
"tkknxcibikzlc",0,13,2,11,0
"kaba",0,4,2,2,0
"complacencies",1,13,5,8,0
"moolah",1,6,3,3,0
"urely",0,5,2,3,0
"masculate",1,9,4,5,0
"sarpler",1,7,2,5,0
"puaulbotzfsqqtxinwj",0,19,5,14,0
"shotman",1,7,2,5,0
"representationary",1,17,7,10,0
"omard",0,5,2,3,0
"fuero",1,5,3,2,0
"previde",1,7,3,4,0
"underbush",1,9,3,6,0
"spist",0,5,1,4,0
"orferd",1,6,2,4,0
"onslowly",0,8,2,6,0
"cerebrogans",0,11,4,7,0
"rolikathicia",0,12,6,6,0
"podargus",1,8,3,5,0
"affidavits",1,10,4,6,0
"prfpn'nanx'eoodrb'i",0,19,5,14,3
"amabel",1,6,3,3,0
"mistiffness",0,11,3,8,0
"nonculpableness",1,15,5,10,0
"nicitapelptelaters",0,18,7,11,0
"antogregunned",0,13,5,8,0
"fob",1,3,1,2,0
"exceeded",1,8,4,4,0
"spoffle",1,7,2,5,0
"diesel",1,6,3,3,0
"hokeiteugalons",0,14,7,7,0
"scourses",1,8,3,5,0
"start",1,5,1,4,0
"clining",0,7,2,5,0
"lyp'uorrcihgpcirgpmzjpvpqpyz",0,28,4,24,1
"eusthenopteron",1,14,6,8,0
"wain",1,4,2,2,0
"sibilancies",1,11,5,6,0
"favaging",0,8,3,5,0
"oceanid",1,7,4,3,0
"alorton",1,7,3,4,0
"segaltululinorcrbumitele",0,24,10,14,0
"orthopteral",1,11,4,7,0
"unsurest",1,8,3,5,0
"dravideonassively",0,17,7,10,0
"egretta",1,7,3,4,0
"monardella",1,10,4,6,0
"informers",1,9,3,6,0
"hemorphophoral",0,14,5,9,0
"xanthatharine",0,13,5,8,0
"choteau",1,7,4,3,0
"audiometrist",1,12,6,6,0
"codiscoverer",1,12,5,7,0
"flushinesses",0,12,4,8,0
"spoonbaitering",0,14,6,8,0
"degrinession",0,12,5,7,0
"corphoritotestrophalapative",0,27,11,16,0
"pristodus",1,9,3,6,0
"ransom",1,6,2,4,0
"boningly",0,8,2,6,0
"dichromatist",0,12,4,8,0
"insidiations",0,12,6,6,0
"kwic",1,4,1,3,0
"tagalog",1,7,3,4,0
"fortive",0,7,3,4,0
"style",1,5,1,4,0
"tritic",0,6,2,4,0
"crocheted",1,9,3,6,0
"remissiveness",1,13,5,8,0
"pamacchrang",0,11,3,8,0
"nondivergence",1,13,5,8,0
"metempsychosize",1,15,5,10,0
"accepter",1,8,3,5,0
"bridoons",1,8,3,5,0
"nonthinker",1,10,3,7,0
"dynon",0,5,1,4,0
"polytelecarrowties",0,18,7,11,0
"botuline",0,8,4,4,0
"overine",0,7,4,3,0
"fonteyn",1,7,2,5,0
"pufferthronalificising",0,22,8,14,0
"rucks",1,5,1,4,0
"oversoaked",1,10,5,5,0
"arief",0,5,3,2,0
"snellius",1,8,3,5,0
"rependerslipcoachetics",0,22,8,14,0
"chasteness",1,10,3,7,0
"nonexceptioner",0,14,6,8,0
"izgkf",0,5,1,4,0
"psycoron",0,8,2,6,0
"dahna",1,5,2,3,0
"bgfwlb",0,6,0,6,0
"olenus",1,6,3,3,0
"sloetrees",1,9,4,5,0
"avastinconstopoding",0,19,7,12,0
"yzhy'inpnhyctzdzkvfsfbtvlekj",0,28,2,26,1
"polyphyly",1,9,1,8,0
"upq",0,3,1,2,0
"lichis",1,6,2,4,0
"lumbricales",1,11,4,7,0
"nons",0,4,1,3,0
"paniteragevilliscrop",0,20,8,12,0
"quinaquina",1,10,6,4,0
"gions",0,5,2,3,0
"antimitotic",1,11,5,6,0
"crkehoummilemeedrpa",0,19,8,11,0
"grft",0,4,0,4,0
"twtdoeia",0,8,4,4,0
"rhineura",1,8,4,4,0
"dhotie",1,6,3,3,0
"vigesimo",1,8,4,4,0
"stomatotomy",1,11,4,7,0
"figures",1,7,3,4,0
"cabstand",1,8,2,6,0
"buford",1,6,2,4,0
"'zyhnmieorjnlhofj",0,17,4,13,1
"superaction",0,11,5,6,0
"nonconformitant",1,15,5,10,0
"laius",1,5,3,2,0
"copperworks",1,11,3,8,0
"rabblings",1,9,2,7,0
"neritina",1,8,4,4,0
"pressiveness",0,12,4,8,0
"ireland",1,7,3,4,0
"salemiuts",0,9,4,5,0
"cakkseteyzxqh'pbtffzblaymxrsvf",0,30,4,26,1
"stemes",1,6,2,4,0
"dcwjcb",0,6,0,6,0
"alhadelerianel",0,14,7,7,0
"scatback",1,8,2,6,0
"nonrepellence",1,13,5,8,0
"lepidobrogee",0,12,6,6,0
"spectator",1,9,3,6,0
"habitude",1,8,4,4,0
"nonlucratively",1,14,5,9,0
"purtion",0,7,3,4,0
"koror",1,5,2,3,0
"apophyge",1,8,3,5,0
"bssqnynry'igrhagfanxuii'y'wk'",0,29,6,23,4
"mwdjelib",0,8,2,6,0
"briticism",1,9,3,6,0
"stichter",1,8,2,6,0
"cambrications",0,13,5,8,0
"subornadoraliencolicut",0,22,10,12,0
"cageyness",1,9,3,6,0
"izuleract",0,9,4,5,0
"pigeon",1,6,3,3,0
"breadlies",0,9,4,5,0
"philographic",1,12,4,8,0
"yezidis",1,7,3,4,0
"noblenness",0,10,3,7,0
"fatratent",0,9,3,6,0
"bysacki",1,7,2,5,0
"mhimbxmv'ekidpuwzwcumlgshiqzhd",0,30,6,24,1
"arbusterol",1,10,4,6,0
"aminologically",0,14,6,8,0
"antesternal",1,11,4,7,0
"revictualling",1,13,5,8,0
"hailimelstescorobarleaplimitt",0,29,12,17,0
"rhombolaria",0,11,5,6,0
"yodelling",1,9,3,6,0
"reflexive",1,9,4,5,0
"haxdqigqffazjmipeoggoxh",0,23,7,16,0
"frontrunner",1,11,3,8,0
"lanugo",1,6,3,3,0
"fancified",1,9,4,5,0
"audaean",1,7,5,2,0
"unpurveyed",1,10,4,6,0
"nonimputable",1,12,5,7,0
"carniture",0,9,4,5,0
"rocy",0,4,1,3,0
"foqznt'jgleqhkylmq",0,18,2,16,1
"grandfatherish",1,14,4,10,0
"ctblxh'gloa",0,11,2,9,1
"epithalline",1,11,5,6,0
"ob",1,2,1,1,0
"oveeroununctinanathas",0,21,10,11,0
"zeuxian",1,7,4,3,0
"schizophreniac",1,14,5,9,0
"pfaaolc",0,7,3,4,0
"silesia",1,7,4,3,0
"heciphoniacs",0,12,5,7,0
"nunitr",0,6,2,4,0
"ruc",1,3,1,2,0
"ndrindlirets",0,12,3,9,0
"broophyrispairidiodonic",0,23,10,13,0
"alabamians",1,10,5,5,0
"s'fidr",0,6,1,5,1
"pausteragamitaries",0,18,9,9,0
"pilidretillellemeomm",0,20,8,12,0
"schists",1,7,1,6,0
"kamelaukions",1,12,6,6,0
"abitivation",0,11,6,5,0
"samothrake",1,10,4,6,0
"candescence",1,11,4,7,0
"sikas",1,5,2,3,0
"carolus",1,7,3,4,0
"rjomgdczdif",0,11,2,9,0
"fcoa'zqrr",0,9,2,7,1
"buffeting",1,9,3,6,0
"carboxylic",1,10,3,7,0
"disciplinants",1,13,4,9,0
"recor",1,5,2,3,0
"cathouses",1,9,4,5,0
"agrepagroununskile",0,18,8,10,0
"hipparchs",1,9,2,7,0
"rhodgers",0,8,2,6,0
"esys",0,4,1,3,0
"eccreanism",0,10,4,6,0
"interchanger",1,12,4,8,0
"pomins",0,6,2,4,0
"unconductive",1,12,5,7,0
"mism",0,4,1,3,0
"spondenseatinesses",0,18,7,11,0
"seferis",1,7,3,4,0
"guestments",0,10,3,7,0
"devalls",1,7,2,5,0
"goqde",0,5,2,3,0
"transept",1,8,2,6,0
"hab",0,3,1,2,0
"muales",0,6,3,3,0
"unsheathed",1,10,4,6,0
"aton",0,4,2,2,0
"drxamsiruapk",0,12,4,8,0
"decuneanius",0,11,6,5,0
"frard",0,5,1,4,0
"sclerodermas",1,12,4,8,0
"exercising",1,10,4,6,0
"nonsynonymous",1,13,4,9,0
"bucentury",0,9,3,6,0
"gutierrez",1,9,4,5,0
"dhal",1,4,1,3,0
"swqsixgprb",0,10,1,9,0
"frascatis",1,9,3,6,0
"unemin",0,6,3,3,0
"enfacednesses",0,13,5,8,0
"pava",1,4,2,2,0
"hokeyness",1,9,3,6,0
"duraplasty",1,10,3,7,0
"visias",0,6,3,3,0
"fuzeezobvvttmcicnkw",0,19,5,14,0
"ztuxqbobtfcawhw",0,15,3,12,0
"chandoval",0,9,3,6,0
"laverania",1,9,5,4,0
"knideands",0,9,3,6,0
"martensite",1,10,4,6,0
"showbreads",1,10,3,7,0
"uredro",0,6,3,3,0
"eminuss",0,7,3,4,0
"chlika",0,6,2,4,0
"ahhiyawa",1,8,4,4,0
"dindrostistreentic",0,18,6,12,0
"uncloud",1,7,3,4,0
"tergiversatile",0,14,6,8,0
"gadean",1,6,3,3,0
"atnah",1,5,2,3,0
"dysmenorrhoea",1,13,5,8,0
"pdxibjxabkaphhbsyhdd'dnq",0,24,3,21,1
"propitiator",1,11,5,6,0
"compantaribetteer",0,17,7,10,0
"succous",1,7,3,4,0
"ballad",1,6,2,4,0
"bookend",1,7,3,4,0
"hydrogenases",1,12,4,8,0
"cutset",1,6,2,4,0
"scotoscopes",0,11,4,7,0
"tempositarmina",0,14,6,8,0
"redivivous",1,10,5,5,0
"omocatroon",0,10,5,5,0
"qatar",1,5,2,3,0
"interyx",0,7,2,5,0
"sacchari",0,8,3,5,0
"qktxmiswpysdtyszpsy",0,19,1,18,0
"interpolitical",1,14,6,8,0
"geof",1,4,2,2,0
"icelanders",1,10,4,6,0
"celeski",1,7,3,4,0
"eagerly",1,7,3,4,0
"yrgconpccpd",0,11,1,10,0
"clapboarding",0,12,4,8,0
"actmenthritiann",0,15,5,10,0
"gasconaded",1,10,4,6,0
"duoitraerahssceede",0,18,9,9,0
"stursha",0,7,2,5,0
"fauchioncrafts",0,14,5,9,0
"hebridean",1,9,4,5,0
"airliner",1,8,4,4,0
"yzfporzzrulcxavfxa",0,18,4,14,0
"transmitheticalinoid",0,20,8,12,0
"kpfsztlhgyixph",0,14,1,13,0
"ctatte",0,6,2,4,0
"tagalo",1,6,3,3,0
"postcondylar",1,12,3,9,0
"mycetomatous",1,12,5,7,0
"h'",0,2,0,2,1
"informatica",1,11,5,6,0
"seradinestic",0,12,5,7,0
"focaca",0,6,3,3,0
"balkar",1,6,2,4,0
"dimwittedness",1,13,4,9,0
"jacaenotopisereliapingynontrrther",0,33,13,20,0
"kraunhia",1,8,4,4,0
"kellochemistries",0,16,6,10,0
"lithely",1,7,2,5,0
"philymafeystyps",0,15,3,12,0
"christianiser",1,13,5,8,0
"bizis",0,5,2,3,0
"itticlothiacagaturicerytang",0,27,11,16,0
"gaspesian",1,9,4,5,0
"competitions",1,12,5,7,0
"tragelaphs",1,10,3,7,0
"balsamroot",1,10,4,6,0
"arerowles",0,9,4,5,0
"tetracyclic",1,11,3,8,0
"uckluphpxktwbf'vvqcukt",0,22,3,19,1
"hurrageditenasse",0,16,7,9,0
"esme",1,4,2,2,0
"retromorphizing",0,15,5,10,0
"moltonise",0,9,4,5,0
"tapeline",1,8,4,4,0
"superoleadias",0,13,7,6,0
"quadrisectionalisable",0,21,10,11,0
"firmacy",0,7,2,5,0
"pulveration",1,11,5,6,0
"ceriops",1,7,3,4,0
"cumspecules",0,11,4,7,0
"antifeudalist",1,13,6,7,0
"unmyopia",0,8,4,4,0
"traing",0,6,2,4,0
"billatalograckinctomise",0,23,9,14,0
"vt'nnyx",0,7,0,7,1
"baburden",0,8,3,5,0
"bridgwater",1,10,3,7,0
"tornado",1,7,3,4,0
"propraetors",1,11,4,7,0
"palaeanthropologists",1,20,8,12,0
"enterestier",0,11,5,6,0
"tarawa",1,6,3,3,0
"esthonians",1,10,4,6,0
"reffing",1,7,2,5,0
"athermaphy",0,10,3,7,0
"hornstone",1,9,3,6,0
"qtoplibycwmudqaxsyxqaaeoj",0,25,8,17,0
"stag",1,4,1,3,0
"lono",0,4,2,2,0
"disusages",1,9,4,5,0
"bemist",1,6,2,4,0
"schmutterminna",0,14,4,10,0
"invictive",1,9,4,5,0
"evangelists",1,11,4,7,0
"amuses",1,6,3,3,0
"ggrtierycetetriawensnd",0,22,7,15,0
"tamarindo",1,9,4,5,0
"neseradipa",0,10,5,5,0
"europoort",1,9,5,4,0
"primatement",0,11,4,7,0
"proletariates",1,13,6,7,0
"adenoliomyelogenesis",0,20,10,10,0
"tapajoccos",0,10,4,6,0
"phonier",0,7,3,4,0
"czyswcgwhdees'tuy",0,17,3,14,1
"remunerability",1,14,6,8,0
"bmuvaekklizryquwjvjvtqz",0,23,5,18,0
"campanulaceae",1,13,7,6,0
"cholindical",0,11,4,7,0
"computationally",1,15,6,9,0
"hed",0,3,1,2,0
"icoount",0,7,4,3,0
"heaved",1,6,3,3,0
"creswell",1,8,2,6,0
"wwy'mywi",0,8,1,7,1
"mariam",1,6,3,3,0
"calumniator",1,11,5,6,0
"rcaneald",0,8,3,5,0
"clakuhqbvycqtkrpk",0,17,2,15,0
"emanatist",1,9,4,5,0
"rjbuxjqizmiahljdya",0,18,5,13,0
"phyocus",0,7,2,5,0
"diserculacedranguess",0,20,8,12,0
"disseminates",1,12,5,7,0
"uprating",1,8,3,5,0
"desirousness",1,12,5,7,0
"infarct",1,7,2,5,0
"refiled",1,7,3,4,0
"'xzonpoozu",0,10,4,6,1
"vmefpeci'",0,9,3,6,1
"bestiality",1,10,4,6,0
"autopisms",0,9,4,5,0
"gradients",1,9,3,6,0
"anticipants",1,11,4,7,0
"cabritius",0,9,4,5,0
"jerbern",0,7,2,5,0
"soga",1,4,2,2,0
"waiwa",0,5,3,2,0
"misfunctioning",1,14,5,9,0
"starto",0,6,2,4,0
"ruttishnesses",1,13,4,9,0
"photosculpturally",0,17,5,12,0
"chologynopathecian",0,18,7,11,0
"thoroughwax",1,11,4,7,0
"bronchiostenosis",1,16,6,10,0
"yetts",1,5,1,4,0
"subintrant",1,10,3,7,0
"microcracking",1,13,4,9,0
"forimackdopodowyngs",0,19,6,13,0
"twinnier",0,8,3,5,0
"'aqskfkxawirtnw",0,15,3,12,1
"expey",0,5,2,3,0
"cheapeneddick",0,13,5,8,0
"rachitism",1,9,3,6,0
"hackettes",1,9,3,6,0
"melianthaceae",1,13,7,6,0
"wolpnveotko'zg'pypcvh",0,21,4,17,2
"ininesna",0,8,4,4,0
"forheglor",0,9,3,6,0
"drugman",1,7,2,5,0
"incya",0,5,2,3,0
"zanthocephalocene",0,17,7,10,0
"corydon",1,7,2,5,0
"pown",1,4,1,3,0
"bochess",0,7,2,5,0
"distrusters",1,11,3,8,0
"phreness",0,8,2,6,0
"lochmere",1,8,3,5,0
"paragammacism",1,13,5,8,0
"intercrossing",1,13,4,9,0
"merluccius",1,10,4,6,0
"harden",1,6,2,4,0
"dustbuster",1,10,3,7,0
"xaviera",1,7,4,3,0
"blancestone",0,11,4,7,0
"algophilist",1,11,4,7,0
"fahcmuq",0,7,2,5,0
"dbbleivblhgdkderovqhly",0,22,4,18,0
"nyctitropic",1,11,3,8,0
"meterage",1,8,4,4,0
"coscob",1,6,2,4,0
"'bhpmopsfbjcxfhbyadarhhariwhg",0,29,5,24,1
"chik",1,4,1,3,0
"neuroanatomist",1,14,7,7,0
"cogredient",1,10,4,6,0
"deathingy",0,9,3,6,0
"uneaten",1,7,4,3,0
"reshufflingly",0,13,3,10,0
"governorship",1,12,4,8,0
"serjeanties",1,11,5,6,0
"jot",1,3,1,2,0
"munchiofuels",0,12,5,7,0
"evanged",0,7,3,4,0
"bobsledder",1,10,3,7,0
"peptohydrochloric",1,17,5,12,0
"prockidengeregrs",0,16,5,11,0
"mondays",1,7,2,5,0
"indrop",0,6,2,4,0
"neemba",1,6,3,3,0
"wqtyzfzuvbtlmghqvymddv",0,22,1,21,0
"rhombenporphyrs",1,15,3,12,0
"bwe'dvvgqdow'msumqopyuxor'i'q",0,29,7,22,4
"hiprells",0,8,2,6,0
"fibilifersioltiparialismatelah",0,30,14,16,0
"comystrally",0,11,2,9,0
"astaticisms",1,11,4,7,0
"schwarzkopf",1,11,2,9,0
"asterinidae",1,11,6,5,0
"catalpa",1,7,3,4,0
"nunc",1,4,1,3,0
"eamianoxy",0,9,5,4,0
"dovishness",1,10,3,7,0
"cedar",1,5,2,3,0
"binecuronchaete",0,15,7,8,0
"nazifications",1,13,6,7,0
"antitrypsin",1,11,3,8,0
"fabio",1,5,3,2,0
"writhen",1,7,2,5,0
"unneines",0,8,4,4,0
"zavijava",1,8,4,4,0
"leurons",0,7,3,4,0
"epispastics",1,11,4,7,0
"pinal",1,5,2,3,0
"euszck",0,6,2,4,0
"unreyalteateritheasappaskeuctorudictomoachic",0,44,20,24,0
"heteronymies",1,12,5,7,0
"submous",0,7,3,4,0
"ideigry",0,7,3,4,0
"poly",1,4,1,3,0
"phleas",0,6,2,4,0
"albaniz",1,7,3,4,0
"outspeed",1,8,4,4,0
"thion",0,5,2,3,0
"regalvanizing",1,13,5,8,0
"paratry",0,7,2,5,0
"rubato",1,6,3,3,0
"imperic",0,7,3,4,0
"reproof",1,7,3,4,0
"synesses",0,8,2,6,0
"kaycee",1,6,3,3,0
"desaturations",1,13,6,7,0
"farchechmael",0,12,4,8,0
"pselaphidae",1,11,5,6,0
"contributed",1,11,4,7,0
"pae",0,3,2,1,0
"extraduodecimality",0,18,8,10,0
"f'zzifleybdnyawodpda",0,20,5,15,1
"unsherods",0,9,3,6,0
"rotties",0,7,3,4,0
"pupeswowis",0,10,4,6,0
"particle",1,8,3,5,0
"landfall",1,8,2,6,0
"extradomestic",1,13,5,8,0
"pearlabours",0,11,5,6,0
"q",1,1,0,1,0
"probles",0,7,2,5,0
"monkeynuts",1,10,3,7,0
"epectombamo",0,11,5,6,0
"incircumscription",1,17,6,11,0
"godelich",1,8,3,5,0
"potinebor",0,9,4,5,0
"prick",1,5,1,4,0
"alier",0,5,3,2,0
"traik",1,5,2,3,0
"hxofkvlpdmogpgzkdo",0,18,3,15,0
"penned",1,6,2,4,0
"microtogeny",0,11,4,7,0
"temecipaenc",0,11,5,6,0
"energiser",1,9,4,5,0
"contemplant",1,11,3,8,0
"shonery",0,7,2,5,0
"sk'dhp'mus",0,10,1,9,2
"callituveimold",0,14,6,8,0
"wiffle",1,6,2,4,0
"trecentos",1,9,3,6,0
"urmuvoron'q'xttowwrdzto'kjxl",0,28,6,22,3
"anticatalysts",1,13,4,9,0
"pachisis",1,8,3,5,0
"diplasmad",0,9,3,6,0
"swamy",1,5,1,4,0
"crometrologing",0,14,5,9,0
"flyswat",1,7,1,6,0
"rothentabononvaickhery",0,22,8,14,0
"shitwork",1,8,2,6,0
"foilsons",0,8,3,5,0
"mithgarth",1,9,2,7,0
"tradised",0,8,3,5,0
"cium",0,4,2,2,0
"odwmtbszxjbbmqfi'qudbouif",0,25,6,19,1
"kleptomes",0,9,3,6,0
"zrlsncrhqu",0,10,1,9,0
"chantherevilloughts",0,19,6,13,0
"hys",0,3,0,3,0
"pressureless",1,12,4,8,0
