word,present,len,vowels,consonants,nonletters,vtc
prone,1,5,2,3,0,0.666666666666667
avematussonguarappin,0,20,9,11,0,0.818181818181818
signories,1,9,4,5,0,0.8
mpffpknrop,0,10,1,9,0,0.111111111111111
gangst,0,6,1,5,0,0.2
lienise,0,7,4,3,0,1.33333333333333
hru'ukgamabxzhekekkrx,0,21,6,15,1,0.4
guaiacum,1,8,5,3,0,1.66666666666667
ln'zmwjhq,0,9,0,9,1,0
icins,0,5,2,3,0,0.666666666666667
preexplode,1,10,4,6,0,0.666666666666667
parvely,0,7,2,5,0,0.4
nonliterate,1,11,5,6,0,0.833333333333333
taklamatic,0,10,4,6,0,0.666666666666667
overmuries,0,10,5,5,0,1
iulus,1,5,3,2,0,1.5
christener,1,10,3,7,0,0.428571428571429
vasotocin,1,9,4,5,0,0.8
difica,0,6,3,3,0,1
teriann,1,7,3,4,0,0.75
frankston,1,9,2,7,0,0.285714285714286
skwbksu,0,7,1,6,0,0.166666666666667
phalanstery,1,11,3,8,0,0.375
pelara,0,6,3,3,0,1
germaterin,0,10,4,6,0,0.666666666666667
bullwinkle,1,10,3,7,0,0.428571428571429
electricharriagend,0,18,7,11,0,0.636363636363636
exin,0,4,2,2,0,1
nondramatically,1,15,5,10,0,0.5
akhes,0,5,2,3,0,0.666666666666667
humohagyra,0,10,4,6,0,0.666666666666667
marsorbel,0,9,3,6,0,0.5
unemulous,1,9,5,4,0,1.25
tacky,1,5,1,4,0,0.25
overcroppings,0,13,4,9,0,0.444444444444444
fibrillan,0,9,3,6,0,0.5
noddingly,1,9,2,7,0,0.285714285714286
titivation,1,10,5,5,0,1
brapodyian,0,10,4,6,0,0.666666666666667
texturally,1,10,3,7,0,0.428571428571429
antonet,1,7,3,4,0,0.75
tabbi,1,5,2,3,0,0.666666666666667
aphkfpkidxkqdq,0,14,2,12,0,0.166666666666667
sensitor,0,8,3,5,0,0.6
moyockels,0,9,3,6,0,0.5
siphonophora,1,12,5,7,0,0.714285714285714
achnist,0,7,2,5,0,0.4
leederte,0,8,4,4,0,1
selmer,1,6,2,4,0,0.5
amphipneusta,1,12,5,7,0,0.714285714285714
hereld,1,6,2,4,0,0.5
pornographomania,1,16,7,9,0,0.777777777777778
swineherdship,1,13,4,9,0,0.444444444444444
fenvand,0,7,2,5,0,0.4
karenina,1,8,4,4,0,1
subcates,0,8,3,5,0,0.6
glegly,1,6,1,5,0,0.2
broautodouging,0,14,7,7,0,1
handlock,1,8,2,6,0,0.333333333333333
elver,1,5,2,3,0,0.666666666666667
moistencer,0,10,4,6,0,0.666666666666667
slowhead,0,8,3,5,0,0.6
conious,0,7,4,3,0,1.33333333333333
linable,1,7,3,4,0,0.75
doup,1,4,2,2,0,1
llyr,1,4,0,4,0,0
heliosphered,0,12,5,7,0,0.714285714285714
tekla,1,5,2,3,0,0.666666666666667
noncallable,1,11,4,7,0,0.571428571428571
feminimistrining,0,16,6,10,0,0.6
chirota,0,7,3,4,0,0.75
catiline,1,8,4,4,0,1
piercers,1,8,3,5,0,0.6
bcachi,0,6,2,4,0,0.5
kwormeriskful,0,13,4,9,0,0.444444444444444
lyrism,1,6,1,5,0,0.2
polypnea,1,8,3,5,0,0.6
unliberally,1,11,4,7,0,0.571428571428571
mastoph,0,7,2,5,0,0.4
polonymy,0,8,2,6,0,0.333333333333333
monosubstitution,1,16,7,9,0,0.777777777777778
gly,0,3,0,3,0,0
preevaporating,1,14,6,8,0,0.75
spagyric,1,8,2,6,0,0.333333333333333
scavengement,0,12,4,8,0,0.5
sicilian,1,8,4,4,0,1
rerabstanicle,0,13,5,8,0,0.625
minesweepings,0,13,5,8,0,0.625
nagyvara,0,8,3,5,0,0.6
inbreaks,1,8,3,5,0,0.6
forbysening,1,11,3,8,0,0.375
biogenies,1,9,5,4,0,1.25
rvrtie,0,6,2,4,0,0.5
echicalic,0,9,4,5,0,0.8
lashkars,1,8,2,6,0,0.333333333333333
strated,0,7,2,5,0,0.4
nebaliacea,1,10,6,4,0,1.5
intramurally,1,12,4,8,0,0.5
zppvlsudzls,0,11,1,10,0,0.1
htiwwmzxslurzqpjmtedjqf,0,23,3,20,0,0.15
tric,0,4,1,3,0,0.333333333333333
chromoxylograph,0,15,4,11,0,0.363636363636364
saucerleaf,1,10,5,5,0,1
shidolor,0,8,3,5,0,0.6
apollonists,0,11,4,7,0,0.571428571428571
covelling,0,9,3,6,0,0.5
fullmouth,1,9,3,6,0,0.5
wnbpiuifyvdsoorbeq'imd,0,22,7,15,1,0.466666666666667
incontroller,0,12,4,8,0,0.5
gastrotrich,1,11,3,8,0,0.375
wgyejnqawcrpccbm''xtbatau,0,25,5,20,2,0.25
abbed,0,5,2,3,0,0.666666666666667
ronn,1,4,1,3,0,0.333333333333333
estranging,1,10,3,7,0,0.428571428571429
gons,1,4,1,3,0,0.333333333333333
gleason,1,7,3,4,0,0.75
smriti,1,6,2,4,0,0.5
tutizlahe,0,9,4,5,0,0.8
udolph,0,6,2,4,0,0.5
belton,1,6,2,4,0,0.5
atrikeromedopron,0,16,7,9,0,0.777777777777778
perist,0,6,2,4,0,0.5
audiometry,1,10,5,5,0,1
lne,0,3,1,2,0,0.5
cusseta,1,7,3,4,0,0.75
kinkinesses,1,11,4,7,0,0.571428571428571
stakhanovites,1,13,5,8,0,0.625
halocaudal,0,10,5,5,0,1
semibarbarian,1,13,6,7,0,0.857142857142857
matrial,0,7,3,4,0,0.75
u'fc'bxcxeqi,0,12,3,9,2,0.333333333333333
nny'whoarwxmfjfef,0,17,3,14,1,0.214285714285714
ramfeezletown,0,13,5,8,0,0.625
pairlee,0,7,4,3,0,1.33333333333333
hedlicyperesbly,0,15,4,11,0,0.363636363636364
hgp,0,3,0,3,0,0
seraphims,1,9,3,6,0,0.5
nonchemically,0,13,4,9,0,0.444444444444444
canler,0,6,2,4,0,0.5
resample,1,8,3,5,0,0.6
folksiest,1,9,3,6,0,0.5
chalmoluon,0,10,4,6,0,0.666666666666667
ganniellenial,0,13,6,7,0,0.857142857142857
courtlier,1,9,4,5,0,0.8
dismissal,1,9,3,6,0,0.5
kulun,1,5,2,3,0,0.666666666666667
veratrum,1,8,3,5,0,0.6
teletraspedote,0,14,6,8,0,0.75
reiter,1,6,3,3,0,1
asterophone,0,11,5,6,0,0.833333333333333
absvwksgfq,0,10,1,9,0,0.111111111111111
pannidyis,0,9,3,6,0,0.5
fectrin,0,7,2,5,0,0.4
bascepseing,0,11,4,7,0,0.571428571428571
neosho,1,6,3,3,0,1
manism,0,6,2,4,0,0.5
ramillie,1,8,4,4,0,1
hempseeds,1,9,3,6,0,0.5
caniser,0,7,3,4,0,0.75
ulmina,0,6,3,3,0,1
hemotic,0,7,3,4,0,0.75
goss,1,4,1,3,0,0.333333333333333
precreases,1,10,4,6,0,0.666666666666667
cfe'ijdv,0,8,2,6,1,0.333333333333333
conigdorargenicis,0,17,7,10,0,0.7
anoil,1,5,3,2,0,1.5
replicalnesses,0,14,5,9,0,0.555555555555556
nonscaling,1,10,3,7,0,0.428571428571429
mano,1,4,2,2,0,1
porcup,0,6,2,4,0,0.5
repheallart,0,11,4,7,0,0.571428571428571
homogenite,0,10,5,5,0,1
wot,0,3,1,2,0,0.5
ostracism,1,9,3,6,0,0.5
sphaeridium,1,11,5,6,0,0.833333333333333
predeficient,1,12,5,7,0,0.714285714285714
countercrowder,0,14,5,9,0,0.555555555555556
cordetinestionathaenglishy,0,26,10,16,0,0.625
chastisers,1,10,3,7,0,0.428571428571429
esonse,0,6,3,3,0,1
methodologists,1,14,5,9,0,0.555555555555556
funchestaxomatondel,0,19,7,12,0,0.583333333333333
idahoans,1,8,4,4,0,1
erophillers,0,11,4,7,0,0.571428571428571
cornix,1,6,2,4,0,0.5
phalaprolity,0,12,4,8,0,0.5
superhines,0,10,4,6,0,0.666666666666667
fistulated,1,10,4,6,0,0.666666666666667
sinehattiverrarpl,0,17,6,11,0,0.545454545454545
metepa,1,6,3,3,0,1
underthief,1,10,4,6,0,0.666666666666667
wzhgxpxwazlochu,0,15,3,12,0,0.25
guagmenting,0,11,4,7,0,0.571428571428571
mul,0,3,1,2,0,0.5
omnifical,0,9,4,5,0,0.8
curmudgeonery,1,13,5,8,0,0.625
sedimenta,0,9,4,5,0,0.8
paraphimosis,1,12,5,7,0,0.714285714285714
crudoon,0,7,3,4,0,0.75
rhynchophoran,1,13,3,10,0,0.3
autonomic,1,9,5,4,0,1.25
chonones,0,8,3,5,0,0.6
easters,1,7,3,4,0,0.75
'ltjouw,0,7,2,5,1,0.4
argutenberration,0,16,7,9,0,0.777777777777778
maurally,0,8,3,5,0,0.6
occipitofrontal,1,15,6,9,0,0.666666666666667
omy,0,3,1,2,0,0.5
brisgogherinano,0,15,6,9,0,0.666666666666667
myrian,0,6,2,4,0,0.5
palaeotropical,1,14,7,7,0,1
supercaptiously,0,15,6,9,0,0.666666666666667
skidpans,1,8,2,6,0,0.333333333333333
berdicus,0,8,3,5,0,0.6
neiygkytijwhxwlvodgrfsidth'tgp,0,30,5,25,1,0.2
h'eaeeweepmwmqgc,0,16,6,10,1,0.6
potence,1,7,3,4,0,0.75
phoris,0,6,2,4,0,0.5
ertyletuchteoloneg,0,18,7,11,0,0.636363636363636
heredolues,1,10,5,5,0,1
uukdvespori,0,11,5,6,0,0.833333333333333
changefulnesses,1,15,5,10,0,0.5
presupplementedly,0,17,5,12,0,0.416666666666667
brakiest,1,8,3,5,0,0.6
emulousness,1,11,5,6,0,0.833333333333333
idae,0,4,3,1,0,3
dissipatedness,1,14,5,9,0,0.555555555555556
symbol,1,6,1,5,0,0.2
faberga,1,7,3,4,0,0.75
afkugqkplqhkjs'xa,0,17,3,14,1,0.214285714285714
reith,1,5,2,3,0,0.666666666666667
oho,1,3,2,1,0,2
swadtealisalocaretic,0,20,9,11,0,0.818181818181818
macroprisms,1,11,3,8,0,0.375
chemosynthesis,1,14,4,10,0,0.4
urochordate,1,11,5,6,0,0.833333333333333
f'emkeqlnr,0,10,2,8,1,0.25
prefraniallydes,0,15,5,10,0,0.5
pseudoamatores,0,14,7,7,0,1
caprucigs,0,9,3,6,0,0.5
arooss,0,6,3,3,0,1
dhives,0,6,2,4,0,0.5
stingily,1,8,2,6,0,0.333333333333333
marmiditivrophts,0,16,5,11,0,0.454545454545455
maledertid,0,10,4,6,0,0.666666666666667
ualortteyamontcong,0,18,7,11,0,0.636363636363636
helicitic,1,9,4,5,0,0.8
pearlside,0,9,4,5,0,0.8
annihilobous,0,12,6,6,0,1
papayotin,1,9,4,5,0,0.8
rotinevetiesterierness,0,22,10,12,0,0.833333333333333
oudidestivinemichydralizatcleccist,0,34,13,21,0,0.619047619047619
antemingents,0,12,4,8,0,0.5
unconsuteness,0,13,5,8,0,0.625
hgalzlupzndvqjnycmllepkzvu,0,26,4,22,0,0.181818181818182
ferrosilicons,1,13,5,8,0,0.625
batteau,1,7,4,3,0,1.33333333333333
parfocality,1,11,4,7,0,0.571428571428571
improvement,1,11,4,7,0,0.571428571428571
neuropoda,0,9,5,4,0,1.25
babas,1,5,2,3,0,0.666666666666667
artgum,1,6,2,4,0,0.5
newcomer,1,8,3,5,0,0.6
polyglottally,1,13,3,10,0,0.3
testate,1,7,3,4,0,0.75
aclgjlg'libeg'zsoxtk,0,20,4,16,2,0.25
needles,1,7,3,4,0,0.75
atoshr,0,6,2,4,0,0.5
ophylaxes,0,9,3,6,0,0.5
sactiouzialetagrapanda,0,22,11,11,0,1
capmakers,1,9,3,6,0,0.5
deathbed,1,8,3,5,0,0.6
totz,1,4,1,3,0,0.333333333333333
escudos,1,7,3,4,0,0.75
anthropomatous,0,14,6,8,0,0.75
cheshvan,1,8,2,6,0,0.333333333333333
vixcufcxxx,0,10,2,8,0,0.25
datographotottlee,0,17,7,10,0,0.7
lexicologist,1,12,5,7,0,0.714285714285714
paperiness,1,10,4,6,0,0.666666666666667
iain,1,4,3,1,0,3
ampyx,1,5,1,4,0,0.25
rmxftqksvtd'rt,0,14,0,14,1,0
enthusiasts,1,11,4,7,0,0.571428571428571
darns,1,5,1,4,0,0.25
racerunner,1,10,4,6,0,0.666666666666667
quet,1,4,2,2,0,1
chloramines,1,11,4,7,0,0.571428571428571
subcarinated,1,12,5,7,0,0.714285714285714
hounskull,1,9,3,6,0,0.5
edmonda,1,7,3,4,0,0.75
corbett,1,7,2,5,0,0.4
udszm,0,5,1,4,0,0.25
cumbeat,0,7,3,4,0,0.75
andochomerinotor,0,16,7,9,0,0.777777777777778
bacteriaceae,1,12,7,5,0,1.4
muncies,0,7,3,4,0,0.75
lachenalia,1,10,5,5,0,1
gunports,1,8,2,6,0,0.333333333333333
bearnaise,1,9,5,4,0,1.25
gophan,0,6,2,4,0,0.5
pgnkfwdakxaznopnty',0,19,3,16,1,0.1875
citruthititis,0,13,5,8,0,0.625
staphylosis,1,11,3,8,0,0.375
okrasianism,0,11,5,6,0,0.833333333333333
tarumari,1,8,4,4,0,1
fertilia,0,8,4,4,0,1
cordello,0,8,3,5,0,0.6
icac,0,4,2,2,0,1
poema,0,5,3,2,0,1.5
sexferd,0,7,2,5,0,0.4
silverwares,1,11,4,7,0,0.571428571428571
jacque,1,6,3,3,0,1
mormmman,0,8,2,6,0,0.333333333333333
piassaba,1,8,4,4,0,1
drinkables,1,10,3,7,0,0.428571428571429
hootananny,1,10,4,6,0,0.666666666666667
gabblement,1,10,3,7,0,0.428571428571429
unsellable,1,10,4,6,0,0.666666666666667
fensition,0,9,4,5,0,0.8
eslyxsg'nt,0,10,1,9,1,0.111111111111111
exed,1,4,2,2,0,1
arowhertephe,0,12,5,7,0,0.714285714285714
sidestreet,1,10,4,6,0,0.666666666666667
hikers,1,6,2,4,0,0.5
flat,1,4,1,3,0,0.333333333333333
mimictimelides,0,14,6,8,0,0.75
decantigationid,0,15,7,8,0,0.875
logitopr,0,8,3,5,0,0.6
polky,1,5,1,4,0,0.25
superiors,1,9,4,5,0,0.8
orlander,0,8,3,5,0,0.6
doctrinarian,1,12,5,7,0,0.714285714285714
conspissate,1,11,4,7,0,0.571428571428571
lontar,1,6,2,4,0,0.5
rhizodus,1,8,3,5,0,0.6
phliolly,0,8,2,6,0,0.333333333333333
superfish,0,9,3,6,0,0.5
ynjcypmzipfegc,0,14,2,12,0,0.166666666666667
undocumentedness,1,16,6,10,0,0.6
glideness,1,9,3,6,0,0.5
gobrancive,0,10,4,6,0,0.666666666666667
evisite,1,7,4,3,0,1.33333333333333
igusdmue'qhk'px,0,15,4,11,2,0.363636363636364
astoide,0,7,4,3,0,1.33333333333333
macroanalytical,1,15,6,9,0,0.666666666666667
oversteadfasts,0,14,5,9,0,0.555555555555556
spd,1,3,0,3,0,0
gulfport,1,8,2,6,0,0.333333333333333
emarginally,0,11,4,7,0,0.571428571428571
saraad,1,6,3,3,0,1
furfuranol,0,10,4,6,0,0.666666666666667
candings,0,8,2,6,0,0.333333333333333
overbrutally,1,12,4,8,0,0.5
ekwtvndvvqfdrvcx,0,16,1,15,0,0.0666666666666667
inordinary,1,10,4,6,0,0.666666666666667
spelldom,0,8,2,6,0,0.333333333333333
winetasting,1,11,4,7,0,0.571428571428571
avlsfjibcep'otvjqoxj'i,0,22,6,16,2,0.375
pholgiga,0,8,3,5,0,0.6
overmeek,1,8,4,4,0,1
kcodeatamuncifaveein,0,20,10,10,0,1
anthargulogil,0,13,5,8,0,0.625
scrubbly,1,8,1,7,0,0.142857142857143
joverenimaloochery,0,18,8,10,0,0.8
appalling,1,9,3,6,0,0.5
insignment,1,10,3,7,0,0.428571428571429
chakdar,1,7,2,5,0,0.4
rhughtheffliplete,0,17,5,12,0,0.416666666666667
kushfddum,0,9,2,7,0,0.285714285714286
soria,0,5,3,2,0,1.5
podsolizations,1,14,6,8,0,0.75
nickelled,1,9,3,6,0,0.5
cicuta,1,6,3,3,0,1
samshu,1,6,2,4,0,0.5
exemplified,1,11,5,6,0,0.833333333333333
upbuoyance,1,10,5,5,0,1
upgully,1,7,2,5,0,0.4
hornblende,1,10,3,7,0,0.428571428571429
bathmissis,0,10,3,7,0,0.428571428571429
unpilloried,1,11,5,6,0,0.833333333333333
polarography,1,12,4,8,0,0.5
fdilsy'',0,8,1,7,2,0.142857142857143
exhausters,1,10,4,6,0,0.666666666666667
updownervouring,0,15,6,9,0,0.666666666666667
metantimonic,1,12,5,7,0,0.714285714285714
aguire,0,6,4,2,0,2
ctenostomatic,0,13,5,8,0,0.625
rnttwjrj'gmarilcjyllr,0,21,2,19,1,0.105263157894737
sardanapallos,1,13,5,8,0,0.625
crotaphytus,1,11,3,8,0,0.375
urticates,1,9,4,5,0,0.8
gecarcinus,1,10,4,6,0,0.666666666666667
subsizars,1,9,3,6,0,0.5
overtopping,1,11,4,7,0,0.571428571428571
illampu,1,7,3,4,0,0.75
unsanctioning,1,13,5,8,0,0.625
masulas,1,7,3,4,0,0.75
rephyls,0,7,1,6,0,0.166666666666667
stiret,0,6,2,4,0,0.5
apisa,0,5,3,2,0,1.5
dyothelism,1,10,3,7,0,0.428571428571429
colourlessness,1,14,5,9,0,0.555555555555556
waliteoadrdotinis,0,17,8,9,0,0.888888888888889
wigan,1,5,2,3,0,0.666666666666667
rriocard,1,8,3,5,0,0.6
sind,1,4,1,3,0,0.333333333333333
undecenseal,0,11,5,6,0,0.833333333333333
crizzle,1,7,2,5,0,0.4
coptis,1,6,2,4,0,0.5
mediastolically,0,15,6,9,0,0.666666666666667
enfamous,1,8,4,4,0,1
rockel,1,6,2,4,0,0.5
ambisonic,1,9,4,5,0,0.8
oxidises,1,8,4,4,0,1
brassertations,0,14,5,9,0,0.555555555555556
potentiodactylites,0,18,7,11,0,0.636363636363636
dangerful,1,9,3,6,0,0.5
mjfmbbllsed,0,11,1,10,0,0.1
locarnite,1,9,4,5,0,0.8
cspactitada,0,11,4,7,0,0.571428571428571
piromongaly,0,11,4,7,0,0.571428571428571
milliken,1,8,3,5,0,0.6
scytonemataceae,1,15,7,8,0,0.875
screet,1,6,2,4,0,0.5
epanalepsis,1,11,5,6,0,0.833333333333333
sarum,1,5,2,3,0,0.666666666666667
munprenontormmas,0,16,5,11,0,0.454545454545455
sanis,0,5,2,3,0,0.666666666666667
togt,1,4,1,3,0,0.333333333333333
kind,1,4,1,3,0,0.333333333333333
georgics,1,8,3,5,0,0.6
yatesboro,1,9,4,5,0,0.8
compensorine,0,12,5,7,0,0.714285714285714
dubnium,1,7,3,4,0,0.75
tums,1,4,1,3,0,0.333333333333333
koker,1,5,2,3,0,0.666666666666667
qfuozrkahbxw,0,12,3,9,0,0.333333333333333
vitics,0,6,2,4,0,0.5
lll,0,3,0,3,0,0
yankeeland,1,10,4,6,0,0.666666666666667
sipunculoidea,1,13,7,6,0,1.16666666666667
focsle,1,6,2,4,0,0.5
purifiable,0,10,5,5,0,1
enthusiastics,0,13,5,8,0,0.625
bowtie,1,6,3,3,0,1
denial,1,6,3,3,0,1
achatinella,1,11,5,6,0,0.833333333333333
oga,0,3,2,1,0,2
slation,0,7,3,4,0,0.75
sunnyme,0,7,2,5,0,0.4
enranckles,1,10,3,7,0,0.428571428571429
butyric,1,7,2,5,0,0.4
keefferennsyllabicamaldant,0,26,9,17,0,0.529411764705882
limpin,1,6,2,4,0,0.5
yutivarissifiticrophypeters,0,27,10,17,0,0.588235294117647
pyrophabiquisiantiwellenconises,0,31,13,18,0,0.722222222222222
esselen,1,7,3,4,0,0.75
cocatalyst,1,10,3,7,0,0.428571428571429
platurous,1,9,4,5,0,0.8
hbjj,0,4,0,4,0,0
fibrinolysin,1,12,4,8,0,0.5
dulaney,1,7,3,4,0,0.75
iuzjhj,0,6,2,4,0,0.5
naturisms,1,9,3,6,0,0.5
bituminating,1,12,5,7,0,0.714285714285714
matacan,1,7,3,4,0,0.75
overope,0,7,4,3,0,1.33333333333333
overealatinaffunistraing,0,24,11,13,0,0.846153846153846
overrashly,1,10,3,7,0,0.428571428571429
pkswwyyhuzcbeg,0,14,2,12,0,0.166666666666667
goatskins,1,9,3,6,0,0.5
scriptichokingbell,0,18,5,13,0,0.384615384615385
trollopees,1,10,4,6,0,0.666666666666667
upinarecracics,0,14,6,8,0,0.75
econometrician,1,14,7,7,0,1
hypermnesia,1,11,4,7,0,0.571428571428571
soar,1,4,2,2,0,1
hindoo,1,6,3,3,0,1
fumeliornis,0,11,5,6,0,0.833333333333333
retely,0,6,2,4,0,0.5
lilid,0,5,2,3,0,0.666666666666667
orchats,1,7,2,5,0,0.4
ovaglyp,0,7,2,5,0,0.4
wallahs,1,7,2,5,0,0.4
gippy,1,5,1,4,0,0.25
xmwmtzbpzdjnnlelyfonyntw'izf,0,28,3,25,1,0.12
siaiophiter,0,11,6,5,0,1.2
nonheritor,1,10,4,6,0,0.666666666666667
hygiene,1,7,3,4,0,0.75
outsaid,1,7,4,3,0,1.33333333333333
cousinages,1,10,5,5,0,1
lianoi,0,6,4,2,0,2
shultz,1,6,1,5,0,0.2
ryeflour,1,8,3,5,0,0.6
ted,1,3,1,2,0,0.5
rexane,1,6,3,3,0,1
wormgear,1,8,3,5,0,0.6
zwfbjjbkhou',0,12,2,10,1,0.2
litance,0,7,3,4,0,0.75
zoug,1,4,2,2,0,1
ellistical,0,10,4,6,0,0.666666666666667
fiansmdsporiastrastacidirubgulacingen,0,37,14,23,0,0.608695652173913
vervinae,0,8,4,4,0,1
cakibstrete,0,11,4,7,0,0.571428571428571
carmichael,1,10,4,6,0,0.666666666666667
seyfert,1,7,2,5,0,0.4
kailyairds,1,10,4,6,0,0.666666666666667
country,1,7,2,5,0,0.4
pipemouth,1,9,4,5,0,0.8
venerator,1,9,4,5,0,0.8
lifebuoy,1,8,4,4,0,1
metrocolpotomy,0,14,5,9,0,0.555555555555556
spiegering,0,10,4,6,0,0.666666666666667
semegivace,0,10,5,5,0,1
cytasters,1,9,2,7,0,0.285714285714286
sutlerage,1,9,4,5,0,0.8
unpolled,1,8,3,5,0,0.6
hellespont,1,10,3,7,0,0.428571428571429
linioriavericoeabationonngaichglitefecrgesayllstta,0,50,22,28,0,0.785714285714286
subdues,1,7,3,4,0,0.75
fusmiorul,0,9,4,5,0,0.8
shessacomesoms,0,14,5,9,0,0.555555555555556
didaenic,0,8,4,4,0,1
nonresponsibilities,1,19,8,11,0,0.727272727272727
subcivilized,1,12,5,7,0,0.714285714285714
gezone,0,6,3,3,0,1
nonant,0,6,2,4,0,0.5
spewiest,1,8,3,5,0,0.6
faroeish,1,8,4,4,0,1
hodometers,1,10,4,6,0,0.666666666666667
overishorterrymorkfus,0,21,7,14,0,0.5
hutsonville,1,11,4,7,0,0.571428571428571
bargues,0,7,3,4,0,0.75
miswitchinaw,0,12,4,8,0,0.5
proletaries,1,11,5,6,0,0.833333333333333
literatocarthartic,0,18,7,11,0,0.636363636363636
postverbal,1,10,3,7,0,0.428571428571429
syriologist,1,11,4,7,0,0.571428571428571
essenacts,0,9,3,6,0,0.5
wanityouxiansidgheteglanguneg,0,29,12,17,0,0.705882352941177
bactericidally,1,14,5,9,0,0.555555555555556
haria,0,5,3,2,0,1.5
sdally,0,6,1,5,0,0.2
mattin,1,6,2,4,0,0.5
eanling,1,7,3,4,0,0.75
wass,0,4,1,3,0,0.333333333333333
embattenberry,0,13,4,9,0,0.444444444444444
tit,1,3,1,2,0,0.5
oversefension,0,13,6,7,0,0.857142857142857
legalizer,1,9,4,5,0,0.8
headraigle,0,10,5,5,0,1
uncented,0,8,3,5,0,0.6
booleans,1,8,4,4,0,1
serendipity,1,11,4,7,0,0.571428571428571
wilisagwodensortitenessmits,0,27,10,17,0,0.588235294117647
socius,1,6,3,3,0,1
unthengedjances,0,15,5,10,0,0.5
malleus,1,7,3,4,0,0.75
unconcreted,1,11,4,7,0,0.571428571428571
ichthyodorulites,1,16,6,10,0,0.6
oga,0,3,2,1,0,2
mustahfiz,1,9,3,6,0,0.5
undisgraced,1,11,4,7,0,0.571428571428571
monavenerasm,0,12,5,7,0,0.714285714285714
cvaweqzuhsca,0,12,4,8,0,0.5
pixphiemanetsurhy,0,17,6,11,0,0.545454545454545
grewski,0,7,2,5,0,0.4
holdfastness,1,12,3,9,0,0.333333333333333
outwister,0,9,4,5,0,0.8
carperter,0,9,3,6,0,0.5
gothicising,1,11,4,7,0,0.571428571428571
lattis,0,6,2,4,0,0.5
bedic,0,5,2,3,0,0.666666666666667
ss',0,3,0,3,1,0
dequeen,1,7,4,3,0,1.33333333333333
lambert,1,7,2,5,0,0.4
gl'yujg,0,7,1,6,1,0.166666666666667
amelift,0,7,3,4,0,0.75
bdcotxfmsp,0,10,1,9,0,0.111111111111111
nallkondaridrangivarid,0,22,8,14,0,0.571428571428571
moniterallsisescalm,0,19,7,12,0,0.583333333333333
protatrant,0,10,3,7,0,0.428571428571429
'yhvjbxdcvp,0,11,0,11,1,0
storomycre,0,10,3,7,0,0.428571428571429
boaexh,0,6,3,3,0,1
implurientotypercompolites,0,26,10,16,0,0.625
overapprehensive,1,16,7,9,0,0.777777777777778
deuteragoniadin,0,15,8,7,0,1.14285714285714
admissive,1,9,4,5,0,0.8
brattishing,1,11,3,8,0,0.375
hawkey,1,6,2,4,0,0.5
inanimatingly,0,13,5,8,0,0.625
leasure,0,7,4,3,0,1.33333333333333
melanosomes,1,11,5,6,0,0.833333333333333
alitorickbrinatsabil,0,20,8,12,0,0.666666666666667
rejournment,0,11,4,7,0,0.571428571428571
pretenesses,0,11,4,7,0,0.571428571428571
papastrophicativerloatlewinloverb,0,33,13,20,0,0.65
impreventilators,0,16,6,10,0,0.6
andromorpha,0,11,4,7,0,0.571428571428571
chronologising,1,14,5,9,0,0.555555555555556
drencher,1,8,2,6,0,0.333333333333333
tockereverdocumaloso,0,20,9,11,0,0.818181818181818
inophin,0,7,3,4,0,0.75
hinarfed,0,8,3,5,0,0.6
dizing,0,6,2,4,0,0.5
diamondback,1,11,4,7,0,0.571428571428571
orthia,1,6,3,3,0,1
gimcracism,0,10,3,7,0,0.428571428571429
causcly,0,7,2,5,0,0.4
qaddafi,1,7,3,4,0,0.75
shromans,0,8,2,6,0,0.333333333333333
prerestamphistic,0,16,5,11,0,0.454545454545455
ranchlike,1,9,3,6,0,0.5
jucoixmleyd,0,11,4,7,0,0.571428571428571
adenological,1,12,6,6,0,1
opposing,1,8,3,5,0,0.6
hypostrophe,1,11,3,8,0,0.375
saltires,1,8,3,5,0,0.6
xrvckdyoecdakyfhwovnlsf',0,24,4,20,1,0.2
googa,0,5,3,2,0,1.5
plbroodooed,0,11,5,6,0,0.833333333333333
ideologician,0,12,7,5,0,1.4
matheson,1,8,3,5,0,0.6
balood,0,6,3,3,0,1
saccoylends,0,11,3,8,0,0.375
echittorner,0,11,4,7,0,0.571428571428571
jba'vqndig,0,10,2,8,1,0.25
chancement,0,10,3,7,0,0.428571428571429
unswell,1,7,2,5,0,0.4
frictional,1,10,4,6,0,0.666666666666667
cium,0,4,2,2,0,1
usv,1,3,1,2,0,0.5
tarrassical,0,11,4,7,0,0.571428571428571
reuchlin,1,8,3,5,0,0.6
levitator,1,9,4,5,0,0.8
barmits,0,7,2,5,0,0.4
noned,0,5,2,3,0,0.666666666666667
lyijmanig',0,10,3,7,1,0.428571428571429
duesemou,0,8,5,3,0,1.66666666666667
nondeference,1,12,5,7,0,0.714285714285714
iqesxjbeqvsuj,0,13,4,9,0,0.444444444444444
mantoes,1,7,3,4,0,0.75
hsingan,1,7,2,5,0,0.4
feudalism,1,9,4,5,0,0.8
treasures,1,9,4,5,0,0.8
arrivism,1,8,3,5,0,0.6
bratialloshery,0,14,5,9,0,0.555555555555556
vicer,0,5,2,3,0,0.666666666666667
welling,1,7,2,5,0,0.4
rewall,1,6,2,4,0,0.5
semihostiley,0,12,5,7,0,0.714285714285714
oecantic,0,8,4,4,0,1
dgmkvjpsjh'j'nwaojnyecf'xg,0,26,3,23,3,0.130434782608696
turakoo,1,7,4,3,0,1.33333333333333
deirdra,1,7,3,4,0,0.75
nsec,1,4,1,3,0,0.333333333333333
disposer,1,8,3,5,0,0.6
blandform,0,9,2,7,0,0.285714285714286
camearathyromass,0,16,6,10,0,0.6
bcws,1,4,0,4,0,0
pilobolus,1,9,4,5,0,0.8
bearableness,0,12,5,7,0,0.714285714285714
mantispa,1,8,3,5,0,0.6
fluously,0,8,3,5,0,0.6
ewery,1,5,2,3,0,0.666666666666667
eddying,1,7,2,5,0,0.4
muscatine,1,9,4,5,0,0.8
decantates,1,10,4,6,0,0.666666666666667
trentepohlia,1,12,5,7,0,0.714285714285714
delwyn,1,6,1,5,0,0.2
mouts,0,5,2,3,0,0.666666666666667
unsystematical,1,14,5,9,0,0.555555555555556
rsacopellalfeedftilllion,0,24,9,15,0,0.6
precombination,1,14,6,8,0,0.75
tgciegc,0,7,2,5,0,0.4
flowerfence,1,11,4,7,0,0.571428571428571
archcondurin,0,12,4,8,0,0.5
christiania,1,11,5,6,0,0.833333333333333
vintness,0,8,2,6,0,0.333333333333333
mosed,1,5,2,3,0,0.666666666666667
myelopa,0,7,3,4,0,0.75
nnlm,0,4,0,4,0,0
djectricorynger,0,15,4,11,0,0.363636363636364
pozna,1,5,2,3,0,0.666666666666667
panhedral,0,9,3,6,0,0.5
unfishes,0,8,3,5,0,0.6
dosseret,1,8,3,5,0,0.6
swansboro,1,9,3,6,0,0.5
legionnaires,1,12,6,6,0,1
paconsparaglings,0,16,5,11,0,0.454545454545455
ischi,0,5,2,3,0,0.666666666666667
toxide,0,6,3,3,0,1
euphonery,0,9,4,5,0,0.8
schlute,0,7,2,5,0,0.4
dephatzh,0,8,2,6,0,0.333333333333333
okhltoixgwr'akxdqcfd,0,20,4,16,1,0.25
tracheoscopist,1,14,5,9,0,0.555555555555556
loyder,0,6,2,4,0,0.5
fsehyimq'rjnhrrchaqhebvkazoxjw,0,30,6,24,1,0.25
hyrhockessentiojeccid,0,21,7,14,0,0.5
kotiant,0,7,3,4,0,0.75
limmasol,1,8,3,5,0,0.6
hyacintha,1,9,3,6,0,0.5
boarding,1,8,3,5,0,0.6
ununanimations,0,14,7,7,0,1
kali,1,4,2,2,0,1
gambetta,1,8,3,5,0,0.6
omipet,0,6,3,3,0,1
fernandia,0,9,4,5,0,0.8
braun,1,5,2,3,0,0.666666666666667
rbhwgimem,0,9,2,7,0,0.285714285714286
sabelled,0,8,3,5,0,0.6
qwhigbtghtefybcipilrps,0,22,4,18,0,0.222222222222222
scralicheisheriagoromoun,0,24,11,13,0,0.846153846153846
mulnercot,0,9,3,6,0,0.5
ulruybtopnxtkexbrunljgr'cy,0,26,5,21,1,0.238095238095238
omrjwhvyizf,0,11,2,9,0,0.222222222222222
kelily,0,6,2,4,0,0.5
countemultipollexed,0,19,8,11,0,0.727272727272727
scjjxhxtadcptnnjbcyyappofdvl,0,28,3,25,0,0.12
mussaenda,1,9,4,5,0,0.8
unremitting,1,11,4,7,0,0.571428571428571
isoimmunisations,1,16,8,8,0,1
pulicene,1,8,4,4,0,1
smoochiavelic,0,13,6,7,0,0.857142857142857
carpwllidi,0,10,3,7,0,0.428571428571429
pechoficiealet,0,14,7,7,0,1
timnersiviess,0,13,5,8,0,0.625
coccucrachrity,0,14,4,10,0,0.4
moonrises,1,9,4,5,0,0.8
interconnectibilities,0,21,9,12,0,0.75
unbra,0,5,2,3,0,0.666666666666667
familiarises,1,12,6,6,0,1
telesis,1,7,3,4,0,0.75
parados,1,7,3,4,0,0.75
rpnaxradih'abog,0,15,5,10,1,0.5
oathworm,0,8,3,5,0,0.6
softback,1,8,2,6,0,0.333333333333333
spottledgelisms,0,15,4,11,0,0.363636363636364
neckguard,1,9,3,6,0,0.5
jsuiopaxadmc'amnnzdihb,0,22,7,15,1,0.466666666666667
brundous,0,8,3,5,0,0.6
superwinglades,0,14,5,9,0,0.555555555555556
tidion,0,6,3,3,0,1
stewbum,1,7,2,5,0,0.4
heteronymous,1,12,5,7,0,0.714285714285714
pelosevonalireor,0,16,8,8,0,1
gotching,0,8,2,6,0,0.333333333333333
postponements,1,13,4,9,0,0.444444444444444
woodpeckers,1,11,4,7,0,0.571428571428571
awrtyrhizan,0,11,3,8,0,0.375
acquiescences,1,13,6,7,0,0.857142857142857
orlov,1,5,2,3,0,0.666666666666667
sollar,1,6,2,4,0,0.5
berdivellogran,0,14,5,9,0,0.555555555555556
mlaga,1,5,2,3,0,0.666666666666667
eckhart,1,7,2,5,0,0.4
concrorichindamaledethy,0,23,8,15,0,0.533333333333333
vavdv,0,5,1,4,0,0.25
arioian,1,7,5,2,0,2.5
xslnkqzytcjipnfut,0,17,2,15,0,0.133333333333333
judi,1,4,2,2,0,1
crenoptins,0,10,3,7,0,0.428571428571429
dechbuchetier,0,13,5,8,0,0.625
starmainteroka,0,14,6,8,0,0.75
akity,0,5,2,3,0,0.666666666666667
hippolyte,1,9,3,6,0,0.5
zoogist,0,7,3,4,0,0.75
naegated,0,8,4,4,0,1
dountame,0,8,4,4,0,1
sparassis,1,9,3,6,0,0.5
unsplittable,1,12,4,8,0,0.5
falter,1,6,2,4,0,0.5
dollarwise,1,10,4,6,0,0.666666666666667
voetsak,1,7,3,4,0,0.75
karionty,0,8,3,5,0,0.6
subtiller,0,9,3,6,0,0.5
prejudicially,1,13,5,8,0,0.625
cevesm,0,6,2,4,0,0.5
nish,1,4,1,3,0,0.333333333333333
comatroce,0,9,4,5,0,0.8
hesperiid,1,9,4,5,0,0.8
cuso,1,4,2,2,0,1
hakenkreuze,1,11,5,6,0,0.833333333333333
ounpeggs,0,8,3,5,0,0.6
banter,1,6,2,4,0,0.5
pevetangeve,0,11,5,6,0,0.833333333333333
suggest,1,7,2,5,0,0.4
celess,0,6,2,4,0,0.5
terpsichore,1,11,4,7,0,0.571428571428571
hazardless,1,10,3,7,0,0.428571428571429
derachiotomocharityloper,0,24,10,14,0,0.714285714285714
feltmongers,0,11,3,8,0,0.375
interestingly,1,13,4,9,0,0.444444444444444
crumb,1,5,1,4,0,0.25
eodiscid,1,8,4,4,0,1
benefacies,0,10,5,5,0,1
citellum,0,8,3,5,0,0.6
puericulture,1,12,6,6,0,1
cefisphtayaereatourangan,0,24,11,13,0,0.846153846153846
scrapper,1,8,2,6,0,0.333333333333333
gedjf'eyb,0,9,2,7,1,0.285714285714286
dissolutely,1,11,4,7,0,0.571428571428571
unembossed,1,10,4,6,0,0.666666666666667
shemu,1,5,2,3,0,0.666666666666667
aca,0,3,2,1,0,2
jerryman,0,8,2,6,0,0.333333333333333
iderclbhei,0,10,4,6,0,0.666666666666667
seatworks,1,9,3,6,0,0.5
amphicarpa,1,10,4,6,0,0.666666666666667
goance,0,6,3,3,0,1
trocompaneer,0,12,5,7,0,0.714285714285714
egyptians,1,9,3,6,0,0.5
rewify,0,6,2,4,0,0.5
conjuring,1,9,3,6,0,0.5
subfeebe,0,8,4,4,0,1
op,1,2,1,1,0,1
ccalista,0,8,3,5,0,0.6
hybridomata,1,11,4,7,0,0.571428571428571
inquinembed,0,11,5,6,0,0.833333333333333
mauk,1,4,2,2,0,1
sublimification,1,15,7,8,0,0.875
herous,0,6,3,3,0,1
dottiest,1,8,3,5,0,0.6
stubborn,1,8,2,6,0,0.333333333333333
exactresses,1,11,4,7,0,0.571428571428571
paggast,0,7,2,5,0,0.4
serjeancy,1,9,3,6,0,0.5
sherlock,1,8,2,6,0,0.333333333333333
''y'ekwtccnqxtrkqh,0,18,1,17,3,0.0588235294117647
nonfold,0,7,2,5,0,0.4
ryjxmnchgt,0,10,0,10,0,0
possinian,0,9,4,5,0,0.8
mely,0,4,1,3,0,0.333333333333333
dunnakin,1,8,3,5,0,0.6
fiomyd,0,6,2,4,0,0.5
antiauthoritarianisms,1,21,10,11,0,0.909090909090909
abs,1,3,1,2,0,0.5
prelaxation,0,11,5,6,0,0.833333333333333
paras,1,5,2,3,0,0.666666666666667
strainor,0,8,3,5,0,0.6
llrycpwnfsrbrrxctddzttgnfbfr,0,28,0,28,0,0
atocuiev'''x,0,12,5,7,3,0.714285714285714
grottier,1,8,3,5,0,0.6
avgaseometry,0,12,5,7,0,0.714285714285714
francophobe,1,11,4,7,0,0.571428571428571
foldout,1,7,3,4,0,0.75
slidles,0,7,2,5,0,0.4
unbounda,0,8,4,4,0,1
ples,0,4,1,3,0,0.333333333333333
unbolster,1,9,3,6,0,0.5
slidable,1,8,3,5,0,0.6
fouettes,1,8,4,4,0,1
esmiykyejkvyozllz,0,17,4,13,0,0.307692307692308
contain,1,7,3,4,0,0.75
craal,1,5,2,3,0,0.666666666666667
pecronsierter,0,13,5,8,0,0.625
distillated,0,11,4,7,0,0.571428571428571
indiscreditably,0,15,5,10,0,0.5
medigamous,0,10,5,5,0,1
gotchias,0,8,3,5,0,0.6
reflectograph,1,13,4,9,0,0.444444444444444
resistlessness,1,14,4,10,0,0.4
herskowitz,1,10,3,7,0,0.428571428571429
jwpcpptapzjx'vniwum',0,20,3,17,2,0.176470588235294
peracetic,1,9,4,5,0,0.8
ctiphe,0,6,2,4,0,0.5
sego,1,4,2,2,0,1
hyperpigments,0,13,3,10,0,0.3
machedisstebychifurtinis,0,24,8,16,0,0.5
calamodendron,1,13,5,8,0,0.625
unmature,1,8,4,4,0,1
baudekin,1,8,4,4,0,1
nonsy,0,5,1,4,0,0.25
heykwxlpddizgulzc,0,17,3,14,0,0.214285714285714
bafwaicytavbmuuahihbyacri,0,25,10,15,0,0.666666666666667
furned,0,6,2,4,0,0.5
qjpiqivhpfuqc,0,13,3,10,0,0.3
teonanachronism,0,15,6,9,0,0.666666666666667
limnobiology,1,12,5,7,0,0.714285714285714
swordistoped,0,12,4,8,0,0.5
dhechukcivrsrv'hr,0,17,3,14,1,0.214285714285714
grunberg,1,8,2,6,0,0.333333333333333
dolgellau,1,9,4,5,0,0.8
anosmia,1,7,4,3,0,1.33333333333333
introductorinesses,1,18,7,11,0,0.636363636363636
estonians,1,9,4,5,0,0.8
festatus,1,8,3,5,0,0.6
vindahl,0,7,2,5,0,0.4
almightings,0,11,3,8,0,0.375
bohykkhed,0,9,2,7,0,0.285714285714286
physiogenic,1,11,4,7,0,0.571428571428571
netropreased,0,12,5,7,0,0.714285714285714
erarviethifia,0,13,7,6,0,1.16666666666667
cevdet,1,6,2,4,0,0.5
pennysiller,1,11,3,8,0,0.375
saccadge,1,8,3,5,0,0.6
olefinic,1,8,4,4,0,1
aquarelle,1,9,5,4,0,1.25
gawknochroni,0,12,4,8,0,0.5
go,1,2,1,1,0,1
floozie,1,7,4,3,0,1.33333333333333
ligeance,1,8,4,4,0,1
figurativeness,1,14,6,8,0,0.75
jokebook,1,8,4,4,0,1
exosporium,1,10,5,5,0,1
nqwvlsbfznwl,0,12,0,12,0,0
barnes,1,6,2,4,0,0.5
graveship,1,9,3,6,0,0.5
laes,0,4,2,2,0,1
transposability,1,15,5,10,0,0.5
casark,0,6,2,4,0,0.5
biometry,1,8,3,5,0,0.6
brasilians,0,10,4,6,0,0.666666666666667
diastematic,1,11,5,6,0,0.833333333333333
measures,1,8,4,4,0,1
underexposing,1,13,5,8,0,0.625
dhe,0,3,1,2,0,0.5
xdeqhefxsdwgzvl'uqbla,0,21,4,17,1,0.235294117647059
mayon,0,5,2,3,0,0.666666666666667
challaning,1,10,3,7,0,0.428571428571429
hmy,0,3,0,3,0,0
ameliorate,1,10,6,4,0,1.5
iconoclastics,0,13,5,8,0,0.625
measure,1,7,4,3,0,1.33333333333333
u'jdruljip,0,10,3,7,1,0.428571428571429
obtusenesses,1,12,5,7,0,0.714285714285714
topee,1,5,3,2,0,1.5
swimminute,0,10,4,6,0,0.666666666666667
kernon,0,6,2,4,0,0.5
cohn,1,4,1,3,0,0.333333333333333
siamese,1,7,4,3,0,1.33333333333333
polkily,0,7,2,5,0,0.4
pywhb,0,5,0,5,0,0
enlargens,1,9,3,6,0,0.5
plna,0,4,1,3,0,0.333333333333333
preacher,1,8,3,5,0,0.6
staphyle,1,8,2,6,0,0.333333333333333
gently,1,6,1,5,0,0.2
fireworm,1,8,3,5,0,0.6
shau,0,4,2,2,0,1
nonderdeidae,0,12,6,6,0,1
yfys,0,4,0,4,0,0
omsvlhutajgxjm,0,14,3,11,0,0.272727272727273
zmzcqwwec,0,9,1,8,0,0.125
emile,1,5,3,2,0,1.5
tackhearsenidae,0,15,7,8,0,0.875
metagrobolising,1,15,6,9,0,0.666666666666667
preswallow,1,10,3,7,0,0.428571428571429
piecree,0,7,4,3,0,1.33333333333333
verdubitation,0,13,6,7,0,0.857142857142857
sabblaysiollickeeps,0,19,7,12,0,0.583333333333333
merinesseisms,0,13,5,8,0,0.625
kness,0,5,1,4,0,0.25
fritz,1,5,1,4,0,0.25
predefinitions,1,14,6,8,0,0.75
applity,0,7,2,5,0,0.4
sonsofbitchers,0,14,4,10,0,0.4
detachability,1,13,5,8,0,0.625
cogory,0,6,2,4,0,0.5
fischbein,1,9,3,6,0,0.5
polychromatophilic,1,18,6,12,0,0.5
dacelonings,0,11,4,7,0,0.571428571428571
orata,0,5,3,2,0,1.5
maypop,1,6,2,4,0,0.5
prmaafztgwcjwsm,0,15,2,13,0,0.153846153846154
cologisticularchia,0,18,8,10,0,0.8
faultlessness,1,13,4,9,0,0.444444444444444
'tcygwlvugq,0,11,1,10,1,0.1
bucraniophagies,0,15,7,8,0,0.875
aspiculous,1,10,5,5,0,1
belvice,0,7,3,4,0,0.75
tkoumttznkqkgbu,0,15,3,12,0,0.25
gconv,1,5,1,4,0,0.25
bryanidraman,0,12,4,8,0,0.5
tunnell,1,7,2,5,0,0.4
gloquenterlenced,0,16,6,10,0,0.6
pmadoppralinaun,0,15,6,9,0,0.666666666666667
syagush,1,7,2,5,0,0.4
unicule,0,7,4,3,0,1.33333333333333
glawlithyl,0,10,2,8,0,0.25
pseudocumidine,1,14,7,7,0,1
piecework,1,9,4,5,0,0.8
octodywidge,0,11,4,7,0,0.571428571428571
renegade,1,8,4,4,0,1
chomartevoly,0,12,4,8,0,0.5
paraclete,1,9,4,5,0,0.8
chinin,1,6,2,4,0,0.5
nonichawbasationortrofs,0,23,9,14,0,0.642857142857143
mir,1,3,1,2,0,0.5
irrate,1,6,3,3,0,1
isordinatanic,0,13,6,7,0,0.857142857142857
asseal,1,6,3,3,0,1
counterdecree,1,13,6,7,0,0.857142857142857
tjvylmwwswowi,0,13,2,11,0,0.181818181818182
yellowest,1,9,3,6,0,0.5
exp,1,3,1,2,0,0.5
eroncorylovermoinisevaddi,0,25,11,14,0,0.785714285714286
selfeffacing,1,12,4,8,0,0.5
overmournfulness,1,16,6,10,0,0.6
gantlope,1,8,3,5,0,0.6
outgars,0,7,3,4,0,0.75
persatcherprefeadin,0,19,7,12,0,0.583333333333333
moothouse,1,9,5,4,0,1.25
velociraptors,1,13,5,8,0,0.625
polyclinic,1,10,3,7,0,0.428571428571429
tunaburger,1,10,4,6,0,0.666666666666667
unjumbled,1,9,3,6,0,0.5
danuriases,0,10,5,5,0,1
teless,0,6,2,4,0,0.5
stammels,1,8,2,6,0,0.333333333333333
amphicyonin,0,11,4,7,0,0.571428571428571
hollidam,1,8,3,5,0,0.6
hardshell,1,9,2,7,0,0.285714285714286
hatful,1,6,2,4,0,0.5
boutiques,1,9,5,4,0,1.25
besmoothhound,0,13,5,8,0,0.625
midspace,1,8,3,5,0,0.6
chondrosarcoma,1,14,5,9,0,0.555555555555556
heavy,1,5,2,3,0,0.666666666666667
baguios,1,7,4,3,0,1.33333333333333
necrotomist,1,11,4,7,0,0.571428571428571
conelike,1,8,4,4,0,1
ble,0,3,1,2,0,0.5
appropinqued,1,12,5,7,0,0.714285714285714
unressianden,0,12,5,7,0,0.714285714285714
incorporeal,1,11,5,6,0,0.833333333333333
coagencies,1,10,5,5,0,1
phanlike,0,8,3,5,0,0.6
selector,1,8,3,5,0,0.6
pholading,0,9,3,6,0,0.5
dauntless,1,9,3,6,0,0.5
mundy,1,5,1,4,0,0.25
mermithidae,1,11,5,6,0,0.833333333333333
ffborbbuw'zzuzpwztsdjauhnhtg,0,28,5,23,1,0.217391304347826
casually,1,8,3,5,0,0.6
educt,1,5,2,3,0,0.666666666666667
corny,1,5,1,4,0,0.25
nicadle,0,7,3,4,0,0.75
lordkin,1,7,2,5,0,0.4
biskiose,0,8,4,4,0,1
verbalised,1,10,4,6,0,0.666666666666667
megasyntheton,0,13,4,9,0,0.444444444444444
moingwena,1,9,4,5,0,0.8
camery,0,6,2,4,0,0.5
phonautographies,0,16,7,9,0,0.777777777777778
lifs,0,4,1,3,0,0.333333333333333
bonelopeen,0,10,5,5,0,1
physicomorphite,0,15,5,10,0,0.5
electrometers,1,13,5,8,0,0.625
arraigners,1,10,4,6,0,0.666666666666667
bqkcnvyykbhurkim'ay,0,19,3,16,1,0.1875
reecho,1,6,3,3,0,1
amplorableness,0,14,5,9,0,0.555555555555556
ostopsine,0,9,4,5,0,0.8
cllatae,0,7,3,4,0,0.75
rayshell,1,8,2,6,0,0.333333333333333
telautomatises,0,14,7,7,0,1
typhonian,1,9,3,6,0,0.5
tracheoschisis,1,14,5,9,0,0.555555555555556
pressive,1,8,3,5,0,0.6
dalmatian,1,9,4,5,0,0.8
belium,0,6,3,3,0,1
thistochronograph,0,17,5,12,0,0.416666666666667
consignificant,1,14,5,9,0,0.555555555555556
und,0,3,1,2,0,0.5
unwarfurties,0,12,5,7,0,0.714285714285714
munsey,1,6,2,4,0,0.5
psomiveroograccitintnck,0,23,8,15,0,0.533333333333333
ercurvents,0,10,3,7,0,0.428571428571429
unhuzzaed,1,9,4,5,0,0.8
eury,0,4,2,2,0,1
euphemise,1,9,5,4,0,1.25
johnsones,0,9,3,6,0,0.5
dogsledders,1,11,3,8,0,0.375
conishake,0,9,4,5,0,0.8
catostomoid,1,11,5,6,0,0.833333333333333
cuddlelessnesses,0,16,5,11,0,0.454545454545455
consumerism,1,11,4,7,0,0.571428571428571
earflaps,1,8,3,5,0,0.6
jamnis,1,6,2,4,0,0.5
witis,0,5,2,3,0,0.666666666666667
charcutered,0,11,4,7,0,0.571428571428571
phamad,0,6,2,4,0,0.5
danya,1,5,2,3,0,0.666666666666667
conskewomed,0,11,4,7,0,0.571428571428571
galese,0,6,3,3,0,1
gmelinas,1,8,3,5,0,0.6
whizkid,1,7,2,5,0,0.4
samite,1,6,3,3,0,1
mazarinades,1,11,5,6,0,0.833333333333333
ynfeqdsoegogfadtqulsxn,0,22,6,16,0,0.375
downweed,1,8,3,5,0,0.6
vocability,1,10,4,6,0,0.666666666666667
trolleyed,1,9,3,6,0,0.5
rebellow,1,8,3,5,0,0.6
oieitssdu,0,9,5,4,0,1.25
brace,1,5,2,3,0,0.666666666666667
entourage,1,9,5,4,0,1.25
synagogue,1,9,4,5,0,0.8
cliquier,1,8,4,4,0,1
cushing,1,7,2,5,0,0.4
cpa,1,3,1,2,0,0.5
worantennl,0,10,3,7,0,0.428571428571429
ullit,0,5,2,3,0,0.666666666666667
nonsick,0,7,2,5,0,0.4
nfllinggiddvftqnrirnzqlfskxe,0,28,4,24,0,0.166666666666667
joriykqevo,0,10,4,6,0,0.666666666666667
genelders,0,9,3,6,0,0.5
caulics,0,7,3,4,0,0.75
gingicanses,0,11,4,7,0,0.571428571428571
montluion,1,9,4,5,0,0.8
dutchwoman,1,10,3,7,0,0.428571428571429
purdy,1,5,1,4,0,0.25
forger,1,6,2,4,0,0.5
hwcstlnnezkaqupxs,0,17,3,14,0,0.214285714285714
ackfaceucaretert,0,16,7,9,0,0.777777777777778
glacis,1,6,2,4,0,0.5
belauds,1,7,3,4,0,0.75
tapermaking,1,11,4,7,0,0.571428571428571
ovid,1,4,2,2,0,1
',0,1,0,1,1,0
intoxicatingly,1,14,5,9,0,0.555555555555556
growers,1,7,2,5,0,0.4
recuperableness,0,15,6,9,0,0.666666666666667
agerartiee,0,10,6,4,0,1.5
amichhofleism,0,13,5,8,0,0.625
slinte,1,6,2,4,0,0.5
eycuhylmv',0,10,2,8,1,0.25
nonblockinged,0,13,4,9,0,0.444444444444444
rcanemariptren,0,14,5,9,0,0.555555555555556
strenuousness,1,13,5,8,0,0.625
dennisville,1,11,4,7,0,0.571428571428571
miba,0,4,2,2,0,1
caryllium,0,9,3,6,0,0.5
floccinaucinihilipilification,1,29,14,15,0,0.933333333333333
skenai,1,6,3,3,0,1
scitur,0,6,2,4,0,0.5
begoniaceae,1,11,7,4,0,1.75
dicrack,0,7,2,5,0,0.4
acculturizing,1,13,5,8,0,0.625
laundercut,0,10,4,6,0,0.666666666666667
scollating,0,10,3,7,0,0.428571428571429
circaeaceae,1,11,7,4,0,1.75
adulterna,0,9,4,5,0,0.8
paschals,1,8,2,6,0,0.333333333333333
trn,0,3,0,3,0,0
lametersenic,0,12,5,7,0,0.714285714285714
'oupctdtgbbtgdsi,0,16,3,13,1,0.230769230769231
ungilt,1,6,2,4,0,0.5
kscaent,0,7,2,5,0,0.4
embargoed,1,9,4,5,0,0.8
macrorhagias,0,12,5,7,0,0.714285714285714
tzcjvgtnjuzvvhenhpyzkxg,0,23,2,21,0,0.0952380952380952
overfierce,1,10,5,5,0,1
boxyn,0,5,1,4,0,0.25
cagers,1,6,2,4,0,0.5
polygenisms,1,11,3,8,0,0.375
kosice,1,6,3,3,0,1
paratomial,1,10,5,5,0,1
disilludes,1,10,4,6,0,0.666666666666667
aeroehmic,0,9,5,4,0,1.25
saccomyidae,1,11,5,6,0,0.833333333333333
depraving,1,9,3,6,0,0.5
'bvybgz'xvchelzo'pzuyqep,0,24,4,20,3,0.2
infraordinals,0,13,5,8,0,0.625
zumlzgpyctjynqy'nldjampwzrdgpm,0,30,2,28,1,0.0714285714285714
rollicker,1,9,3,6,0,0.5
pupikeand,0,9,4,5,0,0.8
rpq,1,3,0,3,0,0
nucles,0,6,2,4,0,0.5
consubstanitise,0,15,6,9,0,0.666666666666667
gyktmlnjrnmbd'cxe,0,17,1,16,1,0.0625
cantings,1,8,2,6,0,0.333333333333333
phragmipedium,1,13,5,8,0,0.625
mahopac,1,7,3,4,0,0.75
catisea,0,7,4,3,0,1.33333333333333
kirgirds,0,8,2,6,0,0.333333333333333
tunnelmaking,1,12,4,8,0,0.5
bothe,1,5,2,3,0,0.666666666666667
approximately,1,13,5,8,0,0.625
heboks,0,6,2,4,0,0.5
christyna,1,9,2,7,0,0.285714285714286
crustlessness,0,13,3,10,0,0.3
dialytically,1,12,4,8,0,0.5
wfhmbbrwltr,0,11,0,11,0,0
pliosaur,1,8,4,4,0,1
ctierpktzszyf,0,13,2,11,0,0.181818181818182
ekslmourarr,0,11,4,7,0,0.571428571428571
mediotarsal,1,11,5,6,0,0.833333333333333
replunges,1,9,3,6,0,0.5
lieges,1,6,3,3,0,1
busk,1,4,1,3,0,0.333333333333333
rgubufggirkbslzpw,0,17,3,14,0,0.214285714285714
sperquideutaker,0,15,7,8,0,0.875
coccuse,0,7,3,4,0,0.75
troubleshooting,1,15,6,9,0,0.666666666666667
mayme,1,5,2,3,0,0.666666666666667
xkq'zhjafz,0,10,1,9,1,0.111111111111111
monensin,1,8,3,5,0,0.6
faciebitia,0,10,6,4,0,1.5
pullback,1,8,2,6,0,0.333333333333333
wmeus,0,5,2,3,0,0.666666666666667
ucjc'ylkf'dlxzgszhf'l,0,21,1,20,3,0.05
scarfpin,1,8,2,6,0,0.333333333333333
tolon,0,5,2,3,0,0.666666666666667
conductiblock,0,13,4,9,0,0.444444444444444
colpo,0,5,2,3,0,0.666666666666667
botalluckofictually,0,19,7,12,0,0.583333333333333
rehboc,1,6,2,4,0,0.5
pondus,1,6,2,4,0,0.5
kymri,1,5,1,4,0,0.25
woodwin,0,7,3,4,0,0.75
orobances,0,9,4,5,0,0.8
douziemes,1,9,5,4,0,1.25
feuillage,1,9,5,4,0,1.25
ssxgnlaujdujlbjh'ggzwmzw,0,24,3,21,1,0.142857142857143
quinderfish,0,11,4,7,0,0.571428571428571
civium,0,6,3,3,0,1
ductomyrishbosess,0,17,5,12,0,0.416666666666667
wyking,0,6,1,5,0,0.2
antivandalism,1,13,5,8,0,0.625
encephalotomy,1,13,5,8,0,0.625
linolenic,1,9,4,5,0,0.8
pleurers,0,8,3,5,0,0.6
goldshier,0,9,3,6,0,0.5
carnes,1,6,2,4,0,0.5
arbuscultus,0,11,4,7,0,0.571428571428571
gloxinia,1,8,4,4,0,1
drollness,1,9,2,7,0,0.285714285714286
manuscriptal,1,12,4,8,0,0.5
bles,0,4,1,3,0,0.333333333333333
agami,1,5,3,2,0,1.5
edan,1,4,2,2,0,1
carlyn,1,6,1,5,0,0.2
daesson,0,7,3,4,0,0.75
violer,1,6,3,3,0,1
chining,1,7,2,5,0,0.4
borosilicate,1,12,6,6,0,1
kyanism,0,7,2,5,0,0.4
uyziezqpjidosnbqpehgpve,0,23,7,16,0,0.4375
weingartner,1,11,4,7,0,0.571428571428571
inebriant,1,9,4,5,0,0.8
filoplumaceous,1,14,7,7,0,1
alkalises,1,9,4,5,0,0.8
protomartyr,1,11,3,8,0,0.375
miscaller,1,9,3,6,0,0.5
lucubration,1,11,5,6,0,0.833333333333333
wawaka,1,6,3,3,0,1
divebombing,1,11,4,7,0,0.571428571428571
unscaly,1,7,2,5,0,0.4
zmiz,0,4,1,3,0,0.333333333333333
zincivier,0,9,4,5,0,0.8
ueneengelewerotiffowapidelaly,0,29,14,15,0,0.933333333333333
choultry,1,8,2,6,0,0.333333333333333
intraphilosophic,1,16,6,10,0,0.6
surestation,0,11,5,6,0,0.833333333333333
trestles,1,8,2,6,0,0.333333333333333
praepubis,1,9,4,5,0,0.8
favowerlunut,0,12,5,7,0,0.714285714285714
mifflinburg,1,11,3,8,0,0.375
florey,1,6,2,4,0,0.5
ghardaoa,1,8,4,4,0,1
guggles,1,7,2,5,0,0.4
riandella,0,9,4,5,0,0.8
tuneful,1,7,3,4,0,0.75
ardol,0,5,2,3,0,0.666666666666667
polystomella,1,12,4,8,0,0.5
areters,0,7,3,4,0,0.75
monmatvopl,0,10,3,7,0,0.428571428571429
palterers,1,9,3,6,0,0.5
underscrub,1,10,3,7,0,0.428571428571429
reflexes,1,8,3,5,0,0.6
mismanageablenesses,0,19,8,11,0,0.727272727272727
tortenter,0,9,3,6,0,0.5
neutrodyne,1,10,4,6,0,0.666666666666667
priapulacea,1,11,6,5,0,1.2
bianchi,1,7,3,4,0,0.75
aughtkedurpreglous,0,18,7,11,0,0.636363636363636
doctor,1,6,2,4,0,0.5
goats,1,5,2,3,0,0.666666666666667
excoriator,1,10,5,5,0,1
dkpcw,0,5,0,5,0,0
allene,1,6,3,3,0,1
almains,1,7,3,4,0,0.75
admitier,0,8,4,4,0,1
cdorzeduvvd,0,11,3,8,0,0.375
nons,0,4,1,3,0,0.333333333333333
zira,1,4,2,2,0,1
pric,0,4,1,3,0,0.333333333333333
corylet,1,7,2,5,0,0.4
playmology,0,10,3,7,0,0.428571428571429
pirogueships,0,12,5,7,0,0.714285714285714
customisers,1,11,4,7,0,0.571428571428571
arod,0,4,2,2,0,1
negroperates,0,12,5,7,0,0.714285714285714
delaware,1,8,4,4,0,1
trabaalogy,0,10,4,6,0,0.666666666666667
psychoprophagous,0,16,5,11,0,0.454545454545455
nonadapting,1,11,4,7,0,0.571428571428571
prodomons,0,9,3,6,0,0.5
wwwyrloserqufusglrsrqhz'ftftg,0,29,4,25,1,0.16
depp,1,4,1,3,0,0.333333333333333
blackworks,0,10,2,8,0,0.25
secernmentalism,0,15,5,10,0,0.5
benone,0,6,3,3,0,1
unfruitedly,0,11,4,7,0,0.571428571428571
nogj'f'pjaoq,0,12,3,9,2,0.333333333333333
drodipokemativeres,0,18,8,10,0,0.8
bespiritedness,0,14,5,9,0,0.555555555555556
antzpg,0,6,1,5,0,0.2
lange,1,5,2,3,0,0.666666666666667
paleozoic,1,9,5,4,0,1.25
occitan,1,7,3,4,0,0.75
montevideo,1,10,5,5,0,1
klaiyyeduhyhttmjzlau,0,20,6,14,0,0.428571428571429
lucinda,1,7,3,4,0,0.75
marabou,1,7,4,3,0,1.33333333333333
monotonosemouth,0,15,7,8,0,0.875
hypopial,1,8,3,5,0,0.6
shri,1,4,1,3,0,0.333333333333333
antiapartheid,1,13,6,7,0,0.857142857142857
tred,0,4,1,3,0,0.333333333333333
cytosine,1,8,3,5,0,0.6
starvatism,0,10,3,7,0,0.428571428571429
reteller,1,8,3,5,0,0.6
pontepatjan,0,11,4,7,0,0.571428571428571
ditzier,1,7,3,4,0,0.75
bruns,1,5,1,4,0,0.25
heliotropine,1,12,6,6,0,1
resell,1,6,2,4,0,0.5
toportablen,0,11,4,7,0,0.571428571428571
artebunpikarvar,0,15,6,9,0,0.666666666666667
bioelectrol,0,11,5,6,0,0.833333333333333
reatoultidae,0,12,7,5,0,1.4
raphathousists,0,14,5,9,0,0.555555555555556
lybs,0,4,0,4,0,0
phalus,0,6,2,4,0,0.5
moderwomapeys,0,13,5,8,0,0.625
upconjure,1,9,4,5,0,0.8
'jmxqedagssoudppvwy,0,19,4,15,1,0.266666666666667
kild,1,4,1,3,0,0.333333333333333
seraliseddah,0,12,5,7,0,0.714285714285714
boateria,0,8,5,3,0,1.66666666666667
belfield,1,8,3,5,0,0.6
dismstradia,0,11,4,7,0,0.571428571428571
gentlewomen,1,11,4,7,0,0.571428571428571
unessenced,1,10,4,6,0,0.666666666666667
hairinesses,1,11,5,6,0,0.833333333333333
eoliennes,1,9,5,4,0,1.25
malapropian,1,11,5,6,0,0.833333333333333
culliton,1,8,3,5,0,0.6
transillumination,1,17,7,10,0,0.7
meles,1,5,2,3,0,0.666666666666667
preworket,0,9,3,6,0,0.5
tetraspore,1,10,4,6,0,0.666666666666667
bbwhutune,0,9,3,6,0,0.5
'ksyjfij'd'vallmzf',0,19,2,17,4,0.117647058823529
fhwfketfpgdpdeu',0,16,3,13,1,0.230769230769231
haemopis,1,8,4,4,0,1
juices,1,6,3,3,0,1
overmanagerialistic,0,19,9,10,0,0.9
higenitentillent,0,16,6,10,0,0.6
portieres,1,9,4,5,0,0.8
phrase,1,6,2,4,0,0.5
rris,0,4,1,3,0,0.333333333333333
interruptibleness,0,17,6,11,0,0.545454545454545
monomyarii,0,10,5,5,0,1
carissa,1,7,3,4,0,0.75
attractancy,1,11,3,8,0,0.375
hyperablerlifulibunded,0,22,8,14,0,0.571428571428571
dombas,0,6,2,4,0,0.5
tarlison,0,8,3,5,0,0.6
voluntedness,0,12,4,8,0,0.5
lockmen,1,7,2,5,0,0.4
huidobro,1,8,4,4,0,1
vjeqxvqmrymveemtyl,0,18,3,15,0,0.2
toreremaloresnatilatriafidiciov,0,31,15,16,0,0.9375
drury,1,5,1,4,0,0.25
neurocentral,1,12,5,7,0,0.714285714285714
limpness,1,8,2,6,0,0.333333333333333
tamans,0,6,2,4,0,0.5
banders,1,7,2,5,0,0.4
proteric,0,8,3,5,0,0.6
angiocardiography,1,17,7,10,0,0.7
unrivitia,0,9,5,4,0,1.25
hydraphylesses,0,14,3,11,0,0.272727272727273
valhalla,1,8,3,5,0,0.6
bvwcu,0,5,1,4,0,0.25
gazumpers,1,9,3,6,0,0.5
isunanistabolive,0,16,8,8,0,1
ohal'dugztdatbumvylsq,0,21,5,16,1,0.3125
nwpikdjvgjcnekisylf,0,19,3,16,0,0.1875
cloys,1,5,1,4,0,0.25
pedatifid,1,9,4,5,0,0.8
sezelsoningsic,0,14,5,9,0,0.555555555555556
monofuel,1,8,4,4,0,1
fyfrfrstkunepjhyozbc'nxfib,0,26,4,22,1,0.181818181818182
umestinitahummblbanewaciactrewisle,0,34,14,20,0,0.7
wildean,1,7,3,4,0,0.75
biazuctiniptascredlent,0,22,8,14,0,0.571428571428571
phesuneneelyscory,0,17,6,11,0,0.545454545454545
formamide,1,9,4,5,0,0.8
molothrus,1,9,3,6,0,0.5
talvile,0,7,3,4,0,0.75
hz,1,2,0,2,0,0
hypercondensibility,0,19,6,13,0,0.461538461538462
spunkinesses,1,12,4,8,0,0.5
scratchweed,1,11,3,8,0,0.375
iezmexz'fmqd,0,12,3,9,1,0.333333333333333
greenlandic,1,11,4,7,0,0.571428571428571
binous,1,6,3,3,0,1
polonial,1,8,4,4,0,1
phosibinson,0,11,4,7,0,0.571428571428571
xhosaurus,0,9,4,5,0,0.8
whillywhaws,1,11,2,9,0,0.222222222222222
eakiclcaldalantinaglurallobulyst,0,32,12,20,0,0.6
ponying,1,7,2,5,0,0.4
mediae,1,6,4,2,0,2
sworpronsist,0,12,3,9,0,0.333333333333333
nondegradables,1,14,5,9,0,0.555555555555556
cadde,0,5,2,3,0,0.666666666666667
pretergress,1,11,3,8,0,0.375
databilizinesses,0,16,7,9,0,0.777777777777778
yee,1,3,2,1,0,2
rustruta,0,8,3,5,0,0.6
occidentalization,0,17,8,9,0,0.888888888888889
sphoerizalesco,0,14,6,8,0,0.75
bali,1,4,2,2,0,1
colectomies,1,11,5,6,0,0.833333333333333
ticoveo,0,7,4,3,0,1.33333333333333
expectivendowedgie,0,18,8,10,0,0.8
dunhidl'jgffc,0,13,2,11,1,0.181818181818182
airspace,1,8,4,4,0,1
graftage,1,8,3,5,0,0.6
factive,1,7,3,4,0,0.75
intertubularians,0,16,7,9,0,0.777777777777778
menetheaeracip,0,14,7,7,0,1
astraphobias,1,12,5,7,0,0.714285714285714
jcb,1,3,0,3,0,0
empatrons,1,9,3,6,0,0.5
astroworms,0,10,3,7,0,0.428571428571429
hollock,0,7,2,5,0,0.4
underpressed,0,12,4,8,0,0.5
cellulomonadeae,1,15,8,7,0,1.14285714285714
breathabilities,1,15,7,8,0,0.875
bvbrzwgwetvlytrlx,0,17,1,16,0,0.0625
cyther,0,6,1,5,0,0.2
interferingness,1,15,5,10,0,0.5
iugqzop,0,7,3,4,0,0.75
unfelder,0,8,3,5,0,0.6
unfoodowniannoo,0,15,8,7,0,1.14285714285714
bungeys,1,7,2,5,0,0.4
ejkthm'uzkipdwfprc,0,18,3,15,1,0.2
ismaelitis,0,10,5,5,0,1
awakings,1,8,3,5,0,0.6
unsilly,1,7,2,5,0,0.4
ourobond,0,8,4,4,0,1
troys,1,5,1,4,0,0.25
micropin,1,8,3,5,0,0.6
lita,1,4,2,2,0,1
pretechnic,0,10,3,7,0,0.428571428571429
hilen,0,5,2,3,0,0.666666666666667
ordines,0,7,3,4,0,0.75
pigfishamelidonies,0,18,8,10,0,0.8
commodiously,1,12,5,7,0,0.714285714285714
pronunciamento,1,14,6,8,0,0.75
vangelically,0,12,4,8,0,0.5
whirland,0,8,2,6,0,0.333333333333333
glenhayes,1,9,3,6,0,0.5
balantidiasis,1,13,6,7,0,0.857142857142857
obvolutionary,0,13,6,7,0,0.857142857142857
spytoes,0,7,2,5,0,0.4
organomalogue,0,13,7,6,0,1.16666666666667
juliette,1,8,4,4,0,1
taxidermised,1,12,5,7,0,0.714285714285714
misecclesiastic,1,15,6,9,0,0.666666666666667
yaexrnlcywknww,0,14,2,12,0,0.166666666666667
assagai,1,7,4,3,0,1.33333333333333
craggy,1,6,1,5,0,0.2
feugiaowlqmdxhzh,0,16,5,11,0,0.454545454545455
roraurrris,0,10,4,6,0,0.666666666666667
petite,1,6,3,3,0,1
flivaluxctieliad,0,16,7,9,0,0.777777777777778
dreasten,0,8,3,5,0,0.6
gauging,1,7,3,4,0,0.75
sofars,1,6,2,4,0,0.5
hyjiwxmevsyu'fypbh'tewj,0,23,4,19,2,0.210526315789474
keres,1,5,2,3,0,0.666666666666667
hochelaga,1,9,4,5,0,0.8
preincreased,1,12,5,7,0,0.714285714285714
wallings,1,8,2,6,0,0.333333333333333
outwaltherne,0,12,5,7,0,0.714285714285714
nhqkfwxfaw,0,10,1,9,0,0.111111111111111
nticra,0,6,2,4,0,0.5
bacteroportenaritorologic,0,25,11,14,0,0.785714285714286
discerningly,1,12,3,9,0,0.333333333333333
chiacking,1,9,3,6,0,0.5
aspergillin,1,11,4,7,0,0.571428571428571
zaddik,1,6,2,4,0,0.5
unings,0,6,2,4,0,0.5
unindigenous,1,12,6,6,0,1
pfvn,0,4,0,4,0,0
avisements,1,10,4,6,0,0.666666666666667
millennial,1,10,4,6,0,0.666666666666667
pomotallagieura,0,15,8,7,0,1.14285714285714
nocephalazareanane,0,18,9,9,0,1
dorweiler,1,9,4,5,0,0.8
ganza,0,5,2,3,0,0.666666666666667
gration,0,7,3,4,0,0.75
tymorphis,0,9,2,7,0,0.285714285714286
scotophobias,0,12,5,7,0,0.714285714285714
renean,0,6,3,3,0,1
langworthy,1,10,2,8,0,0.25
bobeche,1,7,3,4,0,0.75
overheat,1,8,4,4,0,1
boltzman,0,8,2,6,0,0.333333333333333
candollea,1,9,4,5,0,0.8
galettes,1,8,3,5,0,0.6
disunionism,1,11,5,6,0,0.833333333333333
awake,1,5,3,2,0,1.5
noneuroscopine,0,14,7,7,0,1
deltidaceae,0,11,6,5,0,1.2
nzhme,0,5,1,4,0,0.25
certo,0,5,2,3,0,0.666666666666667
huddleston,1,10,3,7,0,0.428571428571429
perisalpingitis,1,15,6,9,0,0.666666666666667
chuckram,1,8,2,6,0,0.333333333333333
utssayiererotat,0,15,7,8,0,0.875
headpeace,1,9,5,4,0,1.25
dinatisinouitserspllititedaedm,0,30,13,17,0,0.764705882352941
mecturaterey,0,12,5,7,0,0.714285714285714
cloyer,1,6,2,4,0,0.5
ntreticatolonarinqulycontonilisoramiodin,0,40,17,23,0,0.739130434782609
pseudoinspirational,1,19,9,10,0,0.9
shortening,1,10,3,7,0,0.428571428571429
euphemisation,1,13,7,6,0,1.16666666666667
talelyritlurimbis,0,17,6,11,0,0.545454545454545
iprising,0,8,3,5,0,0.6
casion,0,6,3,3,0,1
intantematoppine,0,16,7,9,0,0.777777777777778
hipqfjz,0,7,1,6,0,0.166666666666667
bacterizations,1,14,6,8,0,0.75
'aecgnhoaxquiabv'md,0,19,7,12,2,0.583333333333333
inconfinglycil,0,14,4,10,0,0.4
drawers,1,7,2,5,0,0.4
multipolarity,1,13,5,8,0,0.625
tugrik,1,6,2,4,0,0.5
crystalities,0,12,4,8,0,0.5
digmaxitypoewin,0,15,6,9,0,0.666666666666667
grishun,1,7,2,5,0,0.4
subspecifications,0,17,7,10,0,0.7
christless,1,10,2,8,0,0.25
oelet,1,5,3,2,0,1.5
shwas,1,5,1,4,0,0.25
ortynamidendrombiencin,0,22,8,14,0,0.571428571428571
objurgatrix,1,11,4,7,0,0.571428571428571
rentionic,0,9,4,5,0,0.8
crumpliest,1,10,3,7,0,0.428571428571429
espagnuolo,0,10,5,5,0,1
seveloquenes,0,12,6,6,0,1
overextrapolation,1,17,8,9,0,0.888888888888889
envermeiled,1,11,5,6,0,0.833333333333333
gaudlian,0,8,4,4,0,1
mismanage,1,9,4,5,0,0.8
amadi,1,5,3,2,0,1.5
wanglehoofs,0,11,4,7,0,0.571428571428571
dvhcaqihqkiuu'x,0,15,5,10,1,0.5
undown,0,6,2,4,0,0.5
'aariizjbfvlcwgzsjkeuuqn,0,24,7,17,1,0.411764705882353
pined,1,5,2,3,0,0.666666666666667
sculpate,0,8,3,5,0,0.6
eliss,0,5,2,3,0,0.666666666666667
nsjxtbbkuw,0,10,1,9,0,0.111111111111111
outreasoned,1,11,6,5,0,1.2
limnetis,1,8,3,5,0,0.6
omnieruditeness,0,15,7,8,0,0.875
indwesfedsthycsikd,0,18,4,14,0,0.285714285714286
gyglzbwbpbed,0,12,1,11,0,0.0909090909090909
unfleshing,1,10,3,7,0,0.428571428571429
overter,0,7,3,4,0,0.75
feplilever,0,10,4,6,0,0.666666666666667
packable,1,8,3,5,0,0.6
acrodromous,1,11,5,6,0,0.833333333333333
rimpolyses,0,10,3,7,0,0.428571428571429
leptodactylid,1,13,4,9,0,0.444444444444444
profluviographist,0,17,6,11,0,0.545454545454545
heterocentric,1,13,5,8,0,0.625
bdellos,0,7,2,5,0,0.4
decerebrate,1,11,5,6,0,0.833333333333333
gttebidipiettantuenc,0,20,8,12,0,0.666666666666667
oppositeness,1,12,5,7,0,0.714285714285714
closers,1,7,2,5,0,0.4
anaerotrusso,0,12,6,6,0,1
daye,1,4,2,2,0,1
rootward,1,8,3,5,0,0.6
predeterminant,1,14,5,9,0,0.555555555555556
paddleballs,1,11,3,8,0,0.375
actinomycetales,1,15,6,9,0,0.666666666666667
ingravescence,1,13,5,8,0,0.625
journeyman,1,10,4,6,0,0.666666666666667
ebonist,1,7,3,4,0,0.75
vermonpololuctylene,0,19,7,12,0,0.583333333333333
ented,0,5,2,3,0,0.666666666666667
caravel,1,7,3,4,0,0.75
ammiral,1,7,3,4,0,0.75
hippoboscidae,1,13,6,7,0,0.857142857142857
spectrofluorometry,1,18,6,12,0,0.5
erydithales,0,11,4,7,0,0.571428571428571
underogambling,0,14,5,9,0,0.555555555555556
diarticulation,0,14,7,7,0,1
prgasabr,0,8,2,6,0,0.333333333333333
und,0,3,1,2,0,0.5
monocoelial,0,11,6,5,0,1.2
areface,0,7,4,3,0,1.33333333333333
kw'voz'wtlfbioolvtbio'wbrz,0,26,6,20,3,0.3
xkbcxkjbcmp,0,11,0,11,0,0
copalata,0,8,4,4,0,1
perameccabal,0,12,5,7,0,0.714285714285714
chloranthy,1,10,2,8,0,0.25
unguica,0,7,4,3,0,1.33333333333333
timarau,1,7,4,3,0,1.33333333333333
gmohrgqnrt,0,10,1,9,0,0.111111111111111
erdepen,0,7,3,4,0,0.75
croaky,1,6,2,4,0,0.5
autodrainage,1,12,7,5,0,1.4
geonavigator,0,12,6,6,0,1
boftiglia,0,9,4,5,0,0.8
rochkind,1,8,2,6,0,0.333333333333333
propionyl,1,9,3,6,0,0.5
backsplice,1,10,3,7,0,0.428571428571429
pacia,0,5,3,2,0,1.5
k'ziwsvooyhv,0,12,3,9,1,0.333333333333333
misrecollectives,0,16,6,10,0,0.6
modernisms,1,10,3,7,0,0.428571428571429
warranto,1,8,3,5,0,0.6
bawdric,1,7,2,5,0,0.4
oversleeves,1,11,5,6,0,0.833333333333333
bacterialism,0,12,5,7,0,0.714285714285714
madia,1,5,3,2,0,1.5
pxfehwlcdmodzirlrgbamc,0,22,4,18,0,0.222222222222222
dallis,1,6,2,4,0,0.5
microevolutionist,0,17,8,9,0,0.888888888888889
aguacateca,1,10,6,4,0,1.5
mukerji,1,7,3,4,0,0.75
gpfo'idflt,0,10,2,8,1,0.25
sisses,1,6,2,4,0,0.5
orolingualisms,0,14,6,8,0,0.75
cieasentse,0,10,5,5,0,1
withering,1,9,3,6,0,0.5
septembrian,1,11,4,7,0,0.571428571428571
timberman,1,9,3,6,0,0.5
donielled,0,9,4,5,0,0.8
uzecgifkjss,0,11,3,8,0,0.375
petrustibility,0,14,5,9,0,0.555555555555556
gb,1,2,0,2,0,0
anthropogeographies,1,19,8,11,0,0.727272727272727
eosinophilia,1,12,7,5,0,1.4
idiography,0,10,4,6,0,0.666666666666667
corydon,1,7,2,5,0,0.4
mphitriblefeost,0,15,5,10,0,0.5
meticulosity,1,12,5,7,0,0.714285714285714
unessential,1,11,5,6,0,0.833333333333333
prabostarampolbrineseetimarom,0,29,12,17,0,0.705882352941177
opthalmologists,0,15,5,10,0,0.5
intersecrete,0,12,5,7,0,0.714285714285714
semiformed,1,10,4,6,0,0.666666666666667
undereed,0,8,4,4,0,1
refind,1,6,2,4,0,0.5
chalcidid,1,9,3,6,0,0.5
pickes,0,6,2,4,0,0.5
vidle,0,5,2,3,0,0.666666666666667
nonnoble,1,8,3,5,0,0.6
unagitated,1,10,5,5,0,1
unswappable,1,11,4,7,0,0.571428571428571
bordures,1,8,3,5,0,0.6
unscopyracience,0,15,6,9,0,0.666666666666667
heezed,1,6,3,3,0,1
conspicuousness,1,15,6,9,0,0.666666666666667
isocolles,0,9,4,5,0,0.8
dsmillyskwtes,0,13,2,11,0,0.181818181818182
nonmicroscopy,0,13,4,9,0,0.444444444444444
unteness,0,8,3,5,0,0.6
forewomen,1,9,4,5,0,0.8
noncouperation,0,14,7,7,0,1
rutan,1,5,2,3,0,0.666666666666667
glassfiringing,0,14,4,10,0,0.4
'btetjxbrshklitx,0,16,2,14,1,0.142857142857143
xzdpric,0,7,1,6,0,0.166666666666667
caeb'gmdmzuymygi,0,16,4,12,1,0.333333333333333
torvidae,0,8,4,4,0,1
tidemills,1,9,3,6,0,0.5
unplayable,1,10,4,6,0,0.666666666666667
whittener,1,9,3,6,0,0.5
cawks,1,5,1,4,0,0.25
ama,1,3,2,1,0,2
haccictirs,0,10,3,7,0,0.428571428571429
kommunizma,1,10,4,6,0,0.666666666666667
kantia,0,6,3,3,0,1
threnies,0,8,3,5,0,0.6
bratium,0,7,3,4,0,0.75
fortition,0,9,4,5,0,0.8
bellbind,1,8,2,6,0,0.333333333333333
impactments,0,11,3,8,0,0.375
archargracewoman,0,16,6,10,0,0.6
dellaine,0,8,4,4,0,1
'dmuwcvxsbeytqsvweei,0,20,5,15,1,0.333333333333333
vaticinated,1,11,5,6,0,0.833333333333333
urolitical,0,10,5,5,0,1
resterocarative,0,15,7,8,0,0.875
saudis,1,6,3,3,0,1
swinburniaceae,0,14,7,7,0,1
hermophoroglingpointiful,0,24,9,15,0,0.6
zygophyllum,1,11,2,9,0,0.222222222222222
plerocerc,0,9,3,6,0,0.5
littling,1,8,2,6,0,0.333333333333333
bodylike,0,8,3,5,0,0.6
cheelman,0,8,3,5,0,0.6
secupperick,0,11,4,7,0,0.571428571428571
phonates,1,8,3,5,0,0.6
corrue,0,6,3,3,0,1
cesurae,1,7,4,3,0,1.33333333333333
collinae,0,8,4,4,0,1
husitionertin,0,13,6,7,0,0.857142857142857
godparenchwise,0,14,5,9,0,0.555555555555556
heperioityd,0,11,5,6,0,0.833333333333333
factice,1,7,3,4,0,0.75
overhunts,1,9,3,6,0,0.5
protanerso,0,10,4,6,0,0.666666666666667
veschudeprt,0,11,3,8,0,0.375
subpellucid,1,11,4,7,0,0.571428571428571
prephoaducar,0,12,5,7,0,0.714285714285714
keryrnesog,0,10,3,7,0,0.428571428571429
nonextrinsications,0,18,7,11,0,0.636363636363636
grous,1,5,2,3,0,0.666666666666667
siliquiform,1,11,5,6,0,0.833333333333333
dibranch,1,8,2,6,0,0.333333333333333
seesawing,1,9,4,5,0,0.8
unsarian,0,8,4,4,0,1
promercantile,1,13,5,8,0,0.625
samelastribulas,0,15,6,9,0,0.666666666666667
olmz'kahqwcnrdet,0,16,3,13,1,0.230769230769231
lmdeyqooqicx,0,12,4,8,0,0.5
somically,0,9,3,6,0,0.5
brucellosis,1,11,4,7,0,0.571428571428571
blainey,1,7,3,4,0,0.75
uncovetous,1,10,5,5,0,1
possessive,1,10,4,6,0,0.666666666666667
unsmen,0,6,2,4,0,0.5
buddhology,0,10,3,7,0,0.428571428571429
industry,1,8,2,6,0,0.333333333333333
equiprobabilities,1,17,9,8,0,1.125
synochoid,1,9,3,6,0,0.5
tapenade,1,8,4,4,0,1
advertreetalepsy,0,16,6,10,0,0.6
scolographeriurilise,0,20,9,11,0,0.818181818181818
nardraux,0,8,3,5,0,0.6
thoroughwide,0,12,5,7,0,0.714285714285714
karanes,0,7,3,4,0,0.75
sponginblastingnesses,0,21,6,15,0,0.4
folial,1,6,3,3,0,1
tattletales,1,11,4,7,0,0.571428571428571
mutating,1,8,3,5,0,0.6
mailly,0,6,2,4,0,0.5
podozamites,1,11,5,6,0,0.833333333333333
gatydeshris,0,11,3,8,0,0.375
intuitionalist,1,14,7,7,0,1
mortific,1,8,3,5,0,0.6
oomiacs,1,7,4,3,0,1.33333333333333
pueraria,1,8,5,3,0,1.66666666666667
yeaugporr'njgy,0,14,4,10,1,0.4
rvalenorerortticicoporxicheair,0,30,13,17,0,0.764705882352941
nashville,1,9,3,6,0,0.5
looyenworks,1,11,4,7,0,0.571428571428571
delictum,1,8,3,5,0,0.6
abboud,1,6,3,3,0,1
premechanical,1,13,5,8,0,0.625
marida,1,6,3,3,0,1
unexcogitable,1,13,6,7,0,0.857142857142857
ynhiavswpkgder,0,14,3,11,0,0.272727272727273
netidae,0,7,4,3,0,1.33333333333333
emmetrope,1,9,4,5,0,0.8
hyetograph,1,10,3,7,0,0.428571428571429
hammel,1,6,2,4,0,0.5
rescreen,1,8,3,5,0,0.6
bineesolinasm,0,13,6,7,0,0.857142857142857
trsa,1,4,1,3,0,0.333333333333333
biblicize,0,9,4,5,0,0.8
huddlemanite,0,12,5,7,0,0.714285714285714
upvacbdw'rhvrbxwpaq,0,19,3,16,1,0.1875
unrotary,1,8,3,5,0,0.6
ephemity,0,8,3,5,0,0.6
foreknown,1,9,3,6,0,0.5
lovelaceville,1,13,6,7,0,0.857142857142857
astrometrical,1,13,5,8,0,0.625
bacchanal,1,9,3,6,0,0.5
saltire,1,7,3,4,0,0.75
battlewagons,1,12,4,8,0,0.5
unconfidency,0,12,4,8,0,0.5
afton,1,5,2,3,0,0.666666666666667
hypermetise,0,11,4,7,0,0.571428571428571
subanid,0,7,3,4,0,0.75
grunch,1,6,1,5,0,0.2
appense,1,7,3,4,0,0.75
jgffzjftgpmry,0,13,0,13,0,0
nonhouseholder,1,14,6,8,0,0.75
sublineation,1,12,6,6,0,1
checkrein,1,9,3,6,0,0.5
cke,0,3,1,2,0,0.5
buyerestiness,0,13,5,8,0,0.625
hubristically,1,13,4,9,0,0.444444444444444
tranquiles,0,10,4,6,0,0.666666666666667
winehurstenger,0,14,5,9,0,0.555555555555556
trimestancy,0,11,3,8,0,0.375
unemotioned,1,11,6,5,0,1.2
ftins,0,5,1,4,0,0.25
pary,0,4,1,3,0,0.333333333333333
psalms,1,6,1,5,0,0.2
ap,0,2,1,1,0,1
hefam,0,5,2,3,0,0.666666666666667
valiasholly,0,11,4,7,0,0.571428571428571
kaminess,0,8,3,5,0,0.6
labial,1,6,3,3,0,1
plupatrid,0,9,3,6,0,0.5
gote,1,4,2,2,0,1
tapstry,1,7,1,6,0,0.166666666666667
js,1,2,0,2,0,0
cgp'qfuqt,0,9,1,8,1,0.125
hardiness,1,9,3,6,0,0.5
gayfeathercraftman,0,18,6,12,0,0.5
avapergouzzazooseenta,0,21,11,10,0,1.1
chironomers,1,11,4,7,0,0.571428571428571
dssairnatsxcq'hrguynghkggpm,0,27,4,23,1,0.173913043478261
nlugpyqakdlnin',0,15,3,12,1,0.25
cags,0,4,1,3,0,0.333333333333333
dod,1,3,1,2,0,0.5
purim,1,5,2,3,0,0.666666666666667
tartryl,1,7,1,6,0,0.166666666666667
statical,1,8,3,5,0,0.6
mootnesses,1,10,4,6,0,0.666666666666667
contemporary,1,12,4,8,0,0.5
hylavorkisobaling,0,17,6,11,0,0.545454545454545
sporon,0,6,2,4,0,0.5
cardialgic,1,10,4,6,0,0.666666666666667
labdacus,1,8,3,5,0,0.6
carminophenol,0,13,5,8,0,0.625
prestiophagy,0,12,4,8,0,0.5
uning,0,5,2,3,0,0.666666666666667
coutscracotidiosition,0,21,10,11,0,0.909090909090909
schillijers,0,11,3,8,0,0.375
rectoceles,1,10,4,6,0,0.666666666666667
dissimulate,1,11,5,6,0,0.833333333333333
cacophagy,0,9,3,6,0,0.5
underdoctor,1,11,4,7,0,0.571428571428571
zinjanthropi,1,12,4,8,0,0.5
disinclosed,1,11,4,7,0,0.571428571428571
sandflies,1,9,3,6,0,0.5
serogelatinous,1,14,7,7,0,1
cooperia,1,8,5,3,0,1.66666666666667
confirms,1,8,2,6,0,0.333333333333333
vologitally,0,11,4,7,0,0.571428571428571
depeyster,1,9,3,6,0,0.5
qhrme'znswryalharzyh,0,20,3,17,1,0.176470588235294
preperuses,0,10,4,6,0,0.666666666666667
alectoropodous,1,14,7,7,0,1
aggradational,1,13,6,7,0,0.857142857142857
undulator,1,9,4,5,0,0.8
colliform,1,9,3,6,0,0.5
hoolmannie,0,10,5,5,0,1
surton,0,6,2,4,0,0.5
rizzoredge,0,10,4,6,0,0.666666666666667
semiautomorphous,0,16,8,8,0,1
vjbh,0,4,0,4,0,0
shagbarks,1,9,2,7,0,0.285714285714286
distomous,0,9,4,5,0,0.8
vasospastic,1,11,4,7,0,0.571428571428571
creachering,0,11,4,7,0,0.571428571428571
pwmvjmczhboctdrouwadft,0,22,4,18,0,0.222222222222222
deucedly,1,8,3,5,0,0.6
osprghanemer,0,12,4,8,0,0.5
scotoma,1,7,3,4,0,0.75
bagman,1,6,2,4,0,0.5
ievmk'ioffdpszulncogg,0,21,6,15,1,0.4
blastospore,1,11,4,7,0,0.571428571428571
methyl,1,6,1,5,0,0.2
linty,1,5,1,4,0,0.25
horseiest,1,9,4,5,0,0.8
rheobases,1,9,4,5,0,0.8
parled,1,6,2,4,0,0.5
biteos,0,6,3,3,0,1
rompha,0,6,2,4,0,0.5
hkdsqkdiorkgtz,0,14,2,12,0,0.166666666666667
englishes,1,9,3,6,0,0.5
baridens,0,8,3,5,0,0.6
scythagous,0,10,3,7,0,0.428571428571429
splenoblast,1,11,3,8,0,0.375
simoisius,1,9,5,4,0,1.25
batsper,0,7,2,5,0,0.4
mesmerisation,1,13,6,7,0,0.857142857142857
dyzcgjkvmbg,0,11,0,11,0,0
choush,1,6,2,4,0,0.5
draglisticlympira,0,17,5,12,0,0.416666666666667
devoid,1,6,3,3,0,1
etian,0,5,3,2,0,1.5
crappet,0,7,2,5,0,0.4
denous,0,6,3,3,0,1
nerwism,0,7,2,5,0,0.4
opisthodomos,1,12,5,7,0,0.714285714285714
nonrestida,0,10,4,6,0,0.666666666666667
v'a'jzfzzcrlzkbhl,0,17,1,16,2,0.0625
butalma,0,7,3,4,0,0.75
coercival,0,9,4,5,0,0.8
impiarimanungrs,0,15,6,9,0,0.666666666666667
penmaster,1,9,3,6,0,0.5
martinelli,1,10,4,6,0,0.666666666666667
exosporium,1,10,5,5,0,1
emptoriness,0,11,4,7,0,0.571428571428571
cannonier,1,9,4,5,0,0.8
claustrophobic,1,14,5,9,0,0.555555555555556
fourning,0,8,3,5,0,0.6
calomaniaceae,0,13,8,5,0,1.6
aksemin,0,7,3,4,0,0.75
dowagiac,1,8,4,4,0,1
rehemming,1,9,3,6,0,0.5
plex,0,4,1,3,0,0.333333333333333
yhwaeqynbioabyupb'olh,0,21,7,14,1,0.5
jows,1,4,1,3,0,0.333333333333333
smoothness,1,10,3,7,0,0.428571428571429
swig,1,4,1,3,0,0.333333333333333
blltingha,0,9,2,7,0,0.285714285714286
cedarhurst,1,10,3,7,0,0.428571428571429
horodko,1,7,3,4,0,0.75
demimbering,0,11,4,7,0,0.571428571428571
riu'nvcncphsybklp,0,17,2,15,1,0.133333333333333
ini,0,3,2,1,0,2
kavya,1,5,2,3,0,0.666666666666667
unadjoined,1,10,5,5,0,1
subimoanthum,0,12,5,7,0,0.714285714285714
overgrade,1,9,4,5,0,0.8
redurguaimallimelnes,0,20,9,11,0,0.818181818181818
nobleness,1,9,3,6,0,0.5
immind,1,6,2,4,0,0.5
rallorviats,0,11,4,7,0,0.571428571428571
glasswort,1,9,2,7,0,0.285714285714286
borgeson,1,8,3,5,0,0.6
jugatae,1,7,4,3,0,1.33333333333333
sfnedjgcmosyhm'qij,0,18,3,15,1,0.2
scheler,1,7,2,5,0,0.4
polip,0,5,2,3,0,0.666666666666667
bifront,1,7,2,5,0,0.4
maile,1,5,3,2,0,1.5
alomintiemotizhola,0,18,9,9,0,1
obstructures,0,12,4,8,0,0.5
donamins,0,8,3,5,0,0.6
dusicyon,1,8,3,5,0,0.6
orphan,1,6,2,4,0,0.5
artexah,0,7,3,4,0,0.75
glandlike,1,9,3,6,0,0.5
qzmlpfgd'riyjdszqhtjtepno,0,25,3,22,1,0.136363636363636
satisfaction,1,12,5,7,0,0.714285714285714
passus,1,6,2,4,0,0.5
guessentrayush,0,14,5,9,0,0.555555555555556
echab,0,5,2,3,0,0.666666666666667
perpouceckew,0,12,5,7,0,0.714285714285714
massoy,1,6,2,4,0,0.5
anglicized,1,10,4,6,0,0.666666666666667
cyclinnwormia,0,13,4,9,0,0.444444444444444
bestseller,1,10,3,7,0,0.428571428571429
soap,1,4,2,2,0,1
gmxwtksszd'br,0,13,0,13,1,0
xylophils,0,9,2,7,0,0.285714285714286
wenona,1,6,3,3,0,1
damenacoid,0,10,5,5,0,1
vesalian,1,8,4,4,0,1
propaging,1,9,3,6,0,0.5
roughousewife,0,13,7,6,0,1.16666666666667
vahnkkfichhrpmwdhvpgw,0,21,2,19,0,0.105263157894737
nons,0,4,1,3,0,0.333333333333333
l'n,0,3,0,3,1,0
diglossac,0,9,3,6,0,0.5
naywaringumunwaris,0,18,7,11,0,0.636363636363636
entinwomo,0,9,4,5,0,0.8
carrosser,0,9,3,6,0,0.5
dakota,1,6,3,3,0,1
optologist,1,10,4,6,0,0.666666666666667
kukvxokwhhuno,0,13,4,9,0,0.444444444444444
justiceships,1,12,4,8,0,0.5
babbitics,0,9,3,6,0,0.5
nelumbo,1,7,3,4,0,0.75
sabadievillifluctuations,0,24,11,13,0,0.846153846153846
cohere,1,6,3,3,0,1
seationates,0,11,6,5,0,1.2
griddines,0,9,3,6,0,0.5
wpn'',0,5,0,5,2,0
larceners,1,9,3,6,0,0.5
packages,1,8,3,5,0,0.6
bacarposteady,0,13,5,8,0,0.625
admireies,0,9,5,4,0,1.25
snepracraast,0,12,4,8,0,0.5
pensione,1,8,4,4,0,1
harec,0,5,2,3,0,0.666666666666667
wctlyelbvrp,0,11,1,10,0,0.1
broguing,1,8,3,5,0,0.6
revanchism,1,10,3,7,0,0.428571428571429
whinang,0,7,2,5,0,0.4
sweatsuits,1,10,4,6,0,0.666666666666667
hatshepset,1,10,3,7,0,0.428571428571429
interbastate,1,12,5,7,0,0.714285714285714
roughness,1,9,3,6,0,0.5
dressiness,1,10,3,7,0,0.428571428571429
tactounpois,0,11,5,6,0,0.833333333333333
transmutual,1,11,4,7,0,0.571428571428571
tos,1,3,1,2,0,0.5
pulaturis,0,9,4,5,0,0.8
empatronizing,0,13,5,8,0,0.625
streptoneura,1,12,5,7,0,0.714285714285714
southard,1,8,3,5,0,0.6
oconomowoc,1,10,5,5,0,1
unsmokeable,1,11,5,6,0,0.833333333333333
ganodonta,1,9,4,5,0,0.8
bragg,1,5,1,4,0,0.25
quadringenary,1,13,5,8,0,0.625
scombroidea,1,11,5,6,0,0.833333333333333
saseno,1,6,3,3,0,1
vhckntnetr'zdad,0,15,2,13,1,0.153846153846154
claque,1,6,3,3,0,1
waft,1,4,1,3,0,0.333333333333333
strichosauridae,0,15,7,8,0,0.875
balon,1,5,2,3,0,0.666666666666667
rorschach,1,9,2,7,0,0.285714285714286
shawneetown,1,11,4,7,0,0.571428571428571
isabelli,0,8,4,4,0,1
katie,1,5,3,2,0,1.5
elanurement,0,11,5,6,0,0.833333333333333
ungenesis,0,9,4,5,0,0.8
polarises,1,9,4,5,0,0.8
dickhead,1,8,3,5,0,0.6
truncatorotund,1,14,5,9,0,0.555555555555556
inclinically,0,12,4,8,0,0.5
anhydrosis,1,10,3,7,0,0.428571428571429
ferongyldrynrklens,0,18,3,15,0,0.2
nonproportionate,1,16,7,9,0,0.777777777777778
prelatical,1,10,4,6,0,0.666666666666667
mavournin,1,9,4,5,0,0.8
acade,0,5,3,2,0,1.5
papercutient,0,12,5,7,0,0.714285714285714
rjt'xocbvphpt,0,13,1,12,1,0.0833333333333333
semipluminist,0,13,5,8,0,0.625
toplaustomechbinded,0,19,7,12,0,0.583333333333333
ple,0,3,1,2,0,0.5
accessitudes,0,12,5,7,0,0.714285714285714
countrywomen,1,12,4,8,0,0.5
machs,1,5,1,4,0,0.25
pyrogeneses,0,11,4,7,0,0.571428571428571
tittles,1,7,2,5,0,0.4
cian,0,4,2,2,0,1
lennings,0,8,2,6,0,0.333333333333333
intercorrelated,1,15,6,9,0,0.666666666666667
sphygmic,1,8,1,7,0,0.142857142857143
patiluda,0,8,4,4,0,1
mastically,0,10,3,7,0,0.428571428571429
ittacetters,0,11,4,7,0,0.571428571428571
testand,0,7,2,5,0,0.4
holuenthersed,0,13,5,8,0,0.625
hatchonsiders,0,13,4,9,0,0.444444444444444
'bym,0,4,0,4,1,0
omphacy,1,7,2,5,0,0.4
roundeleer,1,10,5,5,0,1
glutinosity,1,11,4,7,0,0.571428571428571
catholicisations,1,16,7,9,0,0.777777777777778
trissartney,0,11,3,8,0,0.375
islandic,1,8,3,5,0,0.6
tgdlvissmvobez,0,14,3,11,0,0.272727272727273
superabsorbent,1,14,5,9,0,0.555555555555556
irimdxunzy,0,10,3,7,0,0.428571428571429
reconverted,1,11,4,7,0,0.571428571428571
eupurvis,0,8,4,4,0,1
fegbqztxiebdaeuir'fpz,0,21,7,14,1,0.5
acreodonisers,0,13,6,7,0,0.857142857142857
emulsopticulabropet,0,19,8,11,0,0.727272727272727
petrpolitic,0,11,4,7,0,0.571428571428571
lexologic,0,9,4,5,0,0.8
dishability,0,11,4,7,0,0.571428571428571
aenneea,1,7,5,2,0,2.5
playwoman,1,9,3,6,0,0.5
trillionth,1,10,3,7,0,0.428571428571429
artifactually,1,13,5,8,0,0.625
homotore,0,8,4,4,0,1
cornwell,1,8,2,6,0,0.333333333333333
contrifugalled,0,14,5,9,0,0.555555555555556
hrdrtiqbx'jx,0,12,1,11,1,0.0909090909090909
radioresigness,0,14,6,8,0,0.75
ovie,0,4,3,1,0,3
unbenevolentness,1,16,6,10,0,0.6
iuvhsrrdcw,0,10,2,8,0,0.25
zerla,1,5,2,3,0,0.666666666666667
subcultun,0,9,3,6,0,0.5
phatemeromuss,0,13,5,8,0,0.625
coracovertebral,1,15,6,9,0,0.666666666666667
strophyton,0,10,2,8,0,0.25
partonshipmast,0,14,4,10,0,0.4
mbitys,0,6,1,5,0,0.2
aqxmhuhzxqt,0,11,2,9,0,0.222222222222222
inboly,0,6,2,4,0,0.5
porno,1,5,2,3,0,0.666666666666667
bisulfite,1,9,4,5,0,0.8
nullificationist,1,16,7,9,0,0.777777777777778
fujfqxuemtbscyzpiuwt,0,20,5,15,0,0.333333333333333
bespeaks,1,8,3,5,0,0.6
heligmus,1,8,3,5,0,0.6
hcaqslr,0,7,1,6,0,0.166666666666667
prefabricant,0,12,4,8,0,0.5
ijftzcyiy'qxlvvgb,0,17,2,15,1,0.133333333333333
roops,1,5,2,3,0,0.666666666666667
monegasque,1,10,5,5,0,1
spdoxnpc,0,8,1,7,0,0.142857142857143
jalevelulos,0,11,5,6,0,0.833333333333333
nordicize,1,9,4,5,0,0.8
parnites,0,8,3,5,0,0.6
ndcc,1,4,0,4,0,0
xiphopaguses,1,12,5,7,0,0.714285714285714
corteise,1,8,4,4,0,1
esticonkmed,0,11,4,7,0,0.571428571428571
acrobative,0,10,5,5,0,1
leatherist,0,10,4,6,0,0.666666666666667
brenistle,0,9,3,6,0,0.5
autistically,1,12,5,7,0,0.714285714285714
tartraviated,0,12,5,7,0,0.714285714285714
unbureaucratic,1,14,7,7,0,1
triunity,1,8,3,5,0,0.6
austrians,1,9,4,5,0,0.8
welshism,1,8,2,6,0,0.333333333333333
valternardo,0,11,4,7,0,0.571428571428571
pyrolater,1,9,3,6,0,0.5
cdqxnqelzivbcpgcow,0,18,3,15,0,0.2
podothecium,0,11,5,6,0,0.833333333333333
disparation,1,11,5,6,0,0.833333333333333
slangulpy,0,9,2,7,0,0.285714285714286
nonmembers,1,10,3,7,0,0.428571428571429
temacronnipica,0,14,6,8,0,0.75
blangle,0,7,2,5,0,0.4
petees,0,6,3,3,0,1
smudged,1,7,2,5,0,0.4
htjcakalqk,0,10,2,8,0,0.25
earpicks,1,8,3,5,0,0.6
thermotaxic,1,11,4,7,0,0.571428571428571
saphenosphere,0,13,5,8,0,0.625
borte,0,5,2,3,0,0.666666666666667
mentrabillu,0,11,4,7,0,0.571428571428571
zmeyfcvovcbpsjuz,0,16,3,13,0,0.230769230769231
onstad,1,6,2,4,0,0.5
demythomatoscopes,0,17,6,11,0,0.545454545454545
amoebida,1,8,5,3,0,1.66666666666667
dataset,1,7,3,4,0,0.75
centaur,1,7,3,4,0,0.75
reshave,1,7,3,4,0,0.75
homismeto,0,9,4,5,0,0.8
radiodermatitis,1,15,7,8,0,0.875
cropduster,1,10,3,7,0,0.428571428571429
phujha,0,6,2,4,0,0.5
nonpublication,1,14,6,8,0,0.75
becquerel,1,9,4,5,0,0.8
hygedroush,0,10,3,7,0,0.428571428571429
hygromateri,0,11,4,7,0,0.571428571428571
illegible,1,9,4,5,0,0.8
extraterritorialness,0,20,8,12,0,0.666666666666667
visnes,1,6,2,4,0,0.5
guaneide,1,8,5,3,0,1.66666666666667
subjenne,0,8,3,5,0,0.6
subter,0,6,2,4,0,0.5
cobocougbtro,0,12,5,7,0,0.714285714285714
vasopressins,1,12,4,8,0,0.5
extranormalities,0,16,7,9,0,0.777777777777778
macushla,1,8,3,5,0,0.6
franinated,0,10,4,6,0,0.666666666666667
carcharodont,1,12,4,8,0,0.5
electorial,1,10,5,5,0,1
unmea,0,5,3,2,0,1.5
dicrous,0,7,3,4,0,0.75
affirmative,1,11,5,6,0,0.833333333333333
uniriders,0,9,4,5,0,0.8
overrefines,1,11,5,6,0,0.833333333333333
synodalist,1,10,3,7,0,0.428571428571429
unmolency,0,9,3,6,0,0.5
trayscrabsorptional,0,19,6,13,0,0.461538461538462
gimhrilgbpohlzcrpxrotkdojuub,0,28,7,21,0,0.333333333333333
momos,1,5,2,3,0,0.666666666666667
deceive,0,7,4,3,0,1.33333333333333
conidia,1,7,4,3,0,1.33333333333333
impuiser,0,8,4,4,0,1
boastualian,0,11,6,5,0,1.2
comanes,0,7,3,4,0,0.75
wherefore,1,9,4,5,0,0.8
jorgenstations,0,14,5,9,0,0.555555555555556
blancanus,1,9,3,6,0,0.5
tracheotome,1,11,5,6,0,0.833333333333333
zygodactylous,1,13,4,9,0,0.444444444444444
doxographically,0,15,5,10,0,0.5
ichochrah,0,9,3,6,0,0.5
gyliompogia,0,11,5,6,0,0.833333333333333
sentifred,0,9,3,6,0,0.5
catalysts,1,9,2,7,0,0.285714285714286
dynastering,0,11,3,8,0,0.375
tapermaker,1,10,4,6,0,0.666666666666667
schizogregarinida,1,17,7,10,0,0.7
upgathered,1,10,4,6,0,0.666666666666667
rfdzkiw,0,7,1,6,0,0.166666666666667
nonstyptical,1,12,3,9,0,0.333333333333333
pardiac,0,7,3,4,0,0.75
superiostegidae,0,15,8,7,0,1.14285714285714
chevron,1,7,2,5,0,0.4
anthimpist,0,10,3,7,0,0.428571428571429
quitemoca,1,9,5,4,0,1.25
triarchall,0,10,3,7,0,0.428571428571429
evanetim,0,8,4,4,0,1
termitaries,1,11,5,6,0,0.833333333333333
auxoblast,1,9,4,5,0,0.8
domatia,1,7,4,3,0,1.33333333333333
wigranse,0,8,3,5,0,0.6
daleloufryoppaste,0,17,7,10,0,0.7
territuals,0,10,4,6,0,0.666666666666667
ris,0,3,1,2,0,0.5
xgiceliq''ylobx,0,15,4,11,2,0.363636363636364
crampbit,1,8,2,6,0,0.333333333333333
verile,1,6,3,3,0,1
entonemertea,0,12,6,6,0,1
taxialities,0,11,6,5,0,1.2
mullo,0,5,2,3,0,0.666666666666667
hexcumplarte,0,12,4,8,0,0.5
chaiken,1,7,3,4,0,0.75
tcrzknipzmavtgsyakclp,0,21,3,18,0,0.166666666666667
filations,0,9,4,5,0,0.8
understiculation,0,16,7,9,0,0.777777777777778
hyporrhagia,0,11,4,7,0,0.571428571428571
injectibility,0,13,5,8,0,0.625
gerhan,1,6,2,4,0,0.5
gy'kmvysodxruobjbucaimsgyqg,0,27,6,21,1,0.285714285714286
myxopod,1,7,2,5,0,0.4
chorioallantoid,1,15,7,8,0,0.875
snugation,0,9,4,5,0,0.8
anaxarete,1,9,5,4,0,1.25
simplier,0,8,3,5,0,0.6
substored,0,9,3,6,0,0.5
ketosteroid,1,11,5,6,0,0.833333333333333
tniswoamu,0,9,4,5,0,0.8
unhydrated,1,10,3,7,0,0.428571428571429
schizing,0,8,2,6,0,0.333333333333333
vallery,1,7,2,5,0,0.4
ranga,0,5,2,3,0,0.666666666666667
eudism,0,6,3,3,0,1
oxen,1,4,2,2,0,1
mayoralty,1,9,3,6,0,0.5
ungrd,0,5,1,4,0,0.25
naevus,1,6,3,3,0,1
oeseltingize,0,12,6,6,0,1
molested,1,8,3,5,0,0.6
excusively,1,10,4,6,0,0.666666666666667
schrund,1,7,1,6,0,0.166666666666667
sibbendy,1,8,2,6,0,0.333333333333333
giuki,1,5,3,2,0,1.5
shittle,0,7,2,5,0,0.4
gundrove,0,8,3,5,0,0.6
recombatant,0,11,4,7,0,0.571428571428571
cypriatively,0,12,4,8,0,0.5
drummy,1,6,1,5,0,0.2
thalum,0,6,2,4,0,0.5
sablenetbalastitessborfurt,0,26,9,17,0,0.529411764705882
trimagin,0,8,3,5,0,0.6
nonseasonable,1,13,6,7,0,0.857142857142857
parcompartists,0,14,4,10,0,0.4
emmensittye,0,11,4,7,0,0.571428571428571
acequiaxed,0,10,6,4,0,1.5
kaffing,0,7,2,5,0,0.4
cippes,0,6,2,4,0,0.5
a'miahf,0,7,3,4,1,0.75
triturated,1,10,4,6,0,0.666666666666667
uilijmswtw'ocda,0,15,5,10,1,0.5
tqqydtxhtfebhze,0,15,2,13,0,0.153846153846154
deadwort,1,8,3,5,0,0.6
extirpative,1,11,5,6,0,0.833333333333333
annalist,1,8,3,5,0,0.6
peld,0,4,1,3,0,0.333333333333333
bejesuiting,1,11,5,6,0,0.833333333333333
absolutisms,1,11,4,7,0,0.571428571428571
disunionisms,1,12,5,7,0,0.714285714285714
joekins,0,7,3,4,0,0.75
ichaly,0,6,2,4,0,0.5
tula,1,4,2,2,0,1
unguliform,0,10,4,6,0,0.666666666666667
solick,0,6,2,4,0,0.5
unhazarded,1,10,4,6,0,0.666666666666667
resor,1,5,2,3,0,0.666666666666667
festyna,0,7,2,5,0,0.4
latyve,0,6,2,4,0,0.5
disarconget,0,11,4,7,0,0.571428571428571
maress,0,6,2,4,0,0.5
monksofermarmantlends,0,21,6,15,0,0.4
for,1,3,1,2,0,0.5
attentively,1,11,4,7,0,0.571428571428571
ancaliderf,0,10,4,6,0,0.666666666666667
sturativelli,0,12,5,7,0,0.714285714285714
rattlebrain,1,11,4,7,0,0.571428571428571
micyle,0,6,2,4,0,0.5
paraguayan,1,10,5,5,0,1
louriest,1,8,4,4,0,1
valerle,1,7,3,4,0,0.75
nyceocumeridasms,0,16,6,10,0,0.6
multibulaten,0,12,5,7,0,0.714285714285714
paraspheric,0,11,4,7,0,0.571428571428571
multipole,1,9,4,5,0,0.8
psychodidae,1,11,4,7,0,0.571428571428571
illimitation,1,12,6,6,0,1
chagensathes,0,12,4,8,0,0.5
preascenceably,0,14,5,9,0,0.555555555555556
allys,1,5,1,4,0,0.25
mandally,0,8,2,6,0,0.333333333333333
jfc'c,0,5,0,5,1,0
divisibility,1,12,5,7,0,0.714285714285714
plumous,1,7,3,4,0,0.75
hexokinase,1,10,5,5,0,1
hospitium,1,9,4,5,0,0.8
florulent,1,9,3,6,0,0.5
innullsburg,0,11,3,8,0,0.375
seeding,1,7,3,4,0,0.75
babbism,0,7,2,5,0,0.4
ock,0,3,1,2,0,0.5
theurgis,0,8,3,5,0,0.6
suberinize,1,10,5,5,0,1
rionsburgenoholammeroddellymnum,0,31,11,20,0,0.55
bibliopeithognosauria,0,21,11,10,0,1.1
hypocarpic,0,10,3,7,0,0.428571428571429
hietorebasives,0,14,7,7,0,1
gabun,1,5,2,3,0,0.666666666666667
mobproof,1,8,3,5,0,0.6
byplay,1,6,1,5,0,0.2
battlewagons,1,12,4,8,0,0.5
maques,0,6,3,3,0,1
maglemose,1,9,4,5,0,0.8
slabbery,1,8,2,6,0,0.333333333333333
vzsluwmhnzkifennlursgvb'pg,0,26,4,22,1,0.181818181818182
archidologist,0,13,5,8,0,0.625
rivet,1,5,2,3,0,0.666666666666667
broadax,1,7,3,4,0,0.75
concrease,0,9,4,5,0,0.8
cascadine,0,9,4,5,0,0.8
hiestandardbred,0,15,5,10,0,0.5
furrow,1,6,2,4,0,0.5
still,1,5,1,4,0,0.25
femtometre,1,10,4,6,0,0.666666666666667
bedworth,1,8,2,6,0,0.333333333333333
uvhgafbkgfrwxjqyucgq,0,20,3,17,0,0.176470588235294
glueprincumbentomethylglutings,0,30,9,21,0,0.428571428571429
cicornly,0,8,2,6,0,0.333333333333333
arthron,1,7,2,5,0,0.4
destructibly,0,12,3,9,0,0.333333333333333
pizzed,0,6,2,4,0,0.5
mistriatchrosativarco,0,21,8,13,0,0.615384615384615
whipstalk,1,9,2,7,0,0.285714285714286
garageable,1,10,5,5,0,1
membhismmmiorourophorinceexygacrpsiutyiasiforincy,0,49,19,30,0,0.633333333333333
destinative,0,11,5,6,0,0.833333333333333
pogit,0,5,2,3,0,0.666666666666667
tarrationpers,0,13,5,8,0,0.625
feijoada,1,8,5,3,0,1.66666666666667
expurgators,1,11,4,7,0,0.571428571428571
pollable,1,8,3,5,0,0.6
hayrack,1,7,2,5,0,0.4
halsed,1,6,2,4,0,0.5
bromothymol,1,11,3,8,0,0.375
sylvie,1,6,2,4,0,0.5
siricid,1,7,3,4,0,0.75
auxanogram,1,10,5,5,0,1
khedivates,1,10,4,6,0,0.666666666666667
navasota,1,8,4,4,0,1
tapolyting,0,10,3,7,0,0.428571428571429
beitris,1,7,3,4,0,0.75
insignifier,0,11,5,6,0,0.833333333333333
villanelle,1,10,4,6,0,0.666666666666667
rhizon,0,6,2,4,0,0.5
cel,0,3,1,2,0,0.5
talker,1,6,2,4,0,0.5
fraction,1,8,3,5,0,0.6
resistibleness,0,14,5,9,0,0.555555555555556
o'gghxpmt'mff'ydobqdxqo,0,23,3,20,3,0.15
block,1,5,1,4,0,0.25
misreprognaturability,0,21,8,13,0,0.615384615384615
overhostility,1,13,5,8,0,0.625
unevitably,1,10,4,6,0,0.666666666666667
callions,0,8,3,5,0,0.6
pronk,1,5,1,4,0,0.25
reservationist,1,14,6,8,0,0.75
aeromaean,0,9,6,3,0,2
seroanaphylaxis,1,15,6,9,0,0.666666666666667
dunsteirtophonical,0,18,7,11,0,0.636363636363636
eurs,0,4,2,2,0,1
ykao'dlgcd,0,10,2,8,1,0.25
nurljdwgsrgnd,0,13,1,12,0,0.0833333333333333
ning,0,4,1,3,0,0.333333333333333
calycentiators,0,14,5,9,0,0.555555555555556
firmans,1,7,2,5,0,0.4
isimud,1,6,3,3,0,1
brio,1,4,2,2,0,1
nonsummons,1,10,3,7,0,0.428571428571429
uzqqqnckwdorvyetlhoy'jz,0,23,4,19,1,0.210526315789474
marchd,0,6,1,5,0,0.2
chromatists,1,11,3,8,0,0.375
chaun,0,5,2,3,0,0.666666666666667
scolparagula,0,12,5,7,0,0.714285714285714
lynch,1,5,0,5,0,0
imbecilite,0,10,5,5,0,1
nosome,0,6,3,3,0,1
mesogloea,1,9,5,4,0,1.25
rhene,1,5,2,3,0,0.666666666666667
ohineum,0,7,4,3,0,1.33333333333333
phlegmatypy,0,11,2,9,0,0.222222222222222
stockyard,1,9,2,7,0,0.285714285714286
chesnut,1,7,2,5,0,0.4
chiasmatic,1,10,4,6,0,0.666666666666667
fleckers,1,8,2,6,0,0.333333333333333
ushy,0,4,1,3,0,0.333333333333333
heminal,0,7,3,4,0,0.75
rubashelwe,0,10,4,6,0,0.666666666666667
suchier,0,7,3,4,0,0.75
earhenguns,0,10,4,6,0,0.666666666666667
subocasuscal,0,12,5,7,0,0.714285714285714
gramedy,0,7,2,5,0,0.4
goverscarvel,0,12,4,8,0,0.5
cercis,1,6,2,4,0,0.5
superstructressed,0,17,5,12,0,0.416666666666667
enculture,0,9,4,5,0,0.8
nilometric,1,10,4,6,0,0.666666666666667
counterpleural,0,14,6,8,0,0.75
mellitons,0,9,3,6,0,0.5
thredgwunt,0,10,2,8,0,0.25
tastekin,1,8,3,5,0,0.6
aswires,0,7,3,4,0,0.75
'wrockjkirkw,0,12,2,10,1,0.2
dilled,1,6,2,4,0,0.5
adrenolytic,1,11,4,7,0,0.571428571428571
cajwadodon,0,10,4,6,0,0.666666666666667
jawcrusher,1,10,3,7,0,0.428571428571429
nti,0,3,1,2,0,0.5
heucheras,1,9,4,5,0,0.8
ovariocyesis,1,12,6,6,0,1
abanga,1,6,3,3,0,1
throphoty,0,9,2,7,0,0.285714285714286
fennelly,1,8,2,6,0,0.333333333333333
muppet,1,6,2,4,0,0.5
sheatherodiaster,0,16,7,9,0,0.777777777777778
mareld,1,6,2,4,0,0.5
dodlet,1,6,2,4,0,0.5
gagastrochotory,0,15,5,10,0,0.5
overcommits,1,11,4,7,0,0.571428571428571
implacablenesses,1,16,6,10,0,0.6
turpitude,1,9,4,5,0,0.8
pileolus,0,8,4,4,0,1
pabarensoltawobry,0,17,6,11,0,0.545454545454545
chimakua,0,8,4,4,0,1
engarment,1,9,3,6,0,0.5
jyvwvyqktkrto'cio,0,17,3,14,1,0.214285714285714
bonediak,0,8,4,4,0,1
shinuting,0,9,3,6,0,0.5
lodesman,1,8,3,5,0,0.6
imaur,0,5,3,2,0,1.5
ggpdhgfwstfjl,0,13,0,13,0,0
nxibddh'dos,0,11,2,9,1,0.222222222222222
divergence,1,10,4,6,0,0.666666666666667
kjuliaminishness,0,16,6,10,0,0.6
llvspjg'icyoyjsqjdcfeaakcq,0,26,5,21,1,0.238095238095238
apokatastasis,1,13,6,7,0,0.857142857142857
biallyl,1,7,2,5,0,0.4
unexculpably,1,12,4,8,0,0.5
supercriminant,0,14,5,9,0,0.555555555555556
reightileness,0,13,5,8,0,0.625
fumez,0,5,2,3,0,0.666666666666667
moding,0,6,2,4,0,0.5
snouistenexcer,0,14,6,8,0,0.75
mountaineering,1,14,7,7,0,1
clambe,0,6,2,4,0,0.5
ulas,0,4,2,2,0,1
hyperconsciousness,1,18,6,12,0,0.5
stagflation,1,11,4,7,0,0.571428571428571
temporofrontal,1,14,5,9,0,0.555555555555556
bryn,1,4,0,4,0,0
greenskeepers,1,13,5,8,0,0.625
tinmnqerhtrdadhojoniqknte'k,0,27,7,20,1,0.35
nkgxalpxxty,0,11,1,10,0,0.1
aschelminthes,1,13,4,9,0,0.444444444444444
uninsulating,1,12,5,7,0,0.714285714285714
harportedly,0,11,3,8,0,0.375
gonealectrobiosynthium,0,22,9,13,0,0.692307692307692
kneeler,1,7,3,4,0,0.75
hyposarca,1,9,3,6,0,0.5
republicable,0,12,5,7,0,0.714285714285714
parama,0,6,3,3,0,1
nocea,0,5,3,2,0,1.5
millechimic,0,11,4,7,0,0.571428571428571
dhaleridiomiotrkbati,0,20,9,11,0,0.818181818181818
hussy,1,5,1,4,0,0.25
uncersh,0,7,2,5,0,0.4
pleaseptualisedness,0,19,8,11,0,0.727272727272727
anguiss,0,7,3,4,0,0.75
elocutionist,1,12,6,6,0,1
bushrangs,0,9,2,7,0,0.285714285714286
visconti,1,8,3,5,0,0.6
conferva,1,8,3,5,0,0.6
syndactylic,1,11,2,9,0,0.222222222222222
nitrimerates,0,12,5,7,0,0.714285714285714
cleistos,0,8,3,5,0,0.6
chiegenaniania,0,14,8,6,0,1.33333333333333
decolorimer,0,11,5,6,0,0.833333333333333
ballsenterovilleur,0,18,7,11,0,0.636363636363636
'a'vauzwif,0,10,4,6,2,0.666666666666667
lumidophycernvirt,0,17,5,12,0,0.416666666666667
utughementhr,0,12,4,8,0,0.5
pesade,1,6,3,3,0,1
polystictus,1,11,3,8,0,0.375
wock,1,4,1,3,0,0.333333333333333
impetrator,1,10,4,6,0,0.666666666666667
ddonozzan,0,9,3,6,0,0.5
porulent,0,8,3,5,0,0.6
uund,1,4,2,2,0,1
bpxptbg,0,7,0,7,0,0
unmissed,1,8,3,5,0,0.6
nazymoricisatacarboscea,0,23,10,13,0,0.769230769230769
phntinoubelima,0,14,6,8,0,0.75
disputist,0,9,3,6,0,0.5
doork,0,5,2,3,0,0.666666666666667
progymnasium,1,12,4,8,0,0.5
lamrouex,1,8,4,4,0,1
mzcwwgxajdszm,0,13,1,12,0,0.0833333333333333
photoautotroph,1,14,6,8,0,0.75
unthiondlgnapradlumatonaloopheterearaninttis,0,44,18,26,0,0.692307692307692
cryphote,0,8,2,6,0,0.333333333333333
holobioncouconed,0,16,8,8,0,1
spassky,1,7,1,6,0,0.166666666666667
chainwork,1,9,3,6,0,0.5
amesaces,1,8,4,4,0,1
stricons,0,8,2,6,0,0.333333333333333
summersetted,1,12,4,8,0,0.5
disimprovement,1,14,5,9,0,0.555555555555556
pegboard,1,8,3,5,0,0.6
peekapoos,1,9,5,4,0,1.25
macrotherioid,1,13,6,7,0,0.857142857142857
inglaementalocytiversoleds,0,26,10,16,0,0.625
lezconpsaov'gkkgcc,0,18,4,14,1,0.285714285714286
jointuress,1,10,4,6,0,0.666666666666667
derogatorinesses,1,16,7,9,0,0.777777777777778
snakelet,1,8,3,5,0,0.6
supercarbureters,0,16,6,10,0,0.6
continener,0,10,4,6,0,0.666666666666667
effelatukergatl,0,15,6,9,0,0.666666666666667
sakoviality,0,11,5,6,0,0.833333333333333
pationthoesolike,0,16,8,8,0,1
nonsolidifying,1,14,5,9,0,0.555555555555556
bodies,1,6,3,3,0,1
unfriendship,1,12,4,8,0,0.5
quartermistresses,1,17,6,11,0,0.545454545454545
omnigenous,1,10,5,5,0,1
weat,0,4,2,2,0,1
msmqxmcrosmp'z,0,14,1,13,1,0.0769230769230769
foreuse,1,7,4,3,0,1.33333333333333
unackhus,0,8,3,5,0,0.6
fructuarius,1,11,5,6,0,0.833333333333333
discretinae,0,11,5,6,0,0.833333333333333
glugs,1,5,1,4,0,0.25
counterraids,1,12,5,7,0,0.714285714285714
returnlessly,1,12,3,9,0,0.333333333333333
zkfskcqtusnsujz,0,15,2,13,0,0.153846153846154
glucayan,0,8,3,5,0,0.6
morphologic,1,11,4,7,0,0.571428571428571
rondelier,1,9,4,5,0,0.8
harrhophylvats,0,14,3,11,0,0.272727272727273
carbamine,1,9,4,5,0,0.8
pyrenocorticelloid,0,18,7,11,0,0.636363636363636
hydroferricyanide,0,17,6,11,0,0.545454545454545
carbines,1,8,3,5,0,0.6
ckeivelicactis,0,14,6,8,0,0.75
senecal,1,7,3,4,0,0.75
daffydowndillies,0,16,5,11,0,0.454545454545455
asphalt,1,7,2,5,0,0.4
erie,1,4,3,1,0,3
coflakynemeatowarinonilaninsis,0,30,13,17,0,0.764705882352941
dementing,1,9,3,6,0,0.5
protoconcavengest,0,17,6,11,0,0.545454545454545
spreaghery,1,10,3,7,0,0.428571428571429
paba,1,4,2,2,0,1
trophe,0,6,2,4,0,0.5
persecutive,1,11,5,6,0,0.833333333333333
peloton,1,7,3,4,0,0.75
boars,1,5,2,3,0,0.666666666666667
ecammidae,0,9,5,4,0,1.25
sporangiform,1,12,4,8,0,0.5
byland,1,6,1,5,0,0.2
panticonogen,0,12,5,7,0,0.714285714285714
giater,0,6,3,3,0,1
bullshot,1,8,2,6,0,0.333333333333333
granollership,0,13,4,9,0,0.444444444444444
avestan,1,7,3,4,0,0.75
exochlegs,0,9,3,6,0,0.5
hpty,0,4,0,4,0,0
roadside,1,8,4,4,0,1
calogy,0,6,2,4,0,0.5
platycephalograph,0,17,5,12,0,0.416666666666667
macrorheometry,0,14,5,9,0,0.555555555555556
anvilled,1,8,3,5,0,0.6
jayem,1,5,2,3,0,0.666666666666667
ramine,0,6,3,3,0,1
mailburhynchy,0,13,3,10,0,0.3
befoamingly,0,11,4,7,0,0.571428571428571
masochisms,1,10,3,7,0,0.428571428571429
shf,1,3,0,3,0,0
tenewaregats,0,12,5,7,0,0.714285714285714
postfoetal,1,10,4,6,0,0.666666666666667
cetefle,0,7,3,4,0,0.75
anaesthesia,1,11,6,5,0,1.2
heddeja,0,7,3,4,0,0.75
tellioscery,0,11,4,7,0,0.571428571428571
baaft,0,5,2,3,0,0.666666666666667
eberewavurerteuvaecoalyseros,0,28,14,14,0,1
textuaries,1,10,5,5,0,1
titillated,1,10,4,6,0,0.666666666666667
botikpstidelmmeas,0,17,6,11,0,0.545454545454545
ascii,1,5,3,2,0,1.5
bernardine,1,10,4,6,0,0.666666666666667
hipberry,1,8,2,6,0,0.333333333333333
circaeaceae,1,11,7,4,0,1.75
gasbag,1,6,2,4,0,0.5
embrutening,0,11,4,7,0,0.571428571428571
gackvfdmqjzpzvj,0,15,1,14,0,0.0714285714285714
izxacvtdrdkei,0,13,4,9,0,0.444444444444444
caragadzonism,0,13,5,8,0,0.625
fawnerallumine,0,14,6,8,0,0.75
maximo,1,6,3,3,0,1
distillment,1,11,3,8,0,0.375
deurotocology,0,13,6,7,0,0.857142857142857
playbills,1,9,2,7,0,0.285714285714286
unsaids,0,7,3,4,0,0.75
latowt,0,6,2,4,0,0.5
seball,0,6,2,4,0,0.5
athalodimerger,0,14,6,8,0,0.75
headcastigophyllophagi,0,22,8,14,0,0.571428571428571
jwznn'xfvvldybjir,0,17,1,16,1,0.0625
schoolmoschemic,0,15,5,10,0,0.5
christianopagandist,0,19,7,12,0,0.583333333333333
tkhvykarmcmetkoxp',0,18,3,15,1,0.2
glossolalists,1,13,4,9,0,0.444444444444444
mutase,1,6,3,3,0,1
melism,0,6,2,4,0,0.5
cardom,0,6,2,4,0,0.5
nonconcurrent,1,13,4,9,0,0.444444444444444
unkneaded,1,9,4,5,0,0.8
optimiser,1,9,4,5,0,0.8
mulbarfondo,0,11,4,7,0,0.571428571428571
kinsman,1,7,2,5,0,0.4
donhercravoldecingobaryike,0,26,10,16,0,0.625
belletristically,0,16,5,11,0,0.454545454545455
ramism,1,6,2,4,0,0.5
unthick,1,7,2,5,0,0.4
pysegonarvinttrata,0,18,6,12,0,0.5
dize,0,4,2,2,0,1
sherbert,1,8,2,6,0,0.333333333333333
adezwn,0,6,2,4,0,0.5
proceduring,1,11,4,7,0,0.571428571428571
cixtbkjuiv'lnxjopoqfyt',0,23,5,18,2,0.277777777777778
savorly,0,7,2,5,0,0.4
seyler,1,6,2,4,0,0.5
studinae,0,8,4,4,0,1
sonk,1,4,1,3,0,0.333333333333333
cornea,1,6,3,3,0,1
snowmobilists,1,13,4,9,0,0.444444444444444
pronohanut,0,10,4,6,0,0.666666666666667
eremia,0,6,4,2,0,2
utqrdrncyarca,0,13,3,10,0,0.3
chaselessness,0,13,4,9,0,0.444444444444444
debasic,0,7,3,4,0,0.75
wiouseaca,0,9,6,3,0,2
woszquusoyhteb'vty,0,18,5,13,1,0.384615384615385
nonoccultatoria,0,15,7,8,0,0.875
suturally,1,9,3,6,0,0.5
maccabaws,1,9,3,6,0,0.5
eburine,1,7,4,3,0,1.33333333333333
'roubjuo'fdsux,0,14,5,9,2,0.555555555555556
niuvbmymqe,0,10,3,7,0,0.428571428571429
pseudodiphtheritises,0,20,8,12,0,0.666666666666667
martias,0,7,3,4,0,0.75
snowbell,1,8,2,6,0,0.333333333333333
periacinous,1,11,6,5,0,1.2
unpictured,1,10,4,6,0,0.666666666666667
ustesimbichom,0,13,5,8,0,0.625
ytkxfrpijthyac,0,14,2,12,0,0.166666666666667
uncontralistituliparoecoins,0,27,12,15,0,0.8
surome,0,6,3,3,0,1
gabune,0,6,3,3,0,1
whousnenchile,0,13,5,8,0,0.625
hairweavers,1,11,5,6,0,0.833333333333333
americ,0,6,3,3,0,1
halamdiggeranning,0,17,6,11,0,0.545454545454545
aden,1,4,2,2,0,1
subconcealed,1,12,5,7,0,0.714285714285714
blepharoptosis,1,14,5,9,0,0.555555555555556
pugmarks,1,8,2,6,0,0.333333333333333
podanger,1,8,3,5,0,0.6
malle,0,5,2,3,0,0.666666666666667
rhiniat,0,7,3,4,0,0.75
ambittering,0,11,4,7,0,0.571428571428571
guenna,1,6,3,3,0,1
lietoypqyzxuozcjnexr,0,20,6,14,0,0.428571428571429
puman,0,5,2,3,0,0.666666666666667
boltcutter,1,10,3,7,0,0.428571428571429
ruffs,1,5,1,4,0,0.25
malvern,1,7,2,5,0,0.4
electroneutralism,0,17,7,10,0,0.7
anaesthesias,1,12,6,6,0,1
baastan,1,7,3,4,0,0.75
swerwinomyrapter,0,16,5,11,0,0.454545454545455
gesanamis,0,9,4,5,0,0.8
tega,1,4,2,2,0,1
idelem,0,6,3,3,0,1
mcgrody,1,7,1,6,0,0.166666666666667
overadjustment,1,14,5,9,0,0.555555555555556
ubianedxgv,0,10,4,6,0,0.666666666666667
tastic,0,6,2,4,0,0.5
moia,1,4,3,1,0,3
unwily,1,6,2,4,0,0.5
blubbering,1,10,3,7,0,0.428571428571429
pexitictenmptaeibewad,0,21,9,12,0,0.75
emulsification,1,14,7,7,0,1
unsimulate,0,10,5,5,0,1
thoom,1,5,2,3,0,0.666666666666667
nist,0,4,1,3,0,0.333333333333333
vermifugous,1,11,5,6,0,0.833333333333333
laminectomies,1,13,6,7,0,0.857142857142857
rndncynwnz'znm,0,14,0,14,1,0
resses,0,6,2,4,0,0.5
shri,1,4,1,3,0,0.333333333333333
jinny,1,5,1,4,0,0.25
enviolabilids,0,13,6,7,0,0.857142857142857
garm,1,4,1,3,0,0.333333333333333
revenued,1,8,4,4,0,1
billabongs,1,10,3,7,0,0.428571428571429
acand,0,5,2,3,0,0.666666666666667
lugwort,0,7,2,5,0,0.4
lycina,0,6,2,4,0,0.5
complexifies,1,12,5,7,0,0.714285714285714
nonromoebearton,0,15,7,8,0,0.875
ze'ented,0,8,3,5,1,0.6
ovispersistence,0,15,6,9,0,0.666666666666667
chemicales,0,10,4,6,0,0.666666666666667
jptrmybjnierlo,0,14,3,11,0,0.272727272727273
desperolvilabitallanptll,0,24,8,16,0,0.5
uness,0,5,2,3,0,0.666666666666667
torpex,1,6,2,4,0,0.5
granoishboyad,0,13,5,8,0,0.625
relecon,0,7,3,4,0,0.75
adscriptions,1,12,4,8,0,0.5
ntitaneranesicicon,0,18,8,10,0,0.8
vilite,0,6,3,3,0,1
southwestwardmost,0,17,5,12,0,0.416666666666667
sheeny,1,6,2,4,0,0.5
tubar,1,5,2,3,0,0.666666666666667
jacintha,1,8,3,5,0,0.6
scotophobia,1,11,5,6,0,0.833333333333333
catharan,1,8,3,5,0,0.6
hworskbgycne,0,12,2,10,0,0.2
jeerfate,0,8,4,4,0,1
waregga,1,7,3,4,0,0.75
didae,0,5,3,2,0,1.5
mucomembrane,0,12,5,7,0,0.714285714285714
compressible,1,12,4,8,0,0.5
ineducatronix,0,13,6,7,0,0.857142857142857
staggerers,1,10,3,7,0,0.428571428571429
lepididymal,0,11,4,7,0,0.571428571428571
filialnesses,1,12,5,7,0,0.714285714285714
veferuswanpuetes,0,16,7,9,0,0.777777777777778
labbarobirentholare,0,19,8,11,0,0.727272727272727
lienomyelogenous,1,16,8,8,0,1
chaffet,0,7,2,5,0,0.4
fireship,1,8,3,5,0,0.6
chap,1,4,1,3,0,0.333333333333333
ter,0,3,1,2,0,0.5
claywear,0,8,3,5,0,0.6
punerouss,0,9,4,5,0,0.8
calderca,1,8,3,5,0,0.6
hfgwubodvjjfcaks'rlacab,0,23,5,18,1,0.277777777777778
kegilinouts,0,11,5,6,0,0.833333333333333
revely,0,6,2,4,0,0.5
fulleginantawaninanelormueeviltilaullishenstic,0,46,20,26,0,0.769230769230769
fulcra,1,6,2,4,0,0.5
chortosterol,1,12,4,8,0,0.5
austerities,1,11,6,5,0,1.2
leo,1,3,2,1,0,2
catamountain,1,12,6,6,0,1
cormakincytheanhable,0,20,7,13,0,0.538461538461538
gratten,1,7,2,5,0,0.4
hagicea,0,7,4,3,0,1.33333333333333
orrisroot,1,9,4,5,0,0.8
gatiamaca,0,9,5,4,0,1.25
sublimings,1,10,3,7,0,0.428571428571429
vwjbizkjbjhkdplichofsjaqamcpj,0,29,5,24,0,0.208333333333333
rydelinnatheiscorrealigotria,0,28,12,16,0,0.75
occubrow,0,8,3,5,0,0.6
biaxwism,0,8,3,5,0,0.6
wheetnikov,0,10,4,6,0,0.666666666666667
jacitara,1,8,4,4,0,1
akrages,0,7,3,4,0,0.75
unreasonably,1,12,5,7,0,0.714285714285714
unclosers,0,9,3,6,0,0.5
leptorrhine,1,11,4,7,0,0.571428571428571
pataco,1,6,3,3,0,1
augenincernaleist,0,17,8,9,0,0.888888888888889
proformas,1,9,3,6,0,0.5
slenicarimiu,0,12,6,6,0,1
vkwvpwzxrqqy,0,12,0,12,0,0
prerevelrousness,0,16,6,10,0,0.6
undefeatableness,1,16,7,9,0,0.777777777777778
fortumn,0,7,2,5,0,0.4
syncess,0,7,1,6,0,0.166666666666667
cascarillas,1,11,4,7,0,0.571428571428571
lative,1,6,3,3,0,1
peroneal,1,8,4,4,0,1
mabobjumaitiped,0,15,7,8,0,0.875
joculationatus,0,14,7,7,0,1
labdabs,0,7,2,5,0,0.4
overreduce,1,10,5,5,0,1
unendoerus,0,10,5,5,0,1
jhspyyrilfpmrc,0,14,1,13,0,0.0769230769230769
claimer,1,7,3,4,0,0.75
brandisements,0,13,4,9,0,0.444444444444444
hangbird,1,8,2,6,0,0.333333333333333
nating,0,6,2,4,0,0.5
involumets,0,10,4,6,0,0.666666666666667
diprotodan,1,10,4,6,0,0.666666666666667
importless,1,10,3,7,0,0.428571428571429
assevered,1,9,4,5,0,0.8
copal,1,5,2,3,0,0.666666666666667
overmuse,1,8,4,4,0,1
ophioninae,1,10,6,4,0,1.5
unprotruded,1,11,4,7,0,0.571428571428571
splenculus,1,10,3,7,0,0.428571428571429
pourneyvorousness,0,17,7,10,0,0.7
foreclothman,0,12,4,8,0,0.5
theosophies,1,11,5,6,0,0.833333333333333
navicella,1,9,4,5,0,0.8
gangliosides,1,12,5,7,0,0.714285714285714
literato,1,8,4,4,0,1
brachiopod,1,10,4,6,0,0.666666666666667
sari,1,4,2,2,0,1
deplete,1,7,3,4,0,0.75
steads,1,6,2,4,0,0.5
ogqcjfl'iwpgucjivr'qjdp,0,23,4,19,2,0.210526315789474
stinkwort,1,9,2,7,0,0.285714285714286
goniffs,1,7,2,5,0,0.4
disgarrisoning,1,14,5,9,0,0.555555555555556
waterboro,1,9,4,5,0,0.8
bonomits,0,8,3,5,0,0.6
gaypialaus,0,10,5,5,0,1
mositiancea,0,11,6,5,0,1.2
chayotes,1,8,3,5,0,0.6
imposthume,1,10,4,6,0,0.666666666666667
chaponisted,0,11,4,7,0,0.571428571428571
gippinesses,0,11,4,7,0,0.571428571428571
pallion,1,7,3,4,0,0.75
pressingnesses,1,14,4,10,0,0.4
camphalterioplebard,0,19,7,12,0,0.583333333333333
fanioned,1,8,4,4,0,1
rctlgfs,0,7,0,7,0,0
maginappreights,0,15,5,10,0,0.5
inflectionist,0,13,5,8,0,0.625
superbenefit,1,12,5,7,0,0.714285714285714
tamals,1,6,2,4,0,0.5
bian,0,4,2,2,0,1
'iuqaqgystuyb,0,13,4,9,1,0.444444444444444
legionry,1,8,3,5,0,0.6
tipsiness,1,9,3,6,0,0.5
vicariism,1,9,4,5,0,0.8
ulznppyez,0,9,2,7,0,0.285714285714286
satie,1,5,3,2,0,1.5
gastroenterologists,1,19,7,12,0,0.583333333333333
pphis,0,5,1,4,0,0.25
inductance,1,10,4,6,0,0.666666666666667
reinilate,0,9,5,4,0,1.25
cobourage,0,9,5,4,0,1.25
octomeral,1,9,4,5,0,0.8
ouste,0,5,3,2,0,1.5
dugongidae,1,10,5,5,0,1
jdfwcjd'u,0,9,1,8,1,0.125
cutey,1,5,2,3,0,0.666666666666667
cognost,0,7,2,5,0,0.4
boundivingly,0,12,4,8,0,0.5
hepplewhit,0,10,3,7,0,0.428571428571429
rebaptist,0,9,3,6,0,0.5
amphisbaenian,1,13,6,7,0,0.857142857142857
marginirostrate,0,15,6,9,0,0.666666666666667
griffes,1,7,2,5,0,0.4
suniesopinerionotanjapeys,0,25,12,13,0,0.923076923076923
enchify,0,7,2,5,0,0.4
crunt,1,5,1,4,0,0.25
anser,1,5,2,3,0,0.666666666666667
episkeletonian,0,14,7,7,0,1
cnidaria,1,8,4,4,0,1
elfrieda,1,8,4,4,0,1
taganisms,0,9,3,6,0,0.5
mikadoate,1,9,5,4,0,1.25
nivir,0,5,2,3,0,0.666666666666667
rywtwmmtciyxohzgsoq,0,19,3,16,0,0.1875
kordofan,1,8,3,5,0,0.6
dentine,1,7,3,4,0,0.75
ylimscsd,0,8,1,7,0,0.142857142857143
pentyl,1,6,1,5,0,0.2
traumatise,1,10,5,5,0,1
imprudes,0,8,3,5,0,0.6
sudable,0,7,3,4,0,0.75
agnetic,0,7,3,4,0,0.75
paroariousness,0,14,7,7,0,1
qsjuqjefrelo,0,12,4,8,0,0.5
royalist,1,8,3,5,0,0.6
mediopation,0,11,6,5,0,1.2
daugs,0,5,2,3,0,0.666666666666667
buccate,1,7,3,4,0,0.75
ambrosera,0,9,4,5,0,0.8
coquinoid,0,9,5,4,0,1.25
forresponsively,0,15,5,10,0,0.5
costogenic,1,10,4,6,0,0.666666666666667
hocuttinadaminkesutoalrnda,0,26,11,15,0,0.733333333333333
brd,0,3,0,3,0,0
nonmouthing,0,11,4,7,0,0.571428571428571
nantyglo,1,8,2,6,0,0.333333333333333
advection,1,9,4,5,0,0.8
occupant,1,8,3,5,0,0.6
wwnabz'xlxe,0,11,2,9,1,0.222222222222222
tadscisthe,0,10,3,7,0,0.428571428571429
sweetbrier,1,10,4,6,0,0.666666666666667
uok,0,3,2,1,0,2
enthrilling,0,11,3,8,0,0.375
viatica,1,7,4,3,0,1.33333333333333
mubonssuns,0,10,3,7,0,0.428571428571429
uptrending,1,10,3,7,0,0.428571428571429
acgfmwuzowqiv,0,13,4,9,0,0.444444444444444
monodrama,1,9,4,5,0,0.8
ausonian,1,8,5,3,0,1.66666666666667
merunerolcas,0,12,5,7,0,0.714285714285714
derability,0,10,4,6,0,0.666666666666667
abms,1,4,1,3,0,0.333333333333333
nacns,0,5,1,4,0,0.25
pyrankillefutereumophograha,0,27,11,16,0,0.6875
salampore,1,9,4,5,0,0.8
aucubas,1,7,4,3,0,1.33333333333333
szekszrd,1,8,1,7,0,0.142857142857143
bandset,0,7,2,5,0,0.4
matuddly,0,8,2,6,0,0.333333333333333
optacon,1,7,3,4,0,0.75
pentacular,1,10,4,6,0,0.666666666666667
lemintiverats,0,13,5,8,0,0.625
buissons,0,8,3,5,0,0.6
uncotoronainon,0,14,7,7,0,1
dreams,1,6,2,4,0,0.5
acronyms,1,8,2,6,0,0.333333333333333
notintra,0,8,3,5,0,0.6
ggari,0,5,2,3,0,0.666666666666667
bettergate,0,10,4,6,0,0.666666666666667
spondyloses,1,11,3,8,0,0.375
rvxw'tfqilpafdckuisyeof,0,23,6,17,1,0.352941176470588
poluttiontora,0,13,6,7,0,0.857142857142857
sovietological,1,14,7,7,0,1
aliatatismemse,0,14,7,7,0,1
geochron,0,8,3,5,0,0.6
buerger,1,7,3,4,0,0.75
pliocentric,0,11,4,7,0,0.571428571428571
caliologies,1,11,6,5,0,1.2
landfordictive,0,14,5,9,0,0.555555555555556
unrind,1,6,2,4,0,0.5
proleta,0,7,3,4,0,0.75
braemar,1,7,3,4,0,0.75
tyrtaeus,1,8,3,5,0,0.6
clinis,1,6,2,4,0,0.5
cornrows,1,8,2,6,0,0.333333333333333
inspirate,1,9,4,5,0,0.8
andyncurs,0,9,2,7,0,0.285714285714286
telecommunities,0,15,7,8,0,0.875
thionism,0,8,3,5,0,0.6
dibias,0,6,3,3,0,1
polonial,1,8,4,4,0,1
materghherimpennestanagitespernichabia,0,38,15,23,0,0.652173913043478
homocentrals,0,12,4,8,0,0.5
'cgsdikebbtbkwsbexet,0,20,4,16,1,0.25
bgwfzoeoydnijjwluzlwsb,0,22,5,17,0,0.294117647058824
hydrolysable,1,12,3,9,0,0.333333333333333
clysma,1,6,1,5,0,0.2
phersuperghebandablenevoleonia,0,30,13,17,0,0.764705882352941
scurrilous,1,10,4,6,0,0.666666666666667
unconversantly,0,14,4,10,0,0.4
compossibleness,0,15,5,10,0,0.5
cenaiss,0,7,3,4,0,0.75
opissive,0,8,4,4,0,1
umpirism,1,8,3,5,0,0.6
fiatooelnagicoogrerarnie,0,24,13,11,0,1.18181818181818
'vuebywoscaoi'pcsdof'r,0,22,7,15,3,0.466666666666667
batheable,1,9,4,5,0,0.8
duls,0,4,1,3,0,0.333333333333333
oxamid,1,6,3,3,0,1
nonvesture,1,10,4,6,0,0.666666666666667
obsignated,1,10,4,6,0,0.666666666666667
sphandrs,0,8,1,7,0,0.142857142857143
incremental,1,11,4,7,0,0.571428571428571
meisel,1,6,3,3,0,1
sneath,1,6,2,4,0,0.5
dullingelicoelippeprist,0,23,9,14,0,0.642857142857143
pydbywvkswzddfz',0,16,0,16,1,0
gozamvxmmxvteqcbdsxq,0,20,3,17,0,0.176470588235294
contifedin,0,10,4,6,0,0.666666666666667
oreachemadestoneting,0,20,9,11,0,0.818181818181818
miketrack,0,9,3,6,0,0.5
megawatts,1,9,3,6,0,0.5
updries,1,7,3,4,0,0.75
randienterfishy,0,15,5,10,0,0.5
cibis,1,5,2,3,0,0.666666666666667
oabwrpmivqn''qihyimrs,0,21,5,16,2,0.3125
gasconism,1,9,3,6,0,0.5
suberingleezle,0,14,6,8,0,0.75
htllgayvcdjauhvucograc,0,22,6,16,0,0.375
outspritous,0,11,5,6,0,0.833333333333333
tashmiria,0,9,4,5,0,0.8
hadean,1,6,3,3,0,1
wbyvdzgmxxheuqetbrtqmfojrwxk,0,28,4,24,0,0.166666666666667
pyrrhonia,0,9,3,6,0,0.5
propulsions,1,11,4,7,0,0.571428571428571
hausatic,0,8,4,4,0,1
pati,0,4,2,2,0,1
fliectristonistoratradent,0,25,9,16,0,0.5625
frithstood,0,10,3,7,0,0.428571428571429
abilyne,1,7,3,4,0,0.75
orientation,1,11,6,5,0,1.2
calabreses,1,10,4,6,0,0.666666666666667
huttan,1,6,2,4,0,0.5
pyodflktfqdvrbau,0,16,3,13,0,0.230769230769231
azjsgdalac'cswvtzia'pegz'nwhzs,0,30,6,24,3,0.25
restrung,1,8,2,6,0,0.333333333333333
diolasterched,0,13,5,8,0,0.625
hypermerocyanoma,0,16,6,10,0,0.6
brevis,1,6,2,4,0,0.5
hlpqaqjpnprdplptz'khdxse,0,24,2,22,1,0.0909090909090909
mallanders,1,10,3,7,0,0.428571428571429
maches,1,6,2,4,0,0.5
misfalne,1,8,3,5,0,0.6
caching,1,7,2,5,0,0.4
misleared,1,9,4,5,0,0.8
synovitelle,0,11,4,7,0,0.571428571428571
prepolitically,1,14,5,9,0,0.555555555555556
mahads,0,6,2,4,0,0.5
resketchblock,0,13,3,10,0,0.3
componerosis,0,12,5,7,0,0.714285714285714
rucks,1,5,1,4,0,0.25
'dluttozq,0,9,2,7,1,0.285714285714286
lapacial,0,8,4,4,0,1
deviseurs,0,9,4,5,0,0.8
talon,1,5,2,3,0,0.666666666666667
sistersink,0,10,3,7,0,0.428571428571429
mielziner,1,9,4,5,0,0.8
monosomic,1,9,4,5,0,0.8
isadora,1,7,4,3,0,1.33333333333333
trochemistracodontidae,0,22,9,13,0,0.692307692307692
golanka,1,7,3,4,0,0.75
factively,0,9,3,6,0,0.5
ectasis,1,7,3,4,0,0.75
prlyalapainovelles,0,18,7,11,0,0.636363636363636
rgp,1,3,0,3,0,0
templacentrop,0,13,4,9,0,0.444444444444444
zebractylummederpitaristramlike,0,31,11,20,0,0.55
grammatinism,0,12,4,8,0,0.5
harb,1,4,1,3,0,0.333333333333333
bumacerred,0,10,4,6,0,0.666666666666667
udb,1,3,1,2,0,0.5
tritonitis,0,10,4,6,0,0.666666666666667
cagonc,0,6,2,4,0,0.5
prehensibiliane,0,15,7,8,0,0.875
neckatees,1,9,4,5,0,0.8
motzas,1,6,2,4,0,0.5
flimmer,1,7,2,5,0,0.4
mataeotechnical,0,15,7,8,0,0.875
anny,1,4,1,3,0,0.333333333333333
gowdnie,1,7,3,4,0,0.75
prise,1,5,2,3,0,0.666666666666667
kxounvzrsjbezmwoeizqg,0,21,6,15,0,0.4
sclaverous,0,10,4,6,0,0.666666666666667
mindergravese,0,13,5,8,0,0.625
immunopathologiser,0,18,8,10,0,0.8
goyish,1,6,2,4,0,0.5
nonecliptical,1,13,5,8,0,0.625
trecenter,0,9,3,6,0,0.5
perfused,1,8,3,5,0,0.6
fundelt,0,7,2,5,0,0.4
asparied,0,8,4,4,0,1
pineywoods,1,10,4,6,0,0.666666666666667
gladipleaxes,0,12,5,7,0,0.714285714285714
haulyard,1,8,3,5,0,0.6
superattractiveness,1,19,7,12,0,0.583333333333333
plikeatens,0,10,4,6,0,0.666666666666667
dianion,0,7,4,3,0,1.33333333333333
terariipyraide,0,14,7,7,0,1
wbmxrip,0,7,1,6,0,0.166666666666667
keherinnerentomamoreene,0,23,11,12,0,0.916666666666667
greenness,1,9,3,6,0,0.5
somewhile,1,9,4,5,0,0.8
yuponlee,0,8,4,4,0,1
antiffolkingulation,0,19,8,11,0,0.727272727272727
hiscortion,0,10,4,6,0,0.666666666666667
heinties,0,8,4,4,0,1
supersize,1,9,4,5,0,0.8
unexhaustibly,1,13,5,8,0,0.625
nutindolleys,0,12,4,8,0,0.5
panjandarus,0,11,4,7,0,0.571428571428571
parindistrial,0,13,5,8,0,0.625
rten,0,4,1,3,0,0.333333333333333
scurrility,1,10,3,7,0,0.428571428571429
eupst,0,5,2,3,0,0.666666666666667
frerallic,0,9,3,6,0,0.5
unblushes,0,9,3,6,0,0.5
glossodynia,1,11,4,7,0,0.571428571428571
hucke,0,5,2,3,0,0.666666666666667
mischaracterise,1,15,6,9,0,0.666666666666667
blackbeat,0,9,3,6,0,0.5
oyltkupinellyllidamtarabereedudompsshiched,0,42,15,27,0,0.555555555555556
puppromola,0,10,4,6,0,0.666666666666667
ltvn,0,4,0,4,0,0
magallan,0,8,3,5,0,0.6
aphototaxis,1,11,5,6,0,0.833333333333333
metafictionist,1,14,6,8,0,0.75
tecallgabus,0,11,4,7,0,0.571428571428571
pinata,1,6,3,3,0,1
fkqvshhkcpvj,0,12,0,12,0,0
orella,1,6,3,3,0,1
scatteration,1,12,5,7,0,0.714285714285714
picist,0,6,2,4,0,0.5
comersolan,0,10,4,6,0,0.666666666666667
kelity,0,6,2,4,0,0.5
kusin,1,5,2,3,0,0.666666666666667
ensphering,1,10,3,7,0,0.428571428571429
zpbt'g,0,6,0,6,1,0
menings,0,7,2,5,0,0.4
areographemeritmonger,0,21,9,12,0,0.75
vcgviwgglslckacyk'y,0,19,2,17,1,0.117647058823529
makeup,1,6,3,3,0,1
atocidae,0,8,5,3,0,1.66666666666667
infamonised,1,11,5,6,0,0.833333333333333
earclip,1,7,3,4,0,0.75
hassless,0,8,2,6,0,0.333333333333333
spriteliest,1,11,4,7,0,0.571428571428571
enrolment,1,9,3,6,0,0.5
infest,1,6,2,4,0,0.5
zooidiophilous,1,14,8,6,0,1.33333333333333
proparda,0,8,3,5,0,0.6
earthmoving,1,11,4,7,0,0.571428571428571
uptrayzcmkipbegaxnfhbnfjrijj,0,28,6,22,0,0.272727272727273
myenteron,1,9,3,6,0,0.5
antichloristic,1,14,5,9,0,0.555555555555556
marvella,1,8,3,5,0,0.6
recatechheim,0,12,5,7,0,0.714285714285714
bankets,1,7,2,5,0,0.4
propoxyphene,1,12,4,8,0,0.5
snarthybowicks,0,14,3,11,0,0.272727272727273
pthalavia,0,9,4,5,0,0.8
sulcidly,0,8,2,6,0,0.333333333333333
baaojeqdzlfnmp,0,14,4,10,0,0.4
guyses,1,6,2,4,0,0.5
counterclaimant,1,15,6,9,0,0.666666666666667
soggings,1,8,2,6,0,0.333333333333333
obelions,1,8,4,4,0,1
dispredus,0,9,3,6,0,0.5
kzzoumlzgfbfkya'vveoqapppptut,0,29,7,22,1,0.318181818181818
pocuiores,0,9,5,4,0,1.25
ateymb'can,0,10,3,7,1,0.428571428571429
clinkering,1,10,3,7,0,0.428571428571429
icos,0,4,2,2,0,1
ouuzjiur,0,8,5,3,0,1.66666666666667
teleostomous,1,12,6,6,0,1
ridicralidadie,0,14,7,7,0,1
reskuing,1,8,3,5,0,0.6
adey,1,4,2,2,0,1
paleomagnetic,0,13,6,7,0,0.857142857142857
romancy,0,7,2,5,0,0.4
poliketterial,0,13,6,7,0,0.857142857142857
cholesterinic,1,13,5,8,0,0.625
sickleman,1,9,3,6,0,0.5
aslop,1,5,2,3,0,0.666666666666667
commationemonise,0,16,8,8,0,1
maulding,0,8,3,5,0,0.6
giamdmphcwegefolevqgzrd'jd,0,26,6,20,1,0.3
undeceivers,1,11,5,6,0,0.833333333333333
cicala,1,6,3,3,0,1
schechitah,1,10,3,7,0,0.428571428571429
unennoblewood,0,13,6,7,0,0.857142857142857
syancingwiertiouslynoconpanhase,0,31,12,19,0,0.631578947368421
gluciorian,0,10,5,5,0,1
lespr,0,5,1,4,0,0.25
subprincipal,1,12,4,8,0,0.5
druptiness,0,10,3,7,0,0.428571428571429
emblematised,1,12,5,7,0,0.714285714285714
daker,1,5,2,3,0,0.666666666666667
bedfjzbu'yk,0,11,2,9,1,0.222222222222222
drearful,0,8,3,5,0,0.6
mussal,1,6,2,4,0,0.5
ionospheres,1,11,5,6,0,0.833333333333333
loppers,1,7,2,5,0,0.4
therari,0,7,3,4,0,0.75
tegmentum,1,9,3,6,0,0.5
tropomyosins,1,12,4,8,0,0.5
silvertail,1,10,4,6,0,0.666666666666667
pathunganaryngometroporolda,0,27,10,17,0,0.588235294117647
cymprepint,0,10,2,8,0,0.25
discontipur,0,11,4,7,0,0.571428571428571
microcinematography,1,19,7,12,0,0.583333333333333
drubber,1,7,2,5,0,0.4
unstead,0,7,3,4,0,0.75
podys,0,5,1,4,0,0.25
exigeante,1,9,5,4,0,1.25
puranic,1,7,3,4,0,0.75
ethercap,1,8,3,5,0,0.6
cer,0,3,1,2,0,0.5
ennstoryl,0,9,2,7,0,0.285714285714286
unmetrified,1,11,5,6,0,0.833333333333333
qv',0,3,0,3,1,0
chizas,0,6,2,4,0,0.5
edwardmore,0,10,4,6,0,0.666666666666667
tughra,1,6,2,4,0,0.5
infiltration,1,12,5,7,0,0.714285714285714
hesperidiums,1,12,5,7,0,0.714285714285714
bittner,1,7,2,5,0,0.4
unconsurfactivealistial,0,23,10,13,0,0.769230769230769
yonita,1,6,3,3,0,1
collonotrophyta,0,15,5,10,0,0.5
unpounded,1,9,4,5,0,0.8
basidenestandialis,0,18,8,10,0,0.8
nonreinstatement,1,16,6,10,0,0.6
duchesney,0,9,3,6,0,0.5
yxwob,0,5,1,4,0,0.25
smes,0,4,1,3,0,0.333333333333333
knickknacks,1,11,2,9,0,0.222222222222222
hawpefewb,0,9,3,6,0,0.5
koipopepignites,0,15,7,8,0,0.875
beekeeper,1,9,5,4,0,1.25
gryllus,1,7,1,6,0,0.166666666666667
yhjpjhmbp'o,0,11,1,10,1,0.1
barleysick,1,10,3,7,0,0.428571428571429
stoory,1,6,2,4,0,0.5
physicomathematical,1,19,7,12,0,0.583333333333333
oat'jeunprtylrl,0,15,4,11,1,0.363636363636364
morocco,1,7,3,4,0,0.75
strehens,0,8,2,6,0,0.333333333333333
frstracular,0,11,3,8,0,0.375
medisucid,0,9,4,5,0,0.8
hfuqqlawfr'avdbdsucwys,0,22,4,18,1,0.222222222222222
karttikeya,1,10,4,6,0,0.666666666666667
sbar,0,4,1,3,0,0.333333333333333
unassailing,1,11,5,6,0,0.833333333333333
chemult,1,7,2,5,0,0.4
extraperiosteorrhaphy,0,21,8,13,0,0.615384615384615
flacourth,0,9,3,6,0,0.5
reprievabilities,0,16,8,8,0,1
sovenances,1,10,4,6,0,0.666666666666667
amalgam,1,7,3,4,0,0.75
pecurg,0,6,2,4,0,0.5
balmacaan,1,9,4,5,0,0.8
slumbitiousness,0,15,6,9,0,0.666666666666667
hirticedicalism,0,15,6,9,0,0.666666666666667
gastrostomy,1,11,3,8,0,0.375
katogle,1,7,3,4,0,0.75
blendcorn,1,9,2,7,0,0.285714285714286
superpossition,1,14,6,8,0,0.75
prelusion,1,9,4,5,0,0.8
astoundingly,1,12,4,8,0,0.5
iambographer,1,12,5,7,0,0.714285714285714
thaumatrope,1,11,5,6,0,0.833333333333333
mannify,1,7,2,5,0,0.4
britanniculi,0,12,5,7,0,0.714285714285714
milldale,1,8,3,5,0,0.6
barpendropola,0,13,5,8,0,0.625
cxkigynk'q'qwg,0,14,1,13,2,0.0769230769230769
rhamsa,0,6,2,4,0,0.5
tericeingmiongohabbbe,0,21,9,12,0,0.75
huis,1,4,2,2,0,1
spitussion,0,10,4,6,0,0.666666666666667
payagua,1,7,4,3,0,1.33333333333333
loxley,1,6,2,4,0,0.5
pannosely,1,9,3,6,0,0.5
cjsropj'xdvrihgoek'jaebakpf,0,27,7,20,2,0.35
mitern,0,6,2,4,0,0.5
musculospiral,1,13,5,8,0,0.625
stronous,0,8,3,5,0,0.6
chowchow,1,8,2,6,0,0.333333333333333
autokoturpeivee,0,15,9,6,0,1.5
prestidigitative,0,16,7,9,0,0.777777777777778
dollar,1,6,2,4,0,0.5
myelomenia,1,10,5,5,0,1
bgnczctqvpz,0,11,0,11,0,0
stoits,1,6,2,4,0,0.5
windemiolloquy,0,14,6,8,0,0.75
chame,0,5,2,3,0,0.666666666666667
imluz,0,5,2,3,0,0.666666666666667
scarrings,1,9,2,7,0,0.285714285714286
homonymy,1,8,2,6,0,0.333333333333333
uricosurgically,0,15,6,9,0,0.666666666666667
bdifwhwhqev,0,11,2,9,0,0.222222222222222
chea,0,4,2,2,0,1
acetylenogen,1,12,5,7,0,0.714285714285714
opposers,1,8,3,5,0,0.6
calcedonios,1,11,5,6,0,0.833333333333333
greenheart,1,10,4,6,0,0.666666666666667
yolgoqpmxepcpytobxrahy,0,22,5,17,0,0.294117647058824
barbarea,1,8,4,4,0,1
vetiveria,1,9,5,4,0,1.25
snabbie,1,7,3,4,0,0.75
lendl,1,5,1,4,0,0.25
syrians,1,7,2,5,0,0.4
nonduciant,0,10,4,6,0,0.666666666666667
leasemen,1,8,4,4,0,1
phrensities,0,11,4,7,0,0.571428571428571
repostclasstophorotund,0,22,7,15,0,0.466666666666667
bioelectrotherapies,1,19,9,10,0,0.9
xpagoxnokoabvj,0,14,5,9,0,0.555555555555556
outtrick,0,8,3,5,0,0.6
iwound,1,6,3,3,0,1
unreachably,1,11,4,7,0,0.571428571428571
'nlejwvjhtun,0,12,2,10,1,0.2
fetishist,1,9,3,6,0,0.5
rosellen,1,8,3,5,0,0.6
schizoneura,1,11,5,6,0,0.833333333333333
ox'hhlyhmp'jxtdkumn,0,19,2,17,2,0.117647058823529
socrates,1,8,3,5,0,0.6
davan,0,5,2,3,0,0.666666666666667
jaguarondi,1,10,5,5,0,1
demanders,1,9,3,6,0,0.5
breaklet,0,8,3,5,0,0.6
regnancy,1,8,2,6,0,0.333333333333333
decoagulabilities,0,17,9,8,0,1.125
sparrers,1,8,2,6,0,0.333333333333333
dramnetick,0,10,3,7,0,0.428571428571429
kubiak,1,6,3,3,0,1
stornians,0,9,3,6,0,0.5
frophall,0,8,2,6,0,0.333333333333333
ikeyness,1,8,3,5,0,0.6
polioneuromerism,0,16,8,8,0,1
nontransportation,1,17,6,11,0,0.545454545454545
scribeship,1,10,3,7,0,0.428571428571429
gasfield,1,8,3,5,0,0.6
birostrated,1,11,4,7,0,0.571428571428571
amantadine,1,10,5,5,0,1
dropflower,0,10,3,7,0,0.428571428571429
lzvsnlvdvoy,0,11,1,10,0,0.1
calamopitys,1,11,4,7,0,0.571428571428571
jzel,0,4,1,3,0,0.333333333333333
slabbinesses,1,12,4,8,0,0.5
aphans,0,6,2,4,0,0.5
strigulaceae,1,12,6,6,0,1
tetrator,0,8,3,5,0,0.6
ulasttomn,0,9,3,6,0,0.5
rimola,1,6,3,3,0,1
unwieldily,1,10,4,6,0,0.666666666666667
belarusan,1,9,4,5,0,0.8
renormality,0,11,4,7,0,0.571428571428571
jmttuikyzmareo,0,14,5,9,0,0.555555555555556
rehypothecation,1,15,6,9,0,0.666666666666667
buddleman,1,9,3,6,0,0.5
proenforced,0,11,4,7,0,0.571428571428571
thalidomide,1,11,5,6,0,0.833333333333333
nonexhaustible,1,14,6,8,0,0.75
depopulates,1,11,5,6,0,0.833333333333333
recertifyings,0,13,4,9,0,0.444444444444444
schyt,0,5,0,5,0,0
bisquick,1,8,3,5,0,0.6
aucklands,0,9,3,6,0,0.5
polyclone,1,9,3,6,0,0.5
pevaber,0,7,3,4,0,0.75
tarinellowskia,0,14,6,8,0,0.75
bluencephalobectase,0,19,8,11,0,0.727272727272727
chery,1,5,1,4,0,0.25
moselesshemerogoi,0,17,8,9,0,0.888888888888889
biddery,1,7,2,5,0,0.4
kirtles,1,7,2,5,0,0.4
habitational,1,12,6,6,0,1
moistish,1,8,3,5,0,0.6
horrorists,0,10,3,7,0,0.428571428571429
adame,0,5,3,2,0,1.5
goodwilies,1,10,5,5,0,1
dillage,0,7,3,4,0,0.75
overnalnes,0,10,4,6,0,0.666666666666667
nonclingingly,0,13,3,10,0,0.3
dci''hiodhqwfhwpewmypcspzkbfxf,0,30,4,26,2,0.153846153846154
lageycubaidntinevadrhenitot,0,27,11,16,0,0.6875
franciscanism,1,13,4,9,0,0.444444444444444
enton,0,5,2,3,0,0.666666666666667
spagirist,1,9,3,6,0,0.5
ariomma,1,7,4,3,0,1.33333333333333
sagamen,1,7,3,4,0,0.75
honestete,1,9,4,5,0,0.8
awamaban,0,8,4,4,0,1
ekvwkov'rl'odhrpcsn,0,19,3,16,2,0.1875
veterrally,0,10,3,7,0,0.428571428571429
chiltonsville,0,13,4,9,0,0.444444444444444
driers,1,6,2,4,0,0.5
aegesta,1,7,4,3,0,1.33333333333333
dantons,1,7,2,5,0,0.4
seaboliefs,0,10,5,5,0,1
polspolans,0,10,3,7,0,0.428571428571429
'wx,0,3,0,3,1,0
ponacosumer,0,11,5,6,0,0.833333333333333
coordinator,1,11,5,6,0,0.833333333333333
hoomilam,0,8,4,4,0,1
jcufdjz'xft,0,11,1,10,1,0.1
chiarezze,1,9,4,5,0,0.8
atalimiotoy,0,11,6,5,0,1.2
dorsoradial,1,11,5,6,0,0.833333333333333
ssti,0,4,1,3,0,0.333333333333333
eles,0,4,2,2,0,1
hypontis,0,8,2,6,0,0.333333333333333
ladefilinfuninferotoligragares,0,30,13,17,0,0.764705882352941
onelqifvegtjxu,0,14,5,9,0,0.555555555555556
subhunry,0,8,2,6,0,0.333333333333333
reremith,0,8,3,5,0,0.6
fustinella,1,10,4,6,0,0.666666666666667
immured,1,7,3,4,0,0.75
corporative,1,11,5,6,0,0.833333333333333
westernly,1,9,2,7,0,0.285714285714286
colourbreeds,1,12,5,7,0,0.714285714285714
capitaled,1,9,4,5,0,0.8
madrence,0,8,3,5,0,0.6
pyrolysing,1,10,2,8,0,0.25
populators,0,10,4,6,0,0.666666666666667
infanticides,1,12,5,7,0,0.714285714285714
reshowering,1,11,4,7,0,0.571428571428571
duodedenums,1,11,5,6,0,0.833333333333333
ceroid,1,6,3,3,0,1
isxlvggq'c'henchym'oozuf,0,24,5,19,3,0.263157894736842
qo,0,2,1,1,0,1
customhouses,1,12,5,7,0,0.714285714285714
fyhh,0,4,0,4,0,0
occiologists,0,12,5,7,0,0.714285714285714
taseometer,1,10,5,5,0,1
pandemia,1,8,4,4,0,1
revamps,1,7,2,5,0,0.4
petrialenesis,0,13,6,7,0,0.857142857142857
cous,0,4,2,2,0,1
llivaleskbala,0,13,5,8,0,0.625
zillionid,0,9,4,5,0,0.8
spadify,0,7,2,5,0,0.4
hoppy,1,5,1,4,0,0.25
iomyi,0,5,3,2,0,1.5
ticogis,0,7,3,4,0,0.75
dowed,1,5,2,3,0,0.666666666666667
prinsburg,1,9,2,7,0,0.285714285714286
extrade,0,7,3,4,0,0.75
gemony,1,6,2,4,0,0.5
babirajazonisevol,0,17,8,9,0,0.888888888888889
poortith,1,8,3,5,0,0.6
jggbn,0,5,0,5,0,0
dentification,1,13,6,7,0,0.857142857142857
awkh'xujix,0,10,3,7,1,0.428571428571429
nonpossed,0,9,3,6,0,0.5
wonderlands,1,11,3,8,0,0.375
sloyd,1,5,1,4,0,0.25
antiasis,0,8,4,4,0,1
prejepupplia,0,12,5,7,0,0.714285714285714
gzofwlylabllvzrtxefswj,0,22,3,19,0,0.157894736842105
mekhitarist,1,11,4,7,0,0.571428571428571
susanoo,1,7,4,3,0,1.33333333333333
lipopoda,1,8,4,4,0,1
anderbromeda,0,12,5,7,0,0.714285714285714
loing,0,5,2,3,0,0.666666666666667
underperforming,1,15,5,10,0,0.5
thorn,1,5,1,4,0,0.25
mirably,0,7,2,5,0,0.4
benzonine,0,9,4,5,0,0.8
foulmart,1,8,3,5,0,0.6
vomitelogishantra,0,17,7,10,0,0.7
cahoneycomb,0,11,4,7,0,0.571428571428571
apologic,0,8,4,4,0,1
stopblock,1,9,2,7,0,0.285714285714286
xvfkqjkmcvwwrhyumjivqudr,0,24,3,21,0,0.142857142857143
eumostended,0,11,5,6,0,0.833333333333333
conias,1,6,3,3,0,1
unfrighted,1,10,3,7,0,0.428571428571429
cereuphonia,0,11,6,5,0,1.2
disinflations,1,13,5,8,0,0.625
definificalness,0,15,6,9,0,0.666666666666667
produced,1,8,3,5,0,0.6
feisty,1,6,2,4,0,0.5
isometrograph,1,13,5,8,0,0.625
lavanine,0,8,4,4,0,1
pimingles,0,9,3,6,0,0.5
proximateness,1,13,5,8,0,0.625
'qcgegtfawhjte,0,14,3,11,1,0.272727272727273
cyndy,1,5,0,5,0,0
yakow,1,5,2,3,0,0.666666666666667
nemathelminthias,0,16,6,10,0,0.6
identifier,1,10,5,5,0,1
xqdsmnaunxfkloowikj',0,20,5,15,1,0.333333333333333
ples,0,4,1,3,0,0.333333333333333
opet,0,4,2,2,0,1
mercourtrahents,0,15,5,10,0,0.5
accessivens,0,11,4,7,0,0.571428571428571
frouncing,1,9,3,6,0,0.5
hikgvkvyaiajhw',0,15,4,11,1,0.363636363636364
echolocate,1,10,5,5,0,1
gilisation,0,10,5,5,0,1
perpent,1,7,2,5,0,0.4
cus,0,3,1,2,0,0.5
ouydxmsg'ecubcigec,0,18,6,12,1,0.5
wcs,1,3,0,3,0,0
ewkymxuzgeodxxsv'dqdv,0,21,4,17,1,0.235294117647059
dioberiwmjn,0,11,4,7,0,0.571428571428571
pharynx,1,7,1,6,0,0.166666666666667
perdita,1,7,3,4,0,0.75
whasle,1,6,2,4,0,0.5
wlcvfxrmlslfcvpifsyqddqbljv,0,27,1,26,0,0.0384615384615385
oizys,1,5,2,3,0,0.666666666666667
beballed,1,8,3,5,0,0.6
aspewindemanasadordiateepigfluorehekt,0,37,17,20,0,0.85
ingurgitates,1,12,5,7,0,0.714285714285714
oeg,0,3,2,1,0,2
rectuated,0,9,4,5,0,0.8
scaldberries,1,12,4,8,0,0.5
hodophobia,1,10,5,5,0,1
pseudochylous,1,13,5,8,0,0.625
urr,0,3,1,2,0,0.5
kceihupb,0,8,3,5,0,0.6
mesosomatidae,0,13,7,6,0,1.16666666666667
tqejitzumdrba,0,13,4,9,0,0.444444444444444
polygenically,1,13,4,9,0,0.444444444444444
mu'ofugdx,0,9,3,6,1,0.5
ydrdwwrtdkfjitnrrwtv,0,20,1,19,0,0.0526315789473684
bonfire,1,7,3,4,0,0.75
i'dw,0,4,1,3,1,0.333333333333333
hillocks,1,8,2,6,0,0.333333333333333
desktop,1,7,2,5,0,0.4
sibylesque,1,10,4,6,0,0.666666666666667
thrombidiidae,0,13,6,7,0,0.857142857142857
outserving,0,10,4,6,0,0.666666666666667
idious,0,6,4,2,0,2
nonmanifestly,1,13,4,9,0,0.444444444444444
perrier,1,7,3,4,0,0.75
nondistracting,1,14,4,10,0,0.4
supercautical,0,13,6,7,0,0.857142857142857
bemuses,1,7,3,4,0,0.75
tivepamimatllbchuiph,0,20,7,13,0,0.538461538461538
hyalinosis,1,10,4,6,0,0.666666666666667
bogbeaner,0,9,4,5,0,0.8
deprian,0,7,3,4,0,0.75
profile,1,7,3,4,0,0.75
suithold,1,8,3,5,0,0.6
jellyrolls,1,10,2,8,0,0.25
whitlamp,0,8,2,6,0,0.333333333333333
znij,0,4,1,3,0,0.333333333333333
oreron,0,6,3,3,0,1
anecdysis,1,9,3,6,0,0.5
rionetrantroconsemangspeted,0,27,10,17,0,0.588235294117647
naethiodamas,0,12,6,6,0,1
slipstreamware,0,14,5,9,0,0.555555555555556
kylie,1,5,2,3,0,0.666666666666667
perk,1,4,1,3,0,0.333333333333333
docks,1,5,1,4,0,0.25
tealery,1,7,3,4,0,0.75
f''djavlapw,0,11,2,9,2,0.222222222222222
torrence,1,8,3,5,0,0.6
jmdohjbo,0,8,2,6,0,0.333333333333333
scologist,0,9,3,6,0,0.5
galauxorteachallarlsoven,0,24,10,14,0,0.714285714285714
mmarcomstvopms,0,14,3,11,0,0.272727272727273
inone,1,5,3,2,0,1.5
butinthrasseudoppys,0,19,6,13,0,0.461538461538462
partonectronoist,0,16,6,10,0,0.6
katholikos,1,10,4,6,0,0.666666666666667
lakelike,1,8,4,4,0,1
uncials,1,7,3,4,0,0.75
pommelion,1,9,4,5,0,0.8
gastarka,0,8,3,5,0,0.6
cumarin,1,7,3,4,0,0.75
propertyship,1,12,3,9,0,0.333333333333333
tripsychos,0,10,2,8,0,0.25
ambo,1,4,2,2,0,1
octapody,1,8,3,5,0,0.6
ingloriousnesses,1,16,7,9,0,0.777777777777778
horsehair,1,9,4,5,0,0.8
skencotorthalultrav,0,19,6,13,0,0.461538461538462
sphite,0,6,2,4,0,0.5
tassie,1,6,3,3,0,1
bespermandriatedalists,0,22,8,14,0,0.571428571428571
falkland,1,8,2,6,0,0.333333333333333
unprovocativeness,1,17,7,10,0,0.7
fucoideae,1,9,6,3,0,2
isagogically,1,12,5,7,0,0.714285714285714
underpopular,0,12,5,7,0,0.714285714285714
sonablenesses,0,13,5,8,0,0.625
toitonil,0,8,4,4,0,1
vampleurassiner,0,15,6,9,0,0.666666666666667
catenane,1,8,4,4,0,1
burdens,1,7,2,5,0,0.4
tcexbqzyd'f'hpleamnotr'cahrerp,0,30,6,24,3,0.25
repulser,1,8,3,5,0,0.6
viscometrically,1,15,5,10,0,0.5
stockpilers,1,11,3,8,0,0.375
quixotic,1,8,4,4,0,1
zfkflruamb,0,10,2,8,0,0.25
antirabilities,0,14,7,7,0,1
proteosaurid,1,12,6,6,0,1
badger,1,6,2,4,0,0.5
wiese,1,5,3,2,0,1.5
rcfopuyjykuburqhivn,0,19,5,14,0,0.357142857142857
decuria,1,7,4,3,0,1.33333333333333
amoebidae,1,9,6,3,0,2
cle,0,3,1,2,0,0.5
felettedincaerpond,0,18,7,11,0,0.636363636363636
dh,0,2,0,2,0,0
overswatchier,0,13,5,8,0,0.625
clavolae,1,8,4,4,0,1
minigardens,1,11,4,7,0,0.571428571428571
benignness,1,10,3,7,0,0.428571428571429
elisabetta,1,10,5,5,0,1
huisheckpoine,0,13,6,7,0,0.857142857142857
crily,0,5,1,4,0,0.25
migeon,1,6,3,3,0,1
superfortaine,0,13,6,7,0,0.857142857142857
sanfood,0,7,3,4,0,0.75
mooress,1,7,3,4,0,0.75
transubstantialist,0,18,6,12,0,0.5
pixiness,1,8,3,5,0,0.6
eusol,1,5,3,2,0,1.5
rpakvenwbxnorixtvyvzpipnhwqoq,0,29,6,23,0,0.260869565217391
flarer,1,6,2,4,0,0.5
fragmentariness,1,15,5,10,0,0.5
usuriousness,1,12,6,6,0,1
hypochondra,0,11,3,8,0,0.375
arotcll,0,7,2,5,0,0.4
tumult,1,6,2,4,0,0.5
semipectologies,0,15,7,8,0,0.875
snomies,0,7,3,4,0,0.75
xb'uwbgbvwbrqpuid,0,17,3,14,1,0.214285714285714
bernoulli,1,9,4,5,0,0.8
meddler,1,7,2,5,0,0.4
nonvibrating,1,12,4,8,0,0.5
noum,0,4,2,2,0,1
cnidosporidia,1,13,6,7,0,0.857142857142857
troutflower,1,11,4,7,0,0.571428571428571
cysted,1,6,1,5,0,0.2
cerebels,0,8,3,5,0,0.6
russophobist,1,12,4,8,0,0.5
tradescantist,0,13,4,9,0,0.444444444444444
unwic,0,5,2,3,0,0.666666666666667
kirths,0,6,1,5,0,0.2
stultification,1,14,6,8,0,0.75
recounter,1,9,4,5,0,0.8
pyrotritaric,1,12,4,8,0,0.5
protostar,1,9,3,6,0,0.5
subsidiser,1,10,4,6,0,0.666666666666667
ganchaming,0,10,3,7,0,0.428571428571429
ffrnnu'ehpmt,0,12,2,10,1,0.2
archaicisms,1,11,4,7,0,0.571428571428571
unrevolting,1,11,4,7,0,0.571428571428571
bugging,1,7,2,5,0,0.4
slederback,0,10,3,7,0,0.428571428571429
acicrulcos,0,10,4,6,0,0.666666666666667
shouldery,0,9,3,6,0,0.5
crashlenbrakiehl,0,16,5,11,0,0.454545454545455
nurselet,1,8,3,5,0,0.6
guglet,1,6,2,4,0,0.5
inunctuosity,1,12,5,7,0,0.714285714285714
lcujl'vriy,0,10,2,8,1,0.25
preobjectivally,0,15,5,10,0,0.5
overtrample,1,11,4,7,0,0.571428571428571
boatic,0,6,3,3,0,1
gadsmen,1,7,2,5,0,0.4
intertextual,1,12,5,7,0,0.714285714285714
doblin,1,6,2,4,0,0.5
nuchemantifule,0,14,6,8,0,0.75
subprefectorial,1,15,6,9,0,0.666666666666667
canilate,0,8,4,4,0,1
sulphonephthalein,1,17,6,11,0,0.545454545454545
concheas,0,8,3,5,0,0.6
chroscorps,0,10,2,8,0,0.25
oxyphenol,1,9,3,6,0,0.5
dudi,0,4,2,2,0,1
luisa,1,5,3,2,0,1.5
backfish,0,8,2,6,0,0.333333333333333
huichial,0,8,4,4,0,1
flutters,1,8,2,6,0,0.333333333333333
macdermanisiness,0,16,6,10,0,0.6
ghrgdudbih,0,10,2,8,0,0.25
cayuses,1,7,3,4,0,0.75
casstown,1,8,2,6,0,0.333333333333333
chord,1,5,1,4,0,0.25
culunpularchme,0,14,5,9,0,0.555555555555556
gilberte,1,8,3,5,0,0.6
pirome,0,6,3,3,0,1
ierna,1,5,3,2,0,1.5
odologies,0,9,5,4,0,1.25
warheaturessnesi,0,16,7,9,0,0.777777777777778
triloculate,1,11,5,6,0,0.833333333333333
cogenerator,1,11,5,6,0,0.833333333333333
hu'hdrljng,0,10,1,9,1,0.111111111111111
lissotrichan,1,12,4,8,0,0.5
concordance,1,11,4,7,0,0.571428571428571
piselli,1,7,3,4,0,0.75
paraxially,1,10,4,6,0,0.666666666666667
evoluntling,0,11,4,7,0,0.571428571428571
staria,0,6,3,3,0,1
apophthegmatises,1,16,6,10,0,0.6
pindjajap,1,9,3,6,0,0.5
u'oyinraqi,0,10,5,5,1,1
omoraran,0,8,4,4,0,1
staging,1,7,2,5,0,0.4
valetudinously,0,14,6,8,0,0.75
monadology,1,10,4,6,0,0.666666666666667
prediscontentedness,0,19,6,13,0,0.461538461538462
skeeling,1,8,3,5,0,0.6
jhelum,1,6,2,4,0,0.5
hagwesiris,0,10,4,6,0,0.666666666666667
xofpmyzlrrxgszozpvcmep,0,22,3,19,0,0.157894736842105
sublet,1,6,2,4,0,0.5
baudrillard,1,11,4,7,0,0.571428571428571
bombarongara,0,12,5,7,0,0.714285714285714
catechumenship,1,14,5,9,0,0.555555555555556
turbarkermentalness,0,19,6,13,0,0.461538461538462
demonstrandwolves,0,17,5,12,0,0.416666666666667
lecithin,1,8,3,5,0,0.6
blackguardism,1,13,4,9,0,0.444444444444444
rouens,1,6,3,3,0,1
norilitiser,0,11,5,6,0,0.833333333333333
untidy,1,6,2,4,0,0.5
scruplesomenesses,0,17,6,11,0,0.545454545454545
seaned,1,6,3,3,0,1
sanelmobies,0,11,5,6,0,0.833333333333333
ungracefulness,1,14,5,9,0,0.555555555555556
meliorations,1,12,6,6,0,1
compassings,1,11,3,8,0,0.375
parles,1,6,2,4,0,0.5
grundified,1,10,4,6,0,0.666666666666667
rafordo,0,7,3,4,0,0.75
womanishness,1,12,4,8,0,0.5
photochloridic,0,14,5,9,0,0.555555555555556
discommissioning,1,16,6,10,0,0.6
modular,1,7,3,4,0,0.75
evenger,0,7,3,4,0,0.75
parmailpot,0,10,4,6,0,0.666666666666667
crenelley,0,9,3,6,0,0.5
montrony,0,8,2,6,0,0.333333333333333
ndivenoly,0,9,3,6,0,0.5
gvxirlbhsjegrmozcbilhxj,0,23,4,19,0,0.210526315789474
nomocracy,1,9,3,6,0,0.5
ragasericto,0,11,5,6,0,0.833333333333333
arnifte,0,7,3,4,0,0.75
unardious,0,9,5,4,0,1.25
patchockes,1,10,3,7,0,0.428571428571429
asbury,1,6,2,4,0,0.5
lafferty,1,8,2,6,0,0.333333333333333
degradualities,0,14,7,7,0,1
floced,0,6,2,4,0,0.5
occupy,1,6,2,4,0,0.5
thrialinch,0,10,3,7,0,0.428571428571429
midian,1,6,3,3,0,1
pamphleteerings,1,15,5,10,0,0.5
hicha,0,5,2,3,0,0.666666666666667
overgence,0,9,4,5,0,0.8
dugedfgsswostvf,0,15,3,12,0,0.25
biphenylmethyl,0,14,3,11,0,0.272727272727273
overbranchiser,0,14,5,9,0,0.555555555555556
chestiness,1,10,3,7,0,0.428571428571429
ecdyseismatis,0,13,5,8,0,0.625
pyrinatings,0,11,3,8,0,0.375
qulun,0,5,2,3,0,0.666666666666667
rechisel,1,8,3,5,0,0.6
maxillary,1,9,3,6,0,0.5
scituate,1,8,4,4,0,1
ceweings,0,8,3,5,0,0.6
tffinglounulies,0,15,6,9,0,0.666666666666667
lary,0,4,1,3,0,0.333333333333333
hyperminisheriopathi,0,20,8,12,0,0.666666666666667
anhunt,0,6,2,4,0,0.5
prettermoist,0,12,4,8,0,0.5
grestickil,0,10,3,7,0,0.428571428571429
pyroclastics,1,12,3,9,0,0.333333333333333
rebrick,1,7,2,5,0,0.4
gmieualanaoganalizingedantyliala,0,32,16,16,0,1
inardin,0,7,3,4,0,0.75
noncongruency,1,13,4,9,0,0.444444444444444
stethoscope,1,11,4,7,0,0.571428571428571
angiocarbonemerger,0,18,8,10,0,0.8
moracl,0,6,2,4,0,0.5
uleshe,0,6,3,3,0,1
millenia,1,8,4,4,0,1
vidanch,0,7,2,5,0,0.4
salicornia,1,10,5,5,0,1
dishevel,1,8,3,5,0,0.6
blephantomicroquefortuitoist,0,28,12,16,0,0.75
toscafo,0,7,3,4,0,0.75
reconomicropuses,0,16,7,9,0,0.777777777777778
eventides,1,9,4,5,0,0.8
guadelouper,0,11,6,5,0,1.2
front,1,5,1,4,0,0.25
crabb,1,5,1,4,0,0.25
calikops,0,8,3,5,0,0.6
keed,0,4,2,2,0,1
superspective,0,13,5,8,0,0.625
avarish,1,7,3,4,0,0.75
imourcubontuatruryullicr,0,24,10,14,0,0.714285714285714
palmerycia,0,10,4,6,0,0.666666666666667
und,0,3,1,2,0,0.5
anchants,0,8,2,6,0,0.333333333333333
allantoidal,1,11,5,6,0,0.833333333333333
monegasques,1,11,5,6,0,0.833333333333333
mocuddums,1,9,3,6,0,0.5
megallethads,0,12,4,8,0,0.5
annunciating,1,12,5,7,0,0.714285714285714
fuflelgcle'fvdxilbct,0,20,4,16,1,0.25
portliest,1,9,3,6,0,0.5
paties,0,6,3,3,0,1
unexhibitableness,1,17,7,10,0,0.7
nonimperenchmeling,0,18,6,12,0,0.5
bithikhoneltaacatisstuelighess,0,30,12,18,0,0.666666666666667
cosine,1,6,3,3,0,1
kiddushes,1,9,3,6,0,0.5
mulhationaryngelltrabaloant,0,27,10,17,0,0.588235294117647
pantarbe,1,8,3,5,0,0.6
edeologic,0,9,5,4,0,1.25
inapostate,1,10,5,5,0,1
knobel,1,6,2,4,0,0.5
unasteries,0,10,5,5,0,1
galenism,1,8,3,5,0,0.6
braided,1,7,3,4,0,0.75
quy,0,3,1,2,0,0.5
paracenical,0,11,5,6,0,0.833333333333333
chatly,0,6,1,5,0,0.2
leucocytozoarialgia,0,19,10,9,0,1.11111111111111
subiaco,1,7,4,3,0,1.33333333333333
hexadd,1,6,2,4,0,0.5
rtetrafoterinate,0,16,7,9,0,0.777777777777778
unfardle,1,8,3,5,0,0.6
bogan,1,5,2,3,0,0.666666666666667
siffleuse,1,9,4,5,0,0.8
o'donoghue,1,10,5,5,1,1
pimply,1,6,1,5,0,0.2
deverbatives,1,12,5,7,0,0.714285714285714
interpleadedness,0,16,6,10,0,0.6
metailogilatts,0,14,6,8,0,0.75
salbu,1,5,2,3,0,0.666666666666667
nursemibasitopausian,0,20,10,10,0,1
vertebrochondral,1,16,5,11,0,0.454545454545455
adenose,1,7,4,3,0,1.33333333333333
muckhole,1,8,3,5,0,0.6
beeriest,1,8,4,4,0,1
coelestial,1,10,5,5,0,1
wanpigerooganity,0,16,7,9,0,0.777777777777778
bucarilocults,0,13,5,8,0,0.625
accreted,1,8,3,5,0,0.6
afterweb,0,8,3,5,0,0.6
fuckamporachmanism,0,18,6,12,0,0.5
coarchisoriness,0,15,6,9,0,0.666666666666667
montages,1,8,3,5,0,0.6
qantar,1,6,2,4,0,0.5
noncompensation,1,15,6,9,0,0.666666666666667
cutpurses,1,9,3,6,0,0.5
intasilevskymowries,0,19,7,12,0,0.583333333333333
arbut,0,5,2,3,0,0.666666666666667
ethelin,1,7,3,4,0,0.75
antecedent,1,10,4,6,0,0.666666666666667
belem,1,5,2,3,0,0.666666666666667
d'vkgtnvdfsvza,0,14,1,13,1,0.0769230769230769
okome,0,5,3,2,0,1.5
snapshootee,0,11,5,6,0,0.833333333333333
imd,1,3,1,2,0,0.5
totalitizer,1,11,5,6,0,0.833333333333333
shagging,1,8,2,6,0,0.333333333333333
zoopantheon,1,11,5,6,0,0.833333333333333
transkei,1,8,3,5,0,0.6
isodomising,0,11,5,6,0,0.833333333333333
agraga,1,6,3,3,0,1
otjb'etpoqeynq,0,14,4,10,1,0.4
wysjlyyvsjsiisthyvtefgfk,0,24,3,21,0,0.142857142857143
z'gbmhanqrr'gqjxhpydhiaxl,0,25,3,22,2,0.136363636363636
megaplex,1,8,3,5,0,0.6
qdqz,0,4,0,4,0,0
laypeople,1,9,4,5,0,0.8
aylykxkspnec'qq,0,15,2,13,1,0.153846153846154
evocations,1,10,5,5,0,1
skyjackers,1,10,2,8,0,0.25
hypoplanktonic,1,14,4,10,0,0.4
recordicinae,0,12,6,6,0,1
uatpjthmhavqq,0,13,3,10,0,0.3
reinfilternations,0,17,7,10,0,0.7
jequille,0,8,4,4,0,1
dolphinets,1,10,3,7,0,0.428571428571429
cosmosis,0,8,3,5,0,0.6
busti,1,5,2,3,0,0.666666666666667
udo'pcpxwoxnniianzgkpmi,0,23,7,16,1,0.4375
abscissions,1,11,4,7,0,0.571428571428571
unipoes,0,7,4,3,0,1.33333333333333
gops,0,4,1,3,0,0.333333333333333
dupo,1,4,2,2,0,1
leptonninframist,0,16,5,11,0,0.454545454545455
spinnel,1,7,2,5,0,0.4
phalacrosis,1,11,4,7,0,0.571428571428571
amphioxide,0,10,5,5,0,1
fadaticinetic,0,13,6,7,0,0.857142857142857
marous,0,6,3,3,0,1
subumbiliform,0,13,5,8,0,0.625
waiinae,0,7,5,2,0,2.5
blespuridamitummak,0,18,7,11,0,0.636363636363636
obares,0,6,3,3,0,1
tialines,0,8,4,4,0,1
disponsolatry,0,13,4,9,0,0.444444444444444
propagandist,1,12,4,8,0,0.5
garberries,0,10,4,6,0,0.666666666666667
reposses,0,8,3,5,0,0.6
tranchmen,0,9,2,7,0,0.285714285714286
quartersaws,1,11,4,7,0,0.571428571428571
hwelon,1,6,2,4,0,0.5
underable,0,9,4,5,0,0.8
loculating,0,10,4,6,0,0.666666666666667
icassiorutorond,0,15,7,8,0,0.875
cotillions,1,10,4,6,0,0.666666666666667
fluellin,1,8,3,5,0,0.6
unstylishly,1,11,2,9,0,0.222222222222222
spond,0,5,1,4,0,0.25
temping,1,7,2,5,0,0.4
steatopygium,0,12,5,7,0,0.714285714285714
uriatrominbiographinniness,0,26,11,15,0,0.733333333333333
cementums,1,9,3,6,0,0.5
puncheon,1,8,3,5,0,0.6
spaerobee,1,9,5,4,0,1.25
archarentundies,0,15,6,9,0,0.666666666666667
muskmelon,1,9,3,6,0,0.5
fretten,1,7,2,5,0,0.4
artlogy,0,7,2,5,0,0.4
antidor,0,7,3,4,0,0.75
lactucol,1,8,3,5,0,0.6
'u'mbzuwvxluyczjscdolil,0,23,5,18,2,0.277777777777778
thianisms,0,9,3,6,0,0.5
louvale,1,7,4,3,0,1.33333333333333
steganographic,1,14,5,9,0,0.555555555555556
delike,0,6,3,3,0,1
scruncler,0,9,2,7,0,0.285714285714286
'memkz'cut'irsf'zuiaenx',0,24,7,17,5,0.411764705882353
hostlership,1,11,3,8,0,0.375
thretivadia,0,11,5,6,0,0.833333333333333
qjtgoqcdkfxnumfxulegtrykghtqyv,0,30,4,26,0,0.153846153846154
gunation,1,8,4,4,0,1
cardinalates,1,12,5,7,0,0.714285714285714
coronomy,0,8,3,5,0,0.6
bemuddle,1,8,3,5,0,0.6
supermajority,1,13,5,8,0,0.625
zmh'kt,0,6,0,6,1,0
sedalia,1,7,4,3,0,1.33333333333333
gregariniform,1,13,5,8,0,0.625
abarweicaalcy,0,13,6,7,0,0.857142857142857
unirradius,0,10,5,5,0,1
subabbots,1,9,3,6,0,0.5
undampable,1,10,4,6,0,0.666666666666667
triazole,1,8,4,4,0,1
kalites,0,7,3,4,0,0.75
debites,0,7,3,4,0,0.75
overorganify,0,12,5,7,0,0.714285714285714
jackdated,0,9,3,6,0,0.5
priveenenerng,0,13,5,8,0,0.625
lcfl'ghkc,0,9,0,9,1,0
rockandroll,1,11,3,8,0,0.375
minaturgenicoaguentia,0,21,11,10,0,1.1
colocation,0,10,5,5,0,1
mhkncmltczobzwwxsgvr,0,20,1,19,0,0.0526315789473684
ghette,0,6,2,4,0,0.5
ejkrnmgdgattgzvdals,0,19,3,16,0,0.1875
wheatgrowingness,0,16,5,11,0,0.454545454545455
excerptions,1,11,4,7,0,0.571428571428571
lbhsznhokalx,0,12,2,10,0,0.2
teats,1,5,2,3,0,0.666666666666667
cutlassfish,1,11,3,8,0,0.375
cryptobatholite,0,15,5,10,0,0.5
ventrally,1,9,2,7,0,0.285714285714286
surjectively,0,12,4,8,0,0.5
hypnales,0,8,2,6,0,0.333333333333333
peribranchial,1,13,5,8,0,0.625
overrighteous,1,13,6,7,0,0.857142857142857
alberta,1,7,3,4,0,0.75
maynord,1,7,2,5,0,0.4
galimed,0,7,3,4,0,0.75
nonicism,0,8,3,5,0,0.6
tclifvyjrcmf,0,12,1,11,0,0.0909090909090909
cottian,0,7,3,4,0,0.75
overestimation,1,14,7,7,0,1
berrs,0,5,1,4,0,0.25
assailments,1,11,4,7,0,0.571428571428571
oldous,0,6,3,3,0,1
kbpppmwghnl,0,11,0,11,0,0
enelouabntflla,0,14,6,8,0,0.75
pulourtfoolhygen,0,16,6,10,0,0.6
fundraised,1,10,4,6,0,0.666666666666667
tth,0,3,0,3,0,0
shopwindows,1,11,3,8,0,0.375
imwcfjkw'mjbnigutw,0,18,3,15,1,0.2
woecxwaajea,0,11,6,5,0,1.2
dorkus,1,6,2,4,0,0.5
panmelodion,1,11,5,6,0,0.833333333333333
erythmite,0,9,3,6,0,0.5
eredueius,0,9,6,3,0,2
higden,1,6,2,4,0,0.5
tongngggs,0,9,1,8,0,0.125
inwrapophlebifer,0,16,6,10,0,0.6
synoecising,1,11,4,7,0,0.571428571428571
undertaxed,1,10,4,6,0,0.666666666666667
obsessed,1,8,3,5,0,0.6
jlmxqseoiz,0,10,3,7,0,0.428571428571429
cacorrhachis,1,12,4,8,0,0.5
montal,0,6,2,4,0,0.5
areca,1,5,3,2,0,1.5
savonbugobracadorfeity,0,22,9,13,0,0.692307692307692
retic,0,5,2,3,0,0.666666666666667
rgocmoy'larkropcus,0,18,5,13,1,0.384615384615385
peenwin,0,7,3,4,0,0.75
thonfllenrossknfeopis,0,21,6,15,0,0.4
denegations,1,11,5,6,0,0.833333333333333
splairged,0,9,3,6,0,0.5
thessuance,0,10,4,6,0,0.666666666666667
erytheis,1,8,3,5,0,0.6
caldaria,1,8,4,4,0,1
horologian,0,10,5,5,0,1
rodrique,1,8,4,4,0,1
honeren,0,7,3,4,0,0.75
pharmacognosy,1,13,4,9,0,0.444444444444444
sallow,1,6,2,4,0,0.5
dovekey,1,7,3,4,0,0.75
enzamburgoney,0,13,5,8,0,0.625
lintimeros,0,10,4,6,0,0.666666666666667
anodine,1,7,4,3,0,1.33333333333333
catalogice,0,10,5,5,0,1
onen,0,4,2,2,0,1
pauseless,1,9,4,5,0,0.8
cetraria,1,8,4,4,0,1
li'lyyyieipy',0,13,4,9,2,0.444444444444444
rutledge,1,8,3,5,0,0.6
boomen,0,6,3,3,0,1
horterstrata,0,12,4,8,0,0.5
bookies,1,7,4,3,0,1.33333333333333
aderwauke,0,9,5,4,0,1.25
fingernails,1,11,4,7,0,0.571428571428571
daraeo,1,6,4,2,0,2
theologise,1,10,5,5,0,1
legpull,1,7,2,5,0,0.4
agalfoacitas,0,12,6,6,0,1
inthralment,1,11,3,8,0,0.375
villotcaking,0,12,4,8,0,0.5
leesg,0,5,2,3,0,0.666666666666667
rlphnjvoi'kjewy,0,15,3,12,1,0.25
nadapt,0,6,2,4,0,0.5
vvbxe,0,5,1,4,0,0.25
hexanitrodiphenylamine,1,22,9,13,0,0.692307692307692
galachist,0,9,3,6,0,0.5
astacia,0,7,4,3,0,1.33333333333333
mautioutogia,0,12,8,4,0,2
romantic,1,8,3,5,0,0.6
broomfield,1,10,4,6,0,0.666666666666667
clarksville,1,11,3,8,0,0.375
uranology,1,9,4,5,0,0.8
posse,1,5,2,3,0,0.666666666666667
uncate,0,6,3,3,0,1
micromanagements,1,16,6,10,0,0.6
carnahuba,1,9,4,5,0,0.8
cmu,1,3,1,2,0,0.5
interdealt,1,10,4,6,0,0.666666666666667
kannah,0,6,2,4,0,0.5
halfpennial,0,11,4,7,0,0.571428571428571
dreamontmospeaker,0,17,7,10,0,0.7
loisgulnes,0,10,4,6,0,0.666666666666667
unmortgaged,1,11,4,7,0,0.571428571428571
sniooemug,0,9,5,4,0,1.25
achenes,1,7,3,4,0,0.75
keywd,1,5,1,4,0,0.25
miscomprehensions,1,17,6,11,0,0.545454545454545
wtranteranophurmphiuimiais,0,26,11,15,0,0.733333333333333
absenteeism,1,11,5,6,0,0.833333333333333
vexcxxmjwgrwrkiq,0,16,2,14,0,0.142857142857143
transsensually,1,14,4,10,0,0.4
pedanticness,1,12,4,8,0,0.5
dampere,0,7,3,4,0,0.75
karstify,1,8,2,6,0,0.333333333333333
gqm,0,3,0,3,0,0
caseminute,0,10,5,5,0,1
rodster,1,7,2,5,0,0.4
witillb,0,7,2,5,0,0.4
precurse,1,8,3,5,0,0.6
telnuts,0,7,2,5,0,0.4
vertrocktorgufraicah,0,20,7,13,0,0.538461538461538
ulleorthise,0,11,5,6,0,0.833333333333333
bansela,1,7,3,4,0,0.75
pulloc,0,6,2,4,0,0.5
shroousiana,0,11,6,5,0,1.2
kroovermalah,0,12,5,7,0,0.714285714285714
retrollekeepersecreticise,0,25,11,14,0,0.785714285714286
unstoned,1,8,3,5,0,0.6
griminess,1,9,3,6,0,0.5
vaumur,0,6,3,3,0,1
baltificationeche,0,17,8,9,0,0.888888888888889
northington,1,11,3,8,0,0.375
mard,0,4,1,3,0,0.333333333333333
ookinesses,0,10,5,5,0,1
htomqpadfxncoxoojvivjcbkq,0,25,6,19,0,0.315789473684211
sheol,1,5,2,3,0,0.666666666666667
srrawrwqqnrnqciycpzrkyk,0,23,2,21,0,0.0952380952380952
malleability,1,12,5,7,0,0.714285714285714
mscqotzbpefnchkaqdeklhpx,0,24,4,20,0,0.2
slickness,1,9,2,7,0,0.285714285714286
jfddc'mq,0,8,0,8,1,0
collivio,0,8,4,4,0,1
stracialesgus,0,13,5,8,0,0.625
galipine,1,8,4,4,0,1
chasmananars,0,12,4,8,0,0.5
mfb,1,3,0,3,0,0
swtmsh'hvdvfrpigznj,0,19,1,18,1,0.0555555555555556
ctes,0,4,1,3,0,0.333333333333333
argentone,0,9,4,5,0,0.8
flora,1,5,2,3,0,0.666666666666667
vice,1,4,2,2,0,1
emprise,1,7,3,4,0,0.75
lyyciyg,0,7,1,6,0,0.166666666666667
whittlings,1,10,2,8,0,0.25
stilette,0,8,3,5,0,0.6
intwists,1,8,2,6,0,0.333333333333333
heeder,1,6,3,3,0,1
transposed,1,10,3,7,0,0.428571428571429
degentilize,1,11,5,6,0,0.833333333333333
coccosteidae,1,12,6,6,0,1
ntaprinouleris,0,14,6,8,0,0.75
phore,0,5,2,3,0,0.666666666666667
pseudocritically,1,16,6,10,0,0.6
'gkmahf',0,8,1,7,2,0.142857142857143
shellessness,0,12,3,9,0,0.333333333333333
flufouyul,0,9,4,5,0,0.8
garnerurg,0,9,3,6,0,0.5
nondeformation,1,14,6,8,0,0.75
oticoding,0,9,4,5,0,0.8
saccharification,1,16,7,9,0,0.777777777777778
candleshrift,1,12,3,9,0,0.333333333333333
ujbszdfhxmxb,0,12,1,11,0,0.0909090909090909
desynonymization,1,16,6,10,0,0.6
caky,1,4,1,3,0,0.333333333333333
squeamish,1,9,4,5,0,0.8
reimaginaceae,0,13,8,5,0,1.6
ambimedliles,0,12,5,7,0,0.714285714285714
wazinednessipere,0,16,7,9,0,0.777777777777778
inguinappeased,0,14,7,7,0,1
ponammenmaings,0,14,5,9,0,0.555555555555556
orator,1,6,3,3,0,1
commonsensibly,1,14,4,10,0,0.4
evlovci,0,7,3,4,0,0.75
crite,0,5,2,3,0,0.666666666666667
daetoaccal,0,10,5,5,0,1
nondecorating,0,13,5,8,0,0.625
hiamata,0,7,4,3,0,1.33333333333333
etrcqec'uasctdqmcp,0,18,4,14,1,0.285714285714286
doomsday,1,8,3,5,0,0.6
nonmenacing,1,11,4,7,0,0.571428571428571
nonheimer,0,9,4,5,0,0.8
hrwfzcfibcj,0,11,1,10,0,0.1
desulfurised,1,12,5,7,0,0.714285714285714
ballutes,1,8,3,5,0,0.6
indignly,1,8,2,6,0,0.333333333333333
porindrinrd,0,11,3,8,0,0.375
purt,0,4,1,3,0,0.333333333333333
excantation,1,11,5,6,0,0.833333333333333
interlopers,1,11,4,7,0,0.571428571428571
knopf,1,5,1,4,0,0.25
platemaking,1,11,4,7,0,0.571428571428571
jtlnaxajhgfwdxjsuzqdkuiakgd',0,28,6,22,1,0.272727272727273
hornlets,1,8,2,6,0,0.333333333333333
tg'iavhjkbavon,0,14,4,10,1,0.4
bontebok,1,8,3,5,0,0.6
antimasquerade,1,14,7,7,0,1
mailcoach,1,9,4,5,0,0.8
runds,1,5,1,4,0,0.25
afeard,1,6,3,3,0,1
kallikrein,1,10,4,6,0,0.666666666666667
depotentiate,1,12,6,6,0,1
openoffice,1,10,5,5,0,1
agloss,0,6,2,4,0,0.5
ploid,0,5,2,3,0,0.666666666666667
asur,1,4,2,2,0,1
noneugenical,1,12,6,6,0,1
stanyel,1,7,2,5,0,0.4
raggy,1,5,1,4,0,0.25
hemilenectivenenethyryer,0,24,9,15,0,0.6
isenanoumenglethins,0,19,8,11,0,0.727272727272727
salvableness,0,12,4,8,0,0.5
calochorda,0,10,4,6,0,0.666666666666667
armw,0,4,1,3,0,0.333333333333333
actinon,1,7,3,4,0,0.75
acrogen,1,7,3,4,0,0.75
zymologic,1,9,3,6,0,0.5
swooperant,0,10,4,6,0,0.666666666666667
tanglingly,1,10,2,8,0,0.25
caskful,1,7,2,5,0,0.4
hotatoninembows,0,15,6,9,0,0.666666666666667
miana,0,5,3,2,0,1.5
carloid,0,7,3,4,0,0.75
kassite,1,7,3,4,0,0.75
setcla,0,6,2,4,0,0.5
scauperinsisteridas,0,19,8,11,0,0.727272727272727
nephelium,1,9,4,5,0,0.8
traducianist,1,12,5,7,0,0.714285714285714
bzbzomnkvuy,0,11,2,9,0,0.222222222222222
endopodin,0,9,4,5,0,0.8
breth,1,5,1,4,0,0.25
vasoepididymostomy,1,18,7,11,0,0.636363636363636
nonsenity,0,9,3,6,0,0.5
poirer,1,6,3,3,0,1
unia,0,4,3,1,0,3
bitcoin,1,7,3,4,0,0.75
vowelish,1,8,3,5,0,0.6
flannelgraph,1,12,3,9,0,0.333333333333333
preflorice,0,10,4,6,0,0.666666666666667
pko,0,3,1,2,0,0.5
callance,0,8,3,5,0,0.6
stonecrosis,0,11,4,7,0,0.571428571428571
undistrustless,0,14,4,10,0,0.4
sansovino,1,9,4,5,0,0.8
hakam,1,5,2,3,0,0.666666666666667
venepunctulated,0,15,6,9,0,0.666666666666667
rathoric,0,8,3,5,0,0.6
lungan,1,6,2,4,0,0.5
microgantly,0,11,3,8,0,0.375
inenubi,0,7,4,3,0,1.33333333333333
arilling,0,8,3,5,0,0.6
tatisation,0,10,5,5,0,1
covicleasory,0,12,5,7,0,0.714285714285714
lutecium,1,8,4,4,0,1
spurium,0,7,3,4,0,0.75
harquebusier,1,12,6,6,0,1
ovaliqueldecalluleimphosubrohys,0,31,13,18,0,0.722222222222222
defatting,1,9,3,6,0,0.5
housnopercherant,0,16,6,10,0,0.6
cockney,1,7,2,5,0,0.4
disruptersquamanling,0,20,7,13,0,0.538461538461538
botaniser,1,9,4,5,0,0.8
stody,0,5,1,4,0,0.25
ulbitism,0,8,3,5,0,0.6
wanlly,0,6,1,5,0,0.2
anapodeictic,1,12,6,6,0,1
hydroquinol,1,11,4,7,0,0.571428571428571
hyperglorious,0,13,5,8,0,0.625
multilingually,1,14,5,9,0,0.555555555555556
correna,1,7,3,4,0,0.75
precalosalistineled,0,19,8,11,0,0.727272727272727
incons,0,6,2,4,0,0.5
nqupnun,0,7,2,5,0,0.4
archaris,0,8,3,5,0,0.6
auamprecogoendifunss,0,20,9,11,0,0.818181818181818
crimp,1,5,1,4,0,0.25
girardo,1,7,3,4,0,0.75
bjhnswssizcvworsfqv,0,19,2,17,0,0.117647058823529
bqtujartuy,0,10,3,7,0,0.428571428571429
homontevahlis,0,13,5,8,0,0.625
ovids,0,5,2,3,0,0.666666666666667
umbellule,1,9,4,5,0,0.8
recemvirgiate,0,13,6,7,0,0.857142857142857
disorderedness,1,14,5,9,0,0.555555555555556
ison,0,4,2,2,0,1
wrfsinfwbxwkwn,0,14,1,13,0,0.0769230769230769
tombac,1,6,2,4,0,0.5
whanging,1,8,2,6,0,0.333333333333333
friendsville,1,12,4,8,0,0.5
ngrairceacrequetes,0,18,8,10,0,0.8
idolatrously,1,12,5,7,0,0.714285714285714
scheinencalfleshabites,0,22,8,14,0,0.571428571428571
tassets,1,7,2,5,0,0.4
postmedullary,1,13,4,9,0,0.444444444444444
ghia,0,4,2,2,0,1
merseyside,1,10,4,6,0,0.666666666666667
indexlessness,1,13,4,9,0,0.444444444444444
carcar,0,6,2,4,0,0.5
inobediences,1,12,6,6,0,1
ataxophemia,1,11,6,5,0,1.2
chorologer,0,10,4,6,0,0.666666666666667
compud,0,6,2,4,0,0.5
unintermixture,0,14,6,8,0,0.75
multiperforated,1,15,6,9,0,0.666666666666667
iolcanglas,0,10,4,6,0,0.666666666666667
hnkemgl,0,7,1,6,0,0.166666666666667
cappyrandratassels,0,18,5,13,0,0.384615384615385
steelmaking,1,11,4,7,0,0.571428571428571
diddles,1,7,2,5,0,0.4
silverpeak,1,10,4,6,0,0.666666666666667
deigawpubicent,0,14,6,8,0,0.75
gilroy,1,6,2,4,0,0.5
delightfully,1,12,3,9,0,0.333333333333333
chopboat,1,8,3,5,0,0.6
garnett,1,7,2,5,0,0.4
midysrlnqxyii,0,13,3,10,0,0.3
vatedly,0,7,2,5,0,0.4
minitimouted,0,12,6,6,0,1
scotlandwards,1,13,3,10,0,0.3
shas,0,4,1,3,0,0.333333333333333
grindery,1,8,2,6,0,0.333333333333333
idykw,0,5,1,4,0,0.25
ninjas,1,6,2,4,0,0.5
hebeany,0,7,3,4,0,0.75
achussecare,0,11,5,6,0,0.833333333333333
svuzxgtrssf,0,11,1,10,0,0.1
reinnervations,1,14,6,8,0,0.75
aramayoite,1,10,6,4,0,1.5
divellication,0,13,6,7,0,0.857142857142857
scarphs,1,7,1,6,0,0.166666666666667
turbogenerate,0,13,6,7,0,0.857142857142857
nimrod,1,6,2,4,0,0.5
souglacomald,0,12,5,7,0,0.714285714285714
flvesty,0,7,1,6,0,0.166666666666667
renterochronological,0,20,8,12,0,0.666666666666667
pinkiness,1,9,3,6,0,0.5
trisulc,1,7,2,5,0,0.4
rectille,0,8,3,5,0,0.6
edwardianism,0,12,5,7,0,0.714285714285714
chrisrooted,0,11,4,7,0,0.571428571428571
johnsonians,1,11,4,7,0,0.571428571428571
sebundies,1,9,4,5,0,0.8
drudge,1,6,2,4,0,0.5
rubblies,0,8,3,5,0,0.6
tabularisations,1,15,7,8,0,0.875
resonthexhan,0,12,4,8,0,0.5
retransmited,1,12,4,8,0,0.5
gelidiaceae,1,11,7,4,0,1.75
watton,1,6,2,4,0,0.5
chroes,0,6,2,4,0,0.5
pgastablexor,0,12,4,8,0,0.5
proxalist,0,9,3,6,0,0.5
estheduschr,0,11,3,8,0,0.375
typhic,1,6,1,5,0,0.2
brtebrontrdenowocead,0,20,7,13,0,0.538461538461538
microvilli,1,10,4,6,0,0.666666666666667
coistrel,1,8,3,5,0,0.6
cliteros,0,8,3,5,0,0.6
iodoso,1,6,4,2,0,2
assiniboine,1,11,6,5,0,1.2
ullswater,1,9,3,6,0,0.5
unblanketed,1,11,4,7,0,0.571428571428571
landau,1,6,3,3,0,1
dendrites,1,9,3,6,0,0.5
mannah,0,6,2,4,0,0.5
putaxlesceners,0,14,5,9,0,0.555555555555556
arenaria,1,8,5,3,0,1.66666666666667
sacramento,1,10,4,6,0,0.666666666666667
ungebulyson,0,11,4,7,0,0.571428571428571
keraunography,1,13,5,8,0,0.625
kramatorsk,1,10,3,7,0,0.428571428571429
superintendence,1,15,6,9,0,0.666666666666667
slumgullions,1,12,4,8,0,0.5
ductworks,1,9,2,7,0,0.285714285714286
antidefamation,1,14,7,7,0,1
uncolourblines,0,14,6,8,0,0.75
nephrotyphoid,1,13,4,9,0,0.444444444444444
loesceke,1,8,4,4,0,1
bali,1,4,2,2,0,1
spis,0,4,1,3,0,0.333333333333333
aethalium,1,9,5,4,0,1.25
vsugivdlxflo,0,12,3,9,0,0.333333333333333
varronian,1,9,4,5,0,0.8
cqx'lud,0,7,1,6,1,0.166666666666667
censions,0,8,3,5,0,0.6
vclfqpdoaecujoaoihgv,0,20,8,12,0,0.666666666666667
kher,0,4,1,3,0,0.333333333333333
scarcely,1,8,2,6,0,0.333333333333333
preily,0,6,2,4,0,0.5
disenclosure,0,12,5,7,0,0.714285714285714
zwaq,0,4,1,3,0,0.333333333333333
sinarchisms,1,11,3,8,0,0.375
barrera,1,7,3,4,0,0.75
cordaitales,1,11,5,6,0,0.833333333333333
rehoboams,1,9,4,5,0,0.8
semiorthodox,1,12,5,7,0,0.714285714285714
fzgii'ziialj,0,12,5,7,1,0.714285714285714
frangent,1,8,2,6,0,0.333333333333333
reng,0,4,1,3,0,0.333333333333333
athalee,1,7,4,3,0,1.33333333333333
y'beegaj'gcwi,0,13,4,9,2,0.444444444444444
antly,0,5,1,4,0,0.25
forbade,1,7,3,4,0,0.75
anch,0,4,1,3,0,0.333333333333333
kummerbund,1,10,3,7,0,0.428571428571429
gambusia,1,8,4,4,0,1
bibliophils,1,11,4,7,0,0.571428571428571
chank,1,5,1,4,0,0.25
ventriloquise,1,13,6,7,0,0.857142857142857
brother,1,7,2,5,0,0.4
sipeddleheadespons,0,18,7,11,0,0.636363636363636
ivoirians,1,9,5,4,0,1.25
chop,1,4,1,3,0,0.333333333333333
crabtree,1,8,3,5,0,0.6
bovill,1,6,2,4,0,0.5
rhegnopteri,1,11,4,7,0,0.571428571428571
albert,1,6,2,4,0,0.5
orphabell,0,9,3,6,0,0.5
aventeotbaccilt,0,15,6,9,0,0.666666666666667
parats,0,6,2,4,0,0.5
filvpfdrelpefkoipo,0,18,6,12,0,0.5
mastes,0,6,2,4,0,0.5
overb,0,5,2,3,0,0.666666666666667
crumbly,1,7,1,6,0,0.166666666666667
trisiticomon,0,12,5,7,0,0.714285714285714
ddafiboltibrkigrksm,0,19,5,14,0,0.357142857142857
exploitage,1,10,5,5,0,1
intermeasuria,0,13,7,6,0,1.16666666666667
utophane,0,8,4,4,0,1
hemerocallis,1,12,5,7,0,0.714285714285714
diatretum,1,9,4,5,0,0.8
cantiradoxographic,0,18,7,11,0,0.636363636363636
apoluphloes,0,11,5,6,0,0.833333333333333
hbjuip,0,6,2,4,0,0.5
vardingale,1,10,4,6,0,0.666666666666667
aus,0,3,2,1,0,2
eungy,0,5,2,3,0,0.666666666666667
shugart,1,7,2,5,0,0.4
coalgood,1,8,4,4,0,1
nonmanagements,1,14,5,9,0,0.555555555555556
dismissiveness,1,14,5,9,0,0.555555555555556
ferrochrome,0,11,4,7,0,0.571428571428571
cbipssbtfut,0,11,2,9,0,0.222222222222222
wahehe,1,6,3,3,0,1
proitalinhtiechecocupreitrerrbily,0,33,13,20,0,0.65
anty,0,4,1,3,0,0.333333333333333
dscelacklgenthas,0,16,4,12,0,0.333333333333333
entertainment,1,13,5,8,0,0.625
phytognomy,1,10,2,8,0,0.25
sileni,1,6,3,3,0,1
progelerfectlecly,0,17,5,12,0,0.416666666666667
nonoskin,0,8,3,5,0,0.6
overtrue,1,8,4,4,0,1
mannoses,1,8,3,5,0,0.6
dubiosities,1,11,6,5,0,1.2
psephurus,1,9,3,6,0,0.5
zfuvdfmvuqu,0,11,3,8,0,0.375
inscrolls,1,9,2,7,0,0.285714285714286
honelly,0,7,2,5,0,0.4
trichechus,1,10,3,7,0,0.428571428571429
nolock,0,6,2,4,0,0.5
saccule,1,7,3,4,0,0.75
enduros,1,7,3,4,0,0.75
tomfortuga,0,10,4,6,0,0.666666666666667
bailiwicks,1,10,4,6,0,0.666666666666667
psammocharidae,1,14,6,8,0,0.75
whiff,1,5,1,4,0,0.25
symmers,0,7,1,6,0,0.166666666666667
nonguarantinable,0,16,7,9,0,0.777777777777778
unsable,0,7,3,4,0,0.75
hwaggendiaetzlxgvdagr,0,21,6,15,0,0.4
otherworldish,1,13,4,9,0,0.444444444444444
mqzkgwflsnjbsvhgzjgzqhz,0,23,0,23,0,0
inism,0,5,2,3,0,0.666666666666667
lombarde,0,8,3,5,0,0.6
crowville,1,9,3,6,0,0.5
counterflower,0,13,5,8,0,0.625
kilithia,0,8,4,4,0,1
daffery,1,7,2,5,0,0.4
unfanton,0,8,3,5,0,0.6
paguroid,1,8,4,4,0,1
nosematic,0,9,4,5,0,0.8
letona,1,6,3,3,0,1
guake,0,5,3,2,0,1.5
'thlrjwpkpwmawjeiuwzv,0,21,4,17,1,0.235294117647059
unconvulsiveness,1,16,6,10,0,0.6
batty,1,5,1,4,0,0.25
churidae,0,8,4,4,0,1
khamseen,1,8,3,5,0,0.6
foretake,1,8,4,4,0,1
caroach,1,7,3,4,0,0.75
indoorstead,0,11,5,6,0,0.833333333333333
yrdckgpyfumrfoxmhwwq,0,20,2,18,0,0.111111111111111
corseting,1,9,3,6,0,0.5
bism,0,4,1,3,0,0.333333333333333
unconspire,0,10,4,6,0,0.666666666666667
nskcpxavuhjsuurzwce,0,19,5,14,0,0.357142857142857
vigkbw,0,6,1,5,0,0.2
goldenbush,1,10,3,7,0,0.428571428571429
inuring,1,7,3,4,0,0.75
nonspherings,0,12,3,9,0,0.333333333333333
densimetry,1,10,3,7,0,0.428571428571429
gesse,1,5,2,3,0,0.666666666666667
trichomona,0,10,4,6,0,0.666666666666667
deducements,1,11,4,7,0,0.571428571428571
hempster,0,8,2,6,0,0.333333333333333
vatonoadefnitinthe,0,18,8,10,0,0.8
overcommendment,0,15,5,10,0,0.5
cilicet,0,7,3,4,0,0.75
jhpoyhvnk,0,9,1,8,0,0.125
voluntee,0,8,4,4,0,1
nasonally,0,9,3,6,0,0.5
coom,1,4,2,2,0,1
utzukxx'klx,0,11,2,9,1,0.222222222222222
migglotingbasquer,0,17,6,11,0,0.545454545454545
terury,0,6,2,4,0,0.5
monopolite,0,10,5,5,0,1
datormagajratecurachic,0,22,9,13,0,0.692307692307692
ethtwlbcz,0,9,1,8,0,0.125
porett,1,6,2,4,0,0.5
verifiedness,0,12,5,7,0,0.714285714285714
dommego,0,7,3,4,0,0.75
munitioneer,1,11,6,5,0,1.2
anisidine,1,9,5,4,0,1.25
wallerian,1,9,4,5,0,0.8
bfnjygsxfe',0,11,1,10,1,0.1
beinanorm,0,9,4,5,0,0.8
driftlessness,1,13,3,10,0,0.3
edrosomissiccaromanting,0,23,9,14,0,0.642857142857143
preaccord,1,9,3,6,0,0.5
retreading,1,10,4,6,0,0.666666666666667
miscorrectest,0,13,4,9,0,0.444444444444444
hoser,1,5,2,3,0,0.666666666666667
adonais,1,7,4,3,0,1.33333333333333
cercyon,1,7,2,5,0,0.4
petalkinsonose,0,14,6,8,0,0.75
rhizomatous,1,11,5,6,0,0.833333333333333
elvers,1,6,2,4,0,0.5
paration,0,8,4,4,0,1
ravonelle,1,9,4,5,0,0.8
aciformes,0,9,4,5,0,0.8
fanache,0,7,3,4,0,0.75
nggsjty',0,8,0,8,1,0
theomorpha,0,10,4,6,0,0.666666666666667
biopsychologist,1,15,5,10,0,0.5
parometerols,0,12,5,7,0,0.714285714285714
stowbordmen,0,11,3,8,0,0.375
parochialised,1,13,6,7,0,0.857142857142857
rayage,1,6,3,3,0,1
bvzjhpudbmmyjbja,0,16,2,14,0,0.142857142857143
nillblinbrutics,0,15,4,11,0,0.363636363636364
rialatiopigre,0,13,7,6,0,1.16666666666667
chanedblepocelpss,0,17,5,12,0,0.416666666666667
sekofski,1,8,3,5,0,0.6
impersuasibly,1,13,5,8,0,0.625
dist,0,4,1,3,0,0.333333333333333
ladle,1,5,2,3,0,0.666666666666667
intersusceptibly,0,16,5,11,0,0.454545454545455
bridgetin,1,9,3,6,0,0.5
marshier,1,8,3,5,0,0.6
exaerphy,0,8,3,5,0,0.6
assuetudinariness,0,17,8,9,0,0.888888888888889
ventade,0,7,3,4,0,0.75
vaginectomy,1,11,4,7,0,0.571428571428571
affenpinscher,1,13,4,9,0,0.444444444444444
vivant,1,6,2,4,0,0.5
repudiationist,1,14,7,7,0,1
sovietist,1,9,4,5,0,0.8
tikalesinfaros,0,14,6,8,0,0.75
ephorates,1,9,4,5,0,0.8
euheme,0,6,4,2,0,2
hepamppidarcyarengrmiapprddes,0,29,9,20,0,0.45
pertia,0,6,3,3,0,1
reshowing,1,9,3,6,0,0.5
bandelette,1,10,4,6,0,0.666666666666667
wkqutfwctjwiheumn',0,18,4,14,1,0.285714285714286
gallical,0,8,3,5,0,0.6
blouddion,0,9,4,5,0,0.8
heterakid,1,9,4,5,0,0.8
mestees,1,7,3,4,0,0.75
infralapsarianisms,1,18,7,11,0,0.636363636363636
moorgamy,0,8,3,5,0,0.6
phylephebic,1,11,3,8,0,0.375
insecured,0,9,4,5,0,0.8
cymbidiums,1,10,3,7,0,0.428571428571429
ladybird,1,8,2,6,0,0.333333333333333
itymatr,0,7,2,5,0,0.4
deptelerle,0,10,4,6,0,0.666666666666667
unameliorable,1,13,7,6,0,1.16666666666667
vauting,1,7,3,4,0,0.75
otah,0,4,2,2,0,1
oenone,1,6,4,2,0,2
kinnuroicrante,0,14,6,8,0,0.75
findigo,0,7,3,4,0,0.75
schoascar,0,9,3,6,0,0.5
wheller,1,7,2,5,0,0.4
rosophisms,0,10,3,7,0,0.428571428571429
nonwarrantableness,0,18,6,12,0,0.5
snoozling,1,9,3,6,0,0.5
intemonal,0,9,4,5,0,0.8
zoogeography,1,12,5,7,0,0.714285714285714
metioukcleadelforgic,0,20,9,11,0,0.818181818181818
civin,0,5,2,3,0,0.666666666666667
ghvki',0,6,1,5,1,0.2
jolleyerosomatoideal,0,20,10,10,0,1
teel,1,4,2,2,0,1
medes,1,5,2,3,0,0.666666666666667
theropoda,1,9,4,5,0,0.8
ichthyian,1,9,3,6,0,0.5
arromignesi,0,11,5,6,0,0.833333333333333
nattorine,0,9,4,5,0,0.8
comforchysoplanjibanic,0,22,7,15,0,0.466666666666667
gloriosa,1,8,4,4,0,1
nonnated,0,8,3,5,0,0.6
remorseproof,1,12,5,7,0,0.714285714285714
phacoidal,1,9,4,5,0,0.8
hypnosporangia,1,14,5,9,0,0.555555555555556
rattletop,1,9,3,6,0,0.5
drolet,1,6,2,4,0,0.5
pepperies,0,9,4,5,0,0.8
teleano,0,7,4,3,0,1.33333333333333
superlenient,1,12,5,7,0,0.714285714285714
nissensohn,1,10,3,7,0,0.428571428571429
salurawms,0,9,3,6,0,0.5
unquick,1,7,3,4,0,0.75
torris,0,6,2,4,0,0.5
subarrhation,1,12,5,7,0,0.714285714285714
playlist,1,8,2,6,0,0.333333333333333
j'accuse,1,8,3,5,1,0.6
squaw,1,5,2,3,0,0.666666666666667
enrage,1,6,3,3,0,1
tsutsi,0,6,2,4,0,0.5
hydrolase,1,9,3,6,0,0.5
uncontemner,0,11,4,7,0,0.571428571428571
percoids,1,8,3,5,0,0.6
heteratomic,1,11,5,6,0,0.833333333333333
unsummerlike,1,12,5,7,0,0.714285714285714
minelayer,1,9,4,5,0,0.8
bashemath,1,9,3,6,0,0.5
hotoxicatabilitted,0,18,8,10,0,0.8
bagpuize,1,8,4,4,0,1
hirami,0,6,3,3,0,1
qz'jsmxjaamyvglnvhwm,0,20,2,18,1,0.111111111111111
catinass,0,8,3,5,0,0.6
nonament,0,8,3,5,0,0.6
yttria,1,6,2,4,0,0.5
temoplartomckes,0,15,5,10,0,0.5
gwvhges'jaiuwa,0,14,5,9,1,0.555555555555556
chomens,0,7,2,5,0,0.4
pericline,1,9,4,5,0,0.8
saffier,1,7,3,4,0,0.75
unbroking,0,9,3,6,0,0.5
ununanimously,1,13,6,7,0,0.857142857142857
perisers,0,8,3,5,0,0.6
purgations,1,10,4,6,0,0.666666666666667
superwise,1,9,4,5,0,0.8
antilethargising,0,16,6,10,0,0.6
hallucinogens,1,13,5,8,0,0.625
origenism,1,9,4,5,0,0.8
kremlinologic,0,13,5,8,0,0.625
bakersfield,1,11,4,7,0,0.571428571428571
brudesation,0,11,5,6,0,0.833333333333333
meifopealabengholine,0,20,10,10,0,1
uricae,0,6,4,2,0,2
pattable,1,8,3,5,0,0.6
groundabout,0,11,5,6,0,0.833333333333333
homwbquufrwb',0,13,3,10,1,0.3
sootied,1,7,4,3,0,1.33333333333333
watercourse,1,11,5,6,0,0.833333333333333
retiolizzurolvulphebraders,0,26,10,16,0,0.625
kgnuccfmgwcc,0,12,1,11,0,0.0909090909090909
nondegrette,0,11,4,7,0,0.571428571428571
hyssopus,1,8,2,6,0,0.333333333333333
cajoles,1,7,3,4,0,0.75
zeguessness,0,11,4,7,0,0.571428571428571
kubergs,0,7,2,5,0,0.4
rayonisms,1,9,3,6,0,0.5
incrustations,1,13,5,8,0,0.625
multiliness,0,11,4,7,0,0.571428571428571
acantasted,0,10,4,6,0,0.666666666666667
nydsgamsfrk,0,11,1,10,0,0.1
armpeniestemes,0,14,6,8,0,0.75
ziqwkimmdynycbbajngoocesj,0,25,6,19,0,0.315789473684211
boers,1,5,2,3,0,0.666666666666667
groundmass,1,10,3,7,0,0.428571428571429
tussar,1,6,2,4,0,0.5
dabes,0,5,2,3,0,0.666666666666667
elucianist,0,10,5,5,0,1
lunateds,1,8,3,5,0,0.6
microts,0,7,2,5,0,0.4
kale,1,4,2,2,0,1
tiro,1,4,2,2,0,1
perissodactyla,1,14,5,9,0,0.555555555555556
diger,0,5,2,3,0,0.666666666666667
hyperexcitator,0,14,5,9,0,0.555555555555556
nwced'nzgrokqrvivblx',0,21,3,18,2,0.166666666666667
pazice,1,6,3,3,0,1
sniernion,0,9,4,5,0,0.8
pathary,0,7,2,5,0,0.4
ksxvezv'dbgcgvxrnes''nfliqgqzu,0,30,4,26,3,0.153846153846154
boheatimplans,0,13,5,8,0,0.625
unsyphobarbitura,0,16,6,10,0,0.6
uwfb,0,4,1,3,0,0.333333333333333
ostrya,1,6,2,4,0,0.5
lumpsuckers,1,11,3,8,0,0.375
attalla,1,7,3,4,0,0.75
doomingness,0,11,4,7,0,0.571428571428571
stovall,1,7,2,5,0,0.4
underactors,1,11,4,7,0,0.571428571428571
sigmoidoproctous,0,16,7,9,0,0.777777777777778
ld'ibzend,0,9,2,7,1,0.285714285714286
istomenonstrelatoloparrew,0,25,10,15,0,0.666666666666667
gunki,0,5,2,3,0,0.666666666666667
rolypolines,0,11,4,7,0,0.571428571428571
trencherwoman,1,13,4,9,0,0.444444444444444
paraaminobenzoic,1,16,8,8,0,1
alipomans,0,9,4,5,0,0.8
sleekiest,1,9,4,5,0,0.8
abscugged,0,9,3,6,0,0.5
vetiveriaceae,0,13,8,5,0,1.6
phytogeographer,1,15,5,10,0,0.5
elfkin,1,6,2,4,0,0.5
oppressor,1,9,3,6,0,0.5
illimitable,1,11,5,6,0,0.833333333333333
sextetrocycles,0,14,4,10,0,0.4
conjunct,1,8,2,6,0,0.333333333333333
expecter,1,8,3,5,0,0.6
gormandie,0,9,4,5,0,0.8
abstaneous,0,10,5,5,0,1
fdqlczmuzndpoakiadpackdyhxw,0,27,6,21,0,0.285714285714286
erignathus,1,10,4,6,0,0.666666666666667
cadgies,0,7,3,4,0,0.75
wgsdr,0,5,0,5,0,0
alenconcomendyescs,0,18,6,12,0,0.5
sy'xvoo'gkbfa,0,13,3,10,2,0.3
maisie,1,6,4,2,0,2
symbolicalnesses,1,16,5,11,0,0.454545454545455
ioykotnx'qggskk,0,15,3,12,1,0.25
protoascales,1,12,5,7,0,0.714285714285714
nephwinsexiusehipisslereptae,0,28,12,16,0,0.75
steid,1,5,2,3,0,0.666666666666667
dishful,1,7,2,5,0,0.4
traryba,0,7,2,5,0,0.4
zzobrifrit,0,10,3,7,0,0.428571428571429
noah,1,4,2,2,0,1
arnosaurid,0,10,5,5,0,1
mystify,1,7,1,6,0,0.166666666666667
ih'bbqfsieeflvefnmqdgeawvowb,0,28,8,20,1,0.4
adlay,1,5,2,3,0,0.666666666666667
nonpubli,0,8,3,5,0,0.6
repton,1,6,2,4,0,0.5
cocreassus,0,10,4,6,0,0.666666666666667
immantiminal,0,12,5,7,0,0.714285714285714
novachord,1,9,3,6,0,0.5
subinfluence,0,12,5,7,0,0.714285714285714
kcuzqcgvpnzzkeipooxy'xmsg,0,25,5,20,1,0.25
absolutest,1,10,4,6,0,0.666666666666667
addling,1,7,2,5,0,0.4
vhdvenyodxukfqdjpmeaaga,0,23,7,16,0,0.4375
urnursearrests,0,14,5,9,0,0.555555555555556
fucama,0,6,3,3,0,1
headstall,1,9,3,6,0,0.5
xtel'fmsdtnt''moguqanbt,0,23,4,19,3,0.210526315789474
fabiolas,1,8,4,4,0,1
traditions,1,10,4,6,0,0.666666666666667
desalinated,1,11,5,6,0,0.833333333333333
fluitzstroster,0,14,4,10,0,0.4
premunitions,1,12,5,7,0,0.714285714285714
ulpatiy'xrf'aswl,0,16,4,12,2,0.333333333333333
shawwal,1,7,2,5,0,0.4
ungritty,1,8,2,6,0,0.333333333333333
eted,0,4,2,2,0,1
electivelterywoodchoid,0,22,9,13,0,0.692307692307692
spanglish,1,9,2,7,0,0.285714285714286
brightendist,0,12,3,9,0,0.333333333333333
danted,1,6,2,4,0,0.5
metaphorically,1,14,5,9,0,0.555555555555556
jingleaf,0,8,3,5,0,0.6
uptic,0,5,2,3,0,0.666666666666667
partitible,0,10,4,6,0,0.666666666666667
coaxal,1,6,3,3,0,1
fringer,0,7,2,5,0,0.4
demutualisation,1,15,8,7,0,1.14285714285714
cerde,0,5,2,3,0,0.666666666666667
strombus,1,8,2,6,0,0.333333333333333
deadener,1,8,4,4,0,1
axatuntiech,0,11,5,6,0,0.833333333333333
heraseable,0,10,5,5,0,1
fumblers,1,8,2,6,0,0.333333333333333
wreadatationsulators,0,20,9,11,0,0.818181818181818
esperador,0,9,4,5,0,0.8
thondracians,1,12,4,8,0,0.5
bokoto,1,6,3,3,0,1
sorees,1,6,3,3,0,1
boolean,1,7,4,3,0,1.33333333333333
solays,0,6,2,4,0,0.5
wakhottelene,0,12,5,7,0,0.714285714285714
tellies,1,7,3,4,0,0.75
unwearily,1,9,4,5,0,0.8
francophile,1,11,4,7,0,0.571428571428571
pald,0,4,1,3,0,0.333333333333333
leifer,1,6,3,3,0,1
rosamund,1,8,3,5,0,0.6
hispanick,0,9,3,6,0,0.5
spcc,1,4,0,4,0,0
polemicising,1,12,5,7,0,0.714285714285714
defragatory,0,11,4,7,0,0.571428571428571
agenea,0,6,4,2,0,2
sipple,1,6,2,4,0,0.5
bailees,1,7,4,3,0,1.33333333333333
sity,0,4,1,3,0,0.333333333333333
phenobarbitol,1,13,5,8,0,0.625
alathia,1,7,4,3,0,1.33333333333333
scedules,1,8,3,5,0,0.6
periqunkanedrrios,0,17,7,10,0,0.7
armarium,1,8,4,4,0,1
counterplay,1,11,4,7,0,0.571428571428571
stravinsky,1,10,2,8,0,0.25
xvnortqecqkoxvbqdjycezihn,0,25,5,20,0,0.25
pinpricks,1,9,2,7,0,0.285714285714286
convexly,1,8,2,6,0,0.333333333333333
surrejoinder,1,12,5,7,0,0.714285714285714
unclearable,1,11,5,6,0,0.833333333333333
rearranging,1,11,4,7,0,0.571428571428571
clogthemoes,0,11,4,7,0,0.571428571428571
phylqcunkqqawyt,0,15,2,13,0,0.153846153846154
'ewnibpv'inilvczonvdz,0,21,5,16,2,0.3125
chargeless,1,10,3,7,0,0.428571428571429
prologos,1,8,3,5,0,0.6
cindaetal,0,9,4,5,0,0.8
bqjqtcmz''iqg,0,13,1,12,2,0.0833333333333333
riverbank,1,9,3,6,0,0.5
chrysomelidae,1,13,5,8,0,0.625
nissanderworkmatematognathisi,0,29,11,18,0,0.611111111111111
coryphaenoididae,1,16,8,8,0,1
sdezon,0,6,2,4,0,0.5
impingence,1,10,4,6,0,0.666666666666667
philhymnist,0,11,2,9,0,0.222222222222222
flutter,1,7,2,5,0,0.4
ec,1,2,1,1,0,1
sdra,0,4,1,3,0,0.333333333333333
mintmark,1,8,2,6,0,0.333333333333333
ornate,1,6,3,3,0,1
exply,0,5,1,4,0,0.25
compiled,1,8,3,5,0,0.6
californium,1,11,5,6,0,0.833333333333333
rement,0,6,2,4,0,0.5
deltic,1,6,2,4,0,0.5
nologiliticiping,0,16,7,9,0,0.777777777777778
thyreocoridae,1,13,6,7,0,0.857142857142857
al'pbcofjisou,0,13,5,8,1,0.625
plummetless,1,11,3,8,0,0.375
parasyntheta,1,12,4,8,0,0.5
nerg,0,4,1,3,0,0.333333333333333
neill,1,5,2,3,0,0.666666666666667
restyling,1,9,2,7,0,0.285714285714286
wcdszizzzi,0,10,2,8,0,0.25
warrob,0,6,2,4,0,0.5
hyperorthognathous,1,18,6,12,0,0.5
vgi,1,3,1,2,0,0.5
aphthalmists,0,12,3,9,0,0.333333333333333
muharrum,1,8,3,5,0,0.6
dictyoxylon,1,11,3,8,0,0.375
cke,0,3,1,2,0,0.5
pet,1,3,1,2,0,0.5
toluate,1,7,4,3,0,1.33333333333333
mikan,1,5,2,3,0,0.666666666666667
baiel,1,5,3,2,0,1.5
bhisti,1,6,2,4,0,0.5
converturbings,0,14,4,10,0,0.4
relocable,1,9,4,5,0,0.8
isoantimonarda,0,14,7,7,0,1
unerotically,0,12,5,7,0,0.714285714285714
impoo,0,5,3,2,0,1.5
lustily,1,7,2,5,0,0.4
undeclarable,1,12,5,7,0,0.714285714285714
myrmica,1,7,2,5,0,0.4
kyl,1,3,0,3,0,0
barbadoes,1,9,4,5,0,0.8
calf,1,4,1,3,0,0.333333333333333
kelvespolotong,0,14,5,9,0,0.555555555555556
minon,0,5,2,3,0,0.666666666666667
msm,1,3,0,3,0,0
cognisance,1,10,4,6,0,0.666666666666667
uncouching,1,10,4,6,0,0.666666666666667
ascosporic,1,10,4,6,0,0.666666666666667
solebury,1,8,3,5,0,0.6
undnessemianian,0,15,7,8,0,0.875
eeogolmxpvzs,0,12,4,8,0,0.5
recurrently,1,11,3,8,0,0.375
modifiabilities,1,15,8,7,0,1.14285714285714
corrodier,1,9,4,5,0,0.8
jacobite,1,8,4,4,0,1
jussive,1,7,3,4,0,0.75
terridae,0,8,4,4,0,1
cornhamidinitionics,0,19,8,11,0,0.727272727272727
arecibo,1,7,4,3,0,1.33333333333333
superheterophyll,0,16,5,11,0,0.454545454545455
collos,0,6,2,4,0,0.5
debruised,1,9,4,5,0,0.8
superwife,1,9,4,5,0,0.8
severe,1,6,3,3,0,1
bletherings,1,11,3,8,0,0.375
piiollonedbotirke,0,17,8,9,0,0.888888888888889
imago,1,5,3,2,0,1.5
howtowdies,1,10,4,6,0,0.666666666666667
haliographer,1,12,5,7,0,0.714285714285714
sulphohaloid,1,12,5,7,0,0.714285714285714
coercively,1,10,4,6,0,0.666666666666667
sewerless,1,9,3,6,0,0.5
nurnberg,1,8,2,6,0,0.333333333333333
baaskap,1,7,3,4,0,0.75
tomolo,1,6,3,3,0,1
loreless,1,8,3,5,0,0.6
onlalululpaxcogitinty,0,21,8,13,0,0.615384615384615
ujnebiav,0,8,4,4,0,1
fetidoniltfles,0,14,5,9,0,0.555555555555556
unordinary,1,10,4,6,0,0.666666666666667
dehydraters,1,11,3,8,0,0.375
defeater,1,8,4,4,0,1
thievery,1,8,3,5,0,0.6
apg,1,3,1,2,0,0.5
catiline,1,8,4,4,0,1
spigot,1,6,2,4,0,0.5
inquinating,1,11,5,6,0,0.833333333333333
forastorigges,0,13,5,8,0,0.625
sternages,1,9,3,6,0,0.5
xffbfpuatjpnofjhwwjfrhc'fp,0,26,3,23,1,0.130434782608696
dhjn,0,4,0,4,0,0
superball,1,9,3,6,0,0.5
phedenhan,0,9,3,6,0,0.5
et,0,2,1,1,0,1
ze,0,2,1,1,0,1
productivenesses,1,16,6,10,0,0.6
meleagrinae,1,11,6,5,0,1.2
wawls,1,5,1,4,0,0.25
salivations,1,11,5,6,0,0.833333333333333
ayve'xyk,0,8,2,6,1,0.333333333333333
tamaria,0,7,4,3,0,1.33333333333333
amphichrom,1,10,3,7,0,0.428571428571429
subblenessly,0,12,3,9,0,0.333333333333333
pcgunwfytkvngr''mre'n,0,21,2,19,3,0.105263157894737
meingoldas,1,10,4,6,0,0.666666666666667
squassation,0,11,5,6,0,0.833333333333333
miniconvexed,0,12,5,7,0,0.714285714285714
necessarion,0,11,5,6,0,0.833333333333333
concactenated,1,13,5,8,0,0.625
jfiib'cmnpywxzjjsyueuzpu'br,0,27,6,21,2,0.285714285714286
countual,0,8,4,4,0,1
shirtless,1,9,2,7,0,0.285714285714286
mingenlin,0,9,3,6,0,0.5
magsaysay,1,9,3,6,0,0.5
pithecanthropidae,1,17,7,10,0,0.7
bolingbrook,0,11,4,7,0,0.571428571428571
antipramine,0,11,5,6,0,0.833333333333333
negotiates,1,10,5,5,0,1
tutors,1,6,2,4,0,0.5
jermain,1,7,3,4,0,0.75
skaddle,1,7,2,5,0,0.4
cozeness,0,8,3,5,0,0.6
superfamiliarity,0,16,7,9,0,0.777777777777778
triviality,1,10,4,6,0,0.666666666666667
mard,0,4,1,3,0,0.333333333333333
cacus,1,5,2,3,0,0.666666666666667
lienotoxin,1,10,5,5,0,1
poth,1,4,1,3,0,0.333333333333333
unsuspiciousness,1,16,7,9,0,0.777777777777778
defibrillative,1,14,6,8,0,0.75
ofurystledgrtropla,0,18,5,13,0,0.384615384615385
unreciprocalistidae,0,19,9,10,0,0.9
isoscopia,0,9,5,4,0,1.25
dragging,1,8,2,6,0,0.333333333333333
iosyz,0,5,2,3,0,0.666666666666667
superver,0,8,3,5,0,0.6
yrekantness,0,11,3,8,0,0.375
marionettes,1,11,5,6,0,0.833333333333333
retiparivoreswax,0,16,7,9,0,0.777777777777778
chartless,1,9,2,7,0,0.285714285714286
whelming,1,8,2,6,0,0.333333333333333
tinc,1,4,1,3,0,0.333333333333333
begunin,0,7,3,4,0,0.75
pseudocoelomate,1,15,8,7,0,1.14285714285714
pseudotto,0,9,4,5,0,0.8
'eypvkitfbjheicdimczclhv,0,24,5,19,1,0.263157894736842
ultrasensitive,1,14,6,8,0,0.75
solvent,1,7,2,5,0,0.4
loming,1,6,2,4,0,0.5
kamerman,1,8,3,5,0,0.6
pauli,1,5,3,2,0,1.5
caud,0,4,2,2,0,1
damnonians,1,10,4,6,0,0.666666666666667
saladang,1,8,3,5,0,0.6
waney,1,5,2,3,0,0.666666666666667
fireside,1,8,4,4,0,1
reesville,1,9,4,5,0,0.8
synaesthetic,1,12,4,8,0,0.5
legically,0,9,3,6,0,0.5
godaureroliarritisionge,0,23,12,11,0,1.09090909090909
herize,0,6,3,3,0,1
tonsi,0,5,2,3,0,0.666666666666667
algonian,0,8,4,4,0,1
snorcertise,0,11,4,7,0,0.571428571428571
obang,1,5,2,3,0,0.666666666666667
fermentability,1,14,5,9,0,0.555555555555556
kaposi,1,6,3,3,0,1
bonbon,1,6,2,4,0,0.5
fhtbcbve,0,8,1,7,0,0.142857142857143
pummice,1,7,3,4,0,0.75
excus,0,5,2,3,0,0.666666666666667
dipodomyinae,1,12,6,6,0,1
heliotypically,1,14,5,9,0,0.555555555555556
k'ltfmiiwmijqlucotns,0,20,5,15,1,0.333333333333333
nbe,1,3,1,2,0,0.5
procks,0,6,1,5,0,0.2
chromat,0,7,2,5,0,0.4
oscilloscopic,1,13,5,8,0,0.625
qgrwgevusjzj,0,12,2,10,0,0.2
hyqijjezkinycngaj,0,17,4,13,0,0.307692307692308
monadheadedly,0,13,5,8,0,0.625
'iqlakbawmw,0,11,3,8,1,0.375
visibilities,1,12,6,6,0,1
holotrich,1,9,3,6,0,0.5
rearise,1,7,4,3,0,1.33333333333333
sawtimber,1,9,3,6,0,0.5
hassocky,1,8,2,6,0,0.333333333333333
rushee,1,6,3,3,0,1
kolus,0,5,2,3,0,0.666666666666667
trochaic,1,8,3,5,0,0.6
parotis,1,7,3,4,0,0.75
extravagated,1,12,5,7,0,0.714285714285714
kewhicassac,0,11,4,7,0,0.571428571428571
phymatorhysin,1,13,3,10,0,0.3
plermircum,0,10,3,7,0,0.428571428571429
oreshoot,1,8,4,4,0,1
ohkiijzobp'mwoiulgx'a,0,21,8,13,2,0.615384615384615
heterogge,0,9,4,5,0,0.8
lark,1,4,1,3,0,0.333333333333333
outscorporanites,0,16,7,9,0,0.777777777777778
polack,1,6,2,4,0,0.5
plath,1,5,1,4,0,0.25
gradine,1,7,3,4,0,0.75
pyritohedra,1,11,4,7,0,0.571428571428571
vaticanical,1,11,5,6,0,0.833333333333333
castigatories,1,13,6,7,0,0.857142857142857
sporogonial,1,11,5,6,0,0.833333333333333
pseudoliberally,1,15,6,9,0,0.666666666666667
preportadelloisbody,0,19,7,12,0,0.583333333333333
loadeoff,0,8,4,4,0,1
collocation,1,11,5,6,0,0.833333333333333
ostensorium,1,11,5,6,0,0.833333333333333
distantly,1,9,2,7,0,0.285714285714286
osteometrical,1,13,6,7,0,0.857142857142857
leukotomes,1,10,5,5,0,1
legius,0,6,3,3,0,1
carnival,1,8,3,5,0,0.6
oreodontidae,1,12,7,5,0,1.4
trisyllable,1,11,3,8,0,0.375
duplicidentata,1,14,6,8,0,0.75
patied,0,6,3,3,0,1
nonoily,1,7,3,4,0,0.75
beaverinductioniser,0,19,9,10,0,0.9
duvet,1,5,2,3,0,0.666666666666667
chimneypieces,1,13,5,8,0,0.625
paragonite,1,10,5,5,0,1
oulinis,0,7,4,3,0,1.33333333333333
pokomo,1,6,3,3,0,1
rideirismintrogres,0,18,7,11,0,0.636363636363636
onomatopoeically,1,16,8,8,0,1
gfnflsxnzkeigve'cpib,0,20,4,16,1,0.25
dreyfusard,1,10,3,7,0,0.428571428571429
cqrr,0,4,0,4,0,0
punizatids,0,10,4,6,0,0.666666666666667
rubbet,1,6,2,4,0,0.5
oilfields,1,9,4,5,0,0.8
prosmodjackling,0,15,4,11,0,0.363636363636364
icclichr,0,8,2,6,0,0.333333333333333
lillionica,0,10,5,5,0,1
temonglike,0,10,4,6,0,0.666666666666667
oversum,1,7,3,4,0,0.75
'fhvgftluacebdmdyseug,0,21,5,16,1,0.3125
protometallic,1,13,5,8,0,0.625
ceramium,1,8,4,4,0,1
omezk,0,5,2,3,0,0.666666666666667
alime,0,5,3,2,0,1.5
blashiest,1,9,3,6,0,0.5
libia,1,5,3,2,0,1.5
phificoriversox,0,15,6,9,0,0.666666666666667
symmetrisation,1,14,5,9,0,0.555555555555556
barrone,0,7,3,4,0,0.75
oute,0,4,3,1,0,3
caloyers,1,8,3,5,0,0.6
tableaux,1,8,4,4,0,1
skry,1,4,0,4,0,0
unsubstings,0,11,3,8,0,0.375
anticritically,1,14,5,9,0,0.555555555555556
lessen,1,6,2,4,0,0.5
springtrap,1,10,2,8,0,0.25
alyssum,1,7,2,5,0,0.4
chickenshit,1,11,3,8,0,0.375
untough,1,7,3,4,0,0.75
pushbird,0,8,2,6,0,0.333333333333333
volumise,1,8,4,4,0,1
donidananeptopuralespet,0,23,10,13,0,0.769230769230769
attainera,0,9,5,4,0,1.25
barotseland,1,11,4,7,0,0.571428571428571
ichthyornithoid,1,15,5,10,0,0.5
trypanum,0,8,2,6,0,0.333333333333333
ariaciform,0,10,5,5,0,1
leazes,1,6,3,3,0,1
ludibry,1,7,2,5,0,0.4
unbefringeflowerinesses,0,23,9,14,0,0.642857142857143
symphodel,0,9,2,7,0,0.285714285714286
ogliads,0,7,3,4,0,0.75
dispossessional,0,15,6,9,0,0.666666666666667
nrhmxyvdtwafp'wpa,0,17,2,15,1,0.133333333333333
chromolithiasis,0,15,6,9,0,0.666666666666667
taliacotian,1,11,6,5,0,1.2
saker,1,5,2,3,0,0.666666666666667
latirostres,1,11,4,7,0,0.571428571428571
oedkgm,0,6,2,4,0,0.5
saltants,1,8,2,6,0,0.333333333333333
monite,0,6,3,3,0,1
maniford,0,8,3,5,0,0.6
calicos,1,7,3,4,0,0.75
starned,1,7,2,5,0,0.4
mariatiemoues,0,13,8,5,0,1.6
afcwtic,0,7,2,5,0,0.4
carcherrightmen,0,15,4,11,0,0.363636363636364
brosistorbote,0,13,5,8,0,0.625
bec,0,3,1,2,0,0.5
vinetta,1,7,3,4,0,0.75
pslfnck,0,7,0,7,0,0
alectrionidae,1,13,7,6,0,1.16666666666667
emulation,1,9,5,4,0,1.25
clnxpcvbhfru,0,12,1,11,0,0.0909090909090909
minervic,1,8,3,5,0,0.6
remus,1,5,2,3,0,0.666666666666667
barthia,0,7,3,4,0,0.75
quarterspace,1,12,5,7,0,0.714285714285714
visiting,1,8,3,5,0,0.6
damnability,1,11,4,7,0,0.571428571428571
strippable,1,10,3,7,0,0.428571428571429
leucherin,0,9,4,5,0,0.8
threadvowsan,0,12,4,8,0,0.5
metch,0,5,1,4,0,0.25
casoness,0,8,3,5,0,0.6
pronarched,0,10,3,7,0,0.428571428571429
conturbations,0,13,5,8,0,0.625
glanville,1,9,3,6,0,0.5
otfgyivbazu,0,11,4,7,0,0.571428571428571
refreshener,1,11,4,7,0,0.571428571428571
tarlipitonicellegism,0,20,8,12,0,0.666666666666667
burnham,1,7,2,5,0,0.4
caren,1,5,2,3,0,0.666666666666667
agasiotheousthevorite,0,21,11,10,0,1.1
tatariales,0,10,5,5,0,1
renex,0,5,2,3,0,0.666666666666667
wzqhhm'n'x'trfwi,0,16,1,15,3,0.0666666666666667
gamblyman,0,9,2,7,0,0.285714285714286
aerodynamicist,1,14,6,8,0,0.75
arcena,0,6,3,3,0,1
troutiest,1,9,4,5,0,0.8
olnay,1,5,2,3,0,0.666666666666667
chet,1,4,1,3,0,0.333333333333333
stoncthanetepr,0,14,4,10,0,0.4
kalumpangweulu,0,14,6,8,0,0.75
apharition,0,10,5,5,0,1
matriculate,1,11,5,6,0,0.833333333333333
ratche,0,6,2,4,0,0.5
punily,1,6,2,4,0,0.5
cubicula,1,8,4,4,0,1
opiners,1,7,3,4,0,0.75
monocondylar,1,12,4,8,0,0.5
gatunfra,0,8,3,5,0,0.6
zanyisms,1,8,2,6,0,0.333333333333333
riette,0,6,3,3,0,1
walterboro,1,10,4,6,0,0.666666666666667
gason,0,5,2,3,0,0.666666666666667
kanqzpoagvvsgna'xzspkie,0,23,6,17,1,0.352941176470588
aeronometrisation,0,17,9,8,0,1.125
bdsits,0,6,1,5,0,0.2
merseburg,1,9,3,6,0,0.5
interjack,0,9,3,6,0,0.5
associationism,1,14,7,7,0,1
unloweata,0,9,5,4,0,1.25
seorkmhzhnx,0,11,2,9,0,0.222222222222222
pactivize,0,9,4,5,0,0.8
nindowa,0,7,3,4,0,0.75
archaeoastrologies,0,18,9,9,0,1
deminesulluxurvargs,0,19,7,12,0,0.583333333333333
ecqlpfs'uhpyvuokbhuzh,0,21,5,16,1,0.3125
iophuss,0,7,3,4,0,0.75
nonsciolins,0,11,4,7,0,0.571428571428571
effigiated,1,10,5,5,0,1
d'xlqvwqwdkx'xrjzemwv,0,21,1,20,2,0.05
quadrum,1,7,3,4,0,0.75
cafulamostatarerrherymedang,0,27,10,17,0,0.588235294117647
ywfpzo,0,6,1,5,0,0.2
achlorhydric,1,12,3,9,0,0.333333333333333
eavabellonader,0,14,7,7,0,1
qasion,0,6,3,3,0,1
latched,1,7,2,5,0,0.4
anesses,0,7,3,4,0,0.75
jerenshanteregantan,0,19,7,12,0,0.583333333333333
aomgbyjg,0,8,2,6,0,0.333333333333333
rhizopheny,0,10,3,7,0,0.428571428571429
homing,1,6,2,4,0,0.5
apologer,1,8,4,4,0,1
jamesonite,1,10,5,5,0,1
bringenmonapstabiandstitietagroffloglainwom,0,43,16,27,0,0.592592592592593
pentameran,1,10,4,6,0,0.666666666666667
tungus,1,6,2,4,0,0.5
ebullo,0,6,3,3,0,1
whaizle,1,7,3,4,0,0.75
aiken,1,5,3,2,0,1.5
unbouniabbendswalbus,0,20,8,12,0,0.666666666666667
mpu'dxhizswww,0,13,2,11,1,0.181818181818182
shipowner,1,9,3,6,0,0.5
smartweeds,1,10,3,7,0,0.428571428571429
reoils,1,6,3,3,0,1
abuttal,1,7,3,4,0,0.75
wwpk,0,4,0,4,0,0
ajivika,1,7,4,3,0,1.33333333333333
intestiniform,1,13,5,8,0,0.625
caverney,0,8,3,5,0,0.6
podophyllin,1,11,3,8,0,0.375
idsmicar,0,8,3,5,0,0.6
natassia,1,8,4,4,0,1
pilfre,1,6,2,4,0,0.5
bobbin,1,6,2,4,0,0.5
disturber,1,9,3,6,0,0.5
roguerie,0,8,5,3,0,1.66666666666667
amustridarrucinessa,0,19,8,11,0,0.727272727272727
forbarred,1,9,3,6,0,0.5
musnudgers,0,10,3,7,0,0.428571428571429
ratexpencequixicathaymandubirriessubs,0,37,15,22,0,0.681818181818182
aureated,0,8,5,3,0,1.66666666666667
coactility,0,10,4,6,0,0.666666666666667
pantographies,1,13,5,8,0,0.625
brandonville,1,12,4,8,0,0.5
mammonteus,1,10,4,6,0,0.666666666666667
postdrug,1,8,2,6,0,0.333333333333333
ptitatodoncheren,0,16,6,10,0,0.6
limnograher,0,11,4,7,0,0.571428571428571
xthgtvlaxugnfsjxlqdjxwtg,0,24,2,22,0,0.0909090909090909
timpsons,0,8,2,6,0,0.333333333333333
unauthorise,1,11,6,5,0,1.2
heptadecyl,1,10,3,7,0,0.428571428571429
interphobia,0,11,5,6,0,0.833333333333333
typist,1,6,1,5,0,0.2
danica,1,6,3,3,0,1
rabbinistic,1,11,4,7,0,0.571428571428571
phosphatise,1,11,4,7,0,0.571428571428571
scalesmith,1,10,3,7,0,0.428571428571429
stagnation,1,10,4,6,0,0.666666666666667
threskiornithidae,1,17,7,10,0,0.7
unshrinee,0,9,4,5,0,0.8
zaconerag,0,9,4,5,0,0.8
oneaclendognon,0,14,6,8,0,0.75
todevvy,0,7,2,5,0,0.4
rosenbaum,1,9,4,5,0,0.8
squattered,1,10,4,6,0,0.666666666666667
sinisitrilinerere,0,17,8,9,0,0.888888888888889
tatoos,1,6,3,3,0,1
aride,0,5,3,2,0,1.5
cald,0,4,1,3,0,0.333333333333333
epize,0,5,3,2,0,1.5
messor,1,6,2,4,0,0.5
tellegists,0,10,3,7,0,0.428571428571429
srama,0,5,2,3,0,0.666666666666667
glands,1,6,1,5,0,0.2
elfheim,0,7,3,4,0,0.75
spartanly,1,9,2,7,0,0.285714285714286
uncleansed,1,10,4,6,0,0.666666666666667
pyla,0,4,1,3,0,0.333333333333333
lus,0,3,1,2,0,0.5
rannactiocaliselamap,0,20,9,11,0,0.818181818181818
sargassos,1,9,3,6,0,0.5
puttin,0,6,2,4,0,0.5
ykigystinrlhh,0,13,2,11,0,0.181818181818182
pilchard,1,8,2,6,0,0.333333333333333
swearedness,0,11,4,7,0,0.571428571428571
dispaint,1,8,3,5,0,0.6
dagu,1,4,2,2,0,1
proprietory,1,11,4,7,0,0.571428571428571
panabling,0,9,3,6,0,0.5
exoga,0,5,3,2,0,1.5
forkland,1,8,2,6,0,0.333333333333333
repristinate,1,12,5,7,0,0.714285714285714
wn,0,2,0,2,0,0
portions,1,8,3,5,0,0.6
nonprocedurally,1,15,5,10,0,0.5
countermen,1,10,4,6,0,0.666666666666667
cuttleman,0,9,3,6,0,0.5
subsidiarinesses,1,16,7,9,0,0.777777777777778
carotaterlo,0,11,5,6,0,0.833333333333333
oreretepilerecotls,0,18,8,10,0,0.8
pointmen,1,8,3,5,0,0.6
phosphorolysis,1,14,4,10,0,0.4
luehrman,0,8,3,5,0,0.6
kalimba,1,7,3,4,0,0.75
excurvated,1,10,4,6,0,0.666666666666667
astally,0,7,2,5,0,0.4
medinalidias,0,12,6,6,0,1
kerittall,0,9,3,6,0,0.5
dolomites,1,9,4,5,0,0.8
piaropus,1,8,4,4,0,1
monticuli,0,9,4,5,0,0.8
dephitivers,0,11,4,7,0,0.571428571428571
simonal,0,7,3,4,0,0.75
dynaming,0,8,2,6,0,0.333333333333333
paraengineery,0,13,6,7,0,0.857142857142857
migmatite,1,9,4,5,0,0.8
sunrisings,1,10,3,7,0,0.428571428571429
provenient,1,10,4,6,0,0.666666666666667
exophthalmos,1,12,4,8,0,0.5
tpeizlcgtch'lcqr,0,16,2,14,1,0.142857142857143
bilgeways,0,9,3,6,0,0.5
vsnwcqpcbam,0,11,1,10,0,0.1
archimorphic,1,12,4,8,0,0.5
stephensburg,1,12,3,9,0,0.333333333333333
ashvillidesrooteronsucted,0,25,10,15,0,0.666666666666667
omnifacimentedness,0,18,7,11,0,0.636363636363636
scarchbism,0,10,2,8,0,0.25
bee,1,3,2,1,0,2
jyyjcxzyehf,0,11,1,10,0,0.1
cardione,0,8,4,4,0,1
papaio,1,6,4,2,0,2
cheluviation,0,12,6,6,0,1
synarding,0,9,2,7,0,0.285714285714286
dichoantiphophopal,0,18,7,11,0,0.636363636363636
baldie,1,6,3,3,0,1
salwauw,0,7,3,4,0,0.75
arminian,1,8,4,4,0,1
echewshoraise,0,13,6,7,0,0.857142857142857
myroxylon,1,9,2,7,0,0.285714285714286
kuqkrkvrnpwjtqawalplychak,0,25,4,21,0,0.19047619047619
ureterveny,0,10,4,6,0,0.666666666666667
solidarity,1,10,4,6,0,0.666666666666667
recollectivistically,0,20,7,13,0,0.538461538461538
appressorium,1,12,5,7,0,0.714285714285714
fowloumon,0,9,4,5,0,0.8
skylarkings,1,11,2,9,0,0.222222222222222
bie,0,3,2,1,0,2
beprisatters,0,12,4,8,0,0.5
misappendance,0,13,5,8,0,0.625
esifeert,0,8,4,4,0,1
conpakeling,0,11,4,7,0,0.571428571428571
nonmaturity,1,11,4,7,0,0.571428571428571
palatoscopic,0,12,5,7,0,0.714285714285714
pluvialis,1,9,4,5,0,0.8
slighty,1,7,1,6,0,0.166666666666667
thermoperies,0,12,5,7,0,0.714285714285714
bowpin,1,6,2,4,0,0.5
poirvz,0,6,2,4,0,0.5
cubas,1,5,2,3,0,0.666666666666667
ke,0,2,1,1,0,1
gaslizzatat,0,11,4,7,0,0.571428571428571
mahoonalectarson,0,16,7,9,0,0.777777777777778
sceputs,0,7,2,5,0,0.4
physicianer,1,11,4,7,0,0.571428571428571
parthenogenous,1,14,6,8,0,0.75
backlandstuffe,0,14,4,10,0,0.4
pgalgnfrgksnzikdivfreoacq,0,25,6,19,0,0.315789473684211
remedite,0,8,4,4,0,1
ddrexxiort,0,10,3,7,0,0.428571428571429
automatidae,0,11,7,4,0,1.75
costen,1,6,2,4,0,0.5
ardthailolthamericha,0,20,8,12,0,0.666666666666667
subocuration,0,12,6,6,0,1
semisubmersible,1,15,6,9,0,0.666666666666667
plainchant,1,10,3,7,0,0.428571428571429
shmo,1,4,1,3,0,0.333333333333333
aterberly,0,9,3,6,0,0.5
dipa,0,4,2,2,0,1
femorange,0,9,4,5,0,0.8
monovalency,1,11,4,7,0,0.571428571428571
algregalse,0,10,4,6,0,0.666666666666667
henrigidae,0,10,5,5,0,1
hashum,1,6,2,4,0,0.5
traipsings,1,10,3,7,0,0.428571428571429
ignishes,0,8,3,5,0,0.6
lkmyfhfyijnpkcenn,0,17,2,15,0,0.133333333333333
graeus,0,6,3,3,0,1
quiescing,1,9,4,5,0,0.8
snippy,1,6,1,5,0,0.2
philosophicalness,1,17,6,11,0,0.545454545454545
refractometry,1,13,4,9,0,0.444444444444444
dromaeognathism,1,15,6,9,0,0.666666666666667
botvilers,0,9,3,6,0,0.5
nonfieldambooka,0,15,7,8,0,0.875
jeta,1,4,2,2,0,1
ugrwbleuprnzkeyrlsc,0,19,4,15,0,0.266666666666667
micotylomustbranctive,0,21,7,14,0,0.5
flyfish,1,7,1,6,0,0.166666666666667
winesops,1,8,3,5,0,0.6
bankits,1,7,2,5,0,0.4
dareece,1,7,4,3,0,1.33333333333333
ve,0,2,1,1,0,1
pseudotachometry,0,16,6,10,0,0.6
tritenesian,0,11,5,6,0,0.833333333333333
otheliast,0,9,4,5,0,0.8
nonresidential,1,14,6,8,0,0.75
pvdgiluhfkrngu'fgzjey'oly,0,25,5,20,2,0.25
gleda,1,5,2,3,0,0.666666666666667
nutritides,0,10,4,6,0,0.666666666666667
vxuvnphwwuttiantetn',0,20,5,15,1,0.333333333333333
downhaussuckie,0,14,6,8,0,0.75
colcelley,0,9,3,6,0,0.5
bioninqualve,0,12,6,6,0,1
amnia,1,5,3,2,0,1.5
cortfassufulplutic,0,18,6,12,0,0.5
xenophilias,1,11,5,6,0,0.833333333333333
tatin,1,5,2,3,0,0.666666666666667
omu'ocifhzzyc,0,13,4,9,1,0.444444444444444
colligatoriness,0,15,6,9,0,0.666666666666667
raipuriagakinsud,0,16,8,8,0,1
arrayan,1,7,3,4,0,0.75
chanths,0,7,1,6,0,0.166666666666667
bouncers,1,8,3,5,0,0.6
zermatt,1,7,2,5,0,0.4
amale,0,5,3,2,0,1.5
effrjxagzn,0,10,2,8,0,0.25
harpp,1,5,1,4,0,0.25
ecumene,1,7,4,3,0,1.33333333333333
hirobumi,1,8,4,4,0,1
preightilionate,0,15,7,8,0,0.875
leukaemogenes,0,13,7,6,0,1.16666666666667
hdqnajolsv'qtugiyxfbf,0,21,4,17,1,0.235294117647059
paneidency,0,10,4,6,0,0.666666666666667
nzvbhvmy'fucecnqxrfzhry,0,23,2,21,1,0.0952380952380952
moonally,0,8,3,5,0,0.6
intermelt,1,9,3,6,0,0.5
snicationism,0,12,5,7,0,0.714285714285714
bomengenetrainillively,0,22,9,13,0,0.692307692307692
serrancy,0,8,2,6,0,0.333333333333333
wawina,1,6,3,3,0,1
muezzin,1,7,3,4,0,0.75
myelencephala,1,13,5,8,0,0.625
copharternadationcaeart,0,23,10,13,0,0.769230769230769
cabiria,1,7,4,3,0,1.33333333333333
noney,0,5,2,3,0,0.666666666666667
zasgzgchadwrs,0,13,2,11,0,0.181818181818182
corinthianism,1,13,5,8,0,0.625
unpersuasible,1,13,6,7,0,0.857142857142857
tralirmaders,0,12,4,8,0,0.5
fishgig,1,7,2,5,0,0.4
vivaletuding,0,12,5,7,0,0.714285714285714
soundheartedness,1,16,6,10,0,0.6
succesive,1,9,4,5,0,0.8
contempestivity,0,15,5,10,0,0.5
marybeller,0,10,3,7,0,0.428571428571429
pripet,1,6,2,4,0,0.5
exrupeal,1,8,4,4,0,1
xeuzjlufinf'rfhnl'plijtwf,0,25,5,20,2,0.25
discanting,1,10,3,7,0,0.428571428571429
movableness,1,11,4,7,0,0.571428571428571
epigraphyll,0,11,3,8,0,0.375
suabejows,0,9,4,5,0,0.8
anaccounderiestation,0,20,10,10,0,1
zaptiah,1,7,3,4,0,0.75
mab,1,3,1,2,0,0.5
noncurative,1,11,5,6,0,0.833333333333333
merychippus,1,11,3,8,0,0.375
oys,1,3,1,2,0,0.5
adorns,1,6,2,4,0,0.5
jepmnbqr'dsk,0,12,1,11,1,0.0909090909090909
hegira,1,6,3,3,0,1
flambeed,1,8,3,5,0,0.6
undergeneral,1,12,5,7,0,0.714285714285714
savonburg,1,9,3,6,0,0.5
compositella,0,12,5,7,0,0.714285714285714
soligioid,0,9,5,4,0,1.25
thigmotropisms,1,14,4,10,0,0.4
represellschaft,0,15,4,11,0,0.363636363636364
tatripatione,0,12,6,6,0,1
dbxjq'auybposeebkhgzftt,0,23,5,18,1,0.277777777777778
bakersfield,1,11,4,7,0,0.571428571428571
trustification,1,14,6,8,0,0.75
polepsialsisssinglioces,0,23,9,14,0,0.642857142857143
delphina,1,8,3,5,0,0.6
ererbeerepokeragearus,0,21,11,10,0,1.1
bacardiographic,0,15,6,9,0,0.666666666666667
canophobia,1,10,5,5,0,1
ensigns,1,7,2,5,0,0.4
lecideaceous,1,12,7,5,0,1.4
rippa,0,5,2,3,0,0.666666666666667
opisthotonus,1,12,5,7,0,0.714285714285714
praehallux,1,10,4,6,0,0.666666666666667
fawkes,1,6,2,4,0,0.5
upele,0,5,3,2,0,1.5
misknowledges,1,13,4,9,0,0.444444444444444
quemado,1,7,4,3,0,1.33333333333333
stila,1,5,2,3,0,0.666666666666667
intrarachide,0,12,5,7,0,0.714285714285714
homoiousianisms,1,15,8,7,0,1.14285714285714
herenesses,1,10,4,6,0,0.666666666666667
neesed,1,6,3,3,0,1
binjiepholllocrobunchendes,0,26,9,17,0,0.529411764705882
bbtsvkfuwupu,0,12,3,9,0,0.333333333333333
counterscientific,1,17,7,10,0,0.7
overmasterfully,1,15,5,10,0,0.5
intralingual,1,12,5,7,0,0.714285714285714
lous,0,4,2,2,0,1
fossilise,1,9,4,5,0,0.8
premolars,1,9,3,6,0,0.5
agronomist,1,10,4,6,0,0.666666666666667
pernas,1,6,2,4,0,0.5
uncompulsorinesses,0,18,7,11,0,0.636363636363636
ove,0,3,2,1,0,2
repulp,1,6,2,4,0,0.5
saddlestiffnesses,0,17,5,12,0,0.416666666666667
wastable,1,8,3,5,0,0.6
unremlesminge,0,13,5,8,0,0.625
missouri,1,8,4,4,0,1
rozokhopoune,0,12,6,6,0,1
lbdib,0,5,1,4,0,0.25
methylsilant,0,12,3,9,0,0.333333333333333
ouphs,1,5,2,3,0,0.666666666666667
nonadoptable,1,12,5,7,0,0.714285714285714
hu'l'bbxxpii,0,12,3,9,2,0.333333333333333
sprotista,0,9,3,6,0,0.5
foins,0,5,2,3,0,0.666666666666667
giessemecdurbid,0,15,6,9,0,0.666666666666667
abstentious,1,11,5,6,0,0.833333333333333
lonelinesses,1,12,5,7,0,0.714285714285714
fodznloapfkocqdqjpwq,0,20,4,16,0,0.25
coyndgiphfh,0,11,2,9,0,0.222222222222222
devestreamer,0,12,5,7,0,0.714285714285714
sanctual,0,8,3,5,0,0.6
vgzcrbbbm,0,9,0,9,0,0
recompendious,0,13,6,7,0,0.857142857142857
geals,1,5,2,3,0,0.666666666666667
ficula,1,6,3,3,0,1
gcilwehyuyhr''d,0,15,3,12,2,0.25
checkweigher,1,12,4,8,0,0.5
osubass,0,7,3,4,0,0.75
dimethylnitrosified,0,19,7,12,0,0.583333333333333
cholecystectasia,1,16,6,10,0,0.6
faux,1,4,2,2,0,1
telfers,0,7,2,5,0,0.4
dowmake,0,7,3,4,0,0.75
redical,0,7,3,4,0,0.75
conglobuling,0,12,4,8,0,0.5
lunatene,0,8,4,4,0,1
durning,1,7,2,5,0,0.4
tilney,1,6,2,4,0,0.5
autoregulative,1,14,8,6,0,1.33333333333333
variolator,1,10,5,5,0,1
colter,1,6,2,4,0,0.5
clupea,1,6,3,3,0,1
closplinterlocking,0,18,5,13,0,0.384615384615385
chieftainry,1,11,4,7,0,0.571428571428571
unastounded,1,11,5,6,0,0.833333333333333
thinghood,1,9,3,6,0,0.5
ichthyodorylinae,0,16,6,10,0,0.6
ventriloquism,1,13,5,8,0,0.625
schmooze,1,8,3,5,0,0.6
conventual,1,10,4,6,0,0.666666666666667
renormalaprotectiveness,0,23,9,14,0,0.642857142857143
barbiest,0,8,3,5,0,0.6
apetalous,1,9,5,4,0,1.25
honkytonks,1,10,2,8,0,0.25
habletdom,0,9,3,6,0,0.5
superclub,1,9,3,6,0,0.5
talmudistical,1,13,5,8,0,0.625
coness,0,6,2,4,0,0.5
polyprotodontinae,0,17,7,10,0,0.7
bakalei,1,7,4,3,0,1.33333333333333
flowerlet,1,9,3,6,0,0.5
dhoti,1,5,2,3,0,0.666666666666667
esllius,0,7,3,4,0,0.75
tawney,1,6,2,4,0,0.5
chapstick,1,9,2,7,0,0.285714285714286
pommard,1,7,2,5,0,0.4
hoodies,1,7,4,3,0,1.33333333333333
trask,1,5,1,4,0,0.25
dutchwoman,1,10,3,7,0,0.428571428571429
adipocerite,1,11,6,5,0,1.2
protutorial,0,11,5,6,0,0.833333333333333
ffless,0,6,1,5,0,0.2
ancilla,1,7,3,4,0,0.75
euskallonsburg,0,14,5,9,0,0.555555555555556
fegrade,0,7,3,4,0,0.75
nashoma,1,7,3,4,0,0.75
simpregular,0,11,4,7,0,0.571428571428571
postconsonantal,1,15,5,10,0,0.5
naboberies,1,10,5,5,0,1
nonethically,1,12,4,8,0,0.5
coccygeal,1,9,3,6,0,0.5
auran,0,5,3,2,0,1.5
encarpus,1,8,3,5,0,0.6
peucjswzvsnbnnjtnwv,0,19,2,17,0,0.117647058823529
gujral,1,6,2,4,0,0.5
fedykvyeajn,0,11,3,8,0,0.375
unprecenturaenie,0,16,8,8,0,1
writely,0,7,2,5,0,0.4
ctenoy,0,6,2,4,0,0.5
galetriggenmul,0,14,5,9,0,0.555555555555556
lectrifying,0,11,3,8,0,0.375
recalling,1,9,3,6,0,0.5
trysail,1,7,2,5,0,0.4
mimalntrenolvomistogerus,0,24,9,15,0,0.6
nondifferentiable,1,17,7,10,0,0.7
varicosity,1,10,4,6,0,0.666666666666667
orthodox,1,8,3,5,0,0.6
stronal,0,7,2,5,0,0.4
sistency,1,8,2,6,0,0.333333333333333
gettysburg,1,10,2,8,0,0.25
spicebushes,1,11,4,7,0,0.571428571428571
reviviscence,1,12,5,7,0,0.714285714285714
vineyarder,1,10,4,6,0,0.666666666666667
trobupropore,0,12,5,7,0,0.714285714285714
inacceptableness,0,16,6,10,0,0.6
nike,1,4,2,2,0,1
cashablenesses,0,14,5,9,0,0.555555555555556
hent,1,4,1,3,0,0.333333333333333
augury,1,6,3,3,0,1
overprisation,0,13,6,7,0,0.857142857142857
groass,0,6,2,4,0,0.5
dee,1,3,2,1,0,2
antinaturally,1,13,5,8,0,0.625
vinsneuryloephiks,0,17,6,11,0,0.545454545454545
unkhablectillagofie,0,19,8,11,0,0.727272727272727
chronograph,1,11,3,8,0,0.375
backspacer,1,10,3,7,0,0.428571428571429
cartetosis,0,10,4,6,0,0.666666666666667
pseudomonadales,0,15,7,8,0,0.875
mergees,1,7,3,4,0,0.75
midwesterner,1,12,4,8,0,0.5
lydidae,0,7,3,4,0,0.75
flagraris,0,9,3,6,0,0.5
pharmacopoeias,1,14,7,7,0,1
interdevour,1,11,5,6,0,0.833333333333333
jiglike,1,7,3,4,0,0.75
ptfy,0,4,0,4,0,0
noordbrabant,1,12,4,8,0,0.5
hastraiser,0,10,4,6,0,0.666666666666667
moonwasperoords,0,15,6,9,0,0.666666666666667
isoetales,1,9,5,4,0,1.25
misanthropically,1,16,5,11,0,0.454545454545455
grmirusllinevebist,0,18,6,12,0,0.5
unpoetical,1,10,5,5,0,1
katsuwonidae,1,12,6,6,0,1
lolium,1,6,3,3,0,1
caefop,0,6,3,3,0,1
reprimandingly,1,14,4,10,0,0.4
yousuf,1,6,3,3,0,1
dermen,0,6,2,4,0,0.5
pawl,1,4,1,3,0,0.333333333333333
trygve,1,6,1,5,0,0.2
libvzicixbwdzizbp'xb,0,20,4,16,1,0.25
spline,1,6,2,4,0,0.5
todotaur,0,8,4,4,0,1
normothermia,1,12,5,7,0,0.714285714285714
'isxvokciq,0,10,3,7,1,0.428571428571429
scareful,1,8,3,5,0,0.6
anacareousness,0,14,7,7,0,1
teleidophianism,0,15,7,8,0,0.875
gnoseme,0,7,3,4,0,0.75
kantappotaea,0,12,6,6,0,1
mhn,0,3,0,3,0,0
strepitantly,1,12,3,9,0,0.333333333333333
tracheopharyngeal,1,17,6,11,0,0.545454545454545
bethemiabatino,0,14,7,7,0,1
descedaliancertia,0,17,8,9,0,0.888888888888889
disrespecial,0,12,5,7,0,0.714285714285714
shrie,0,5,2,3,0,0.666666666666667
parsechatelet,0,13,5,8,0,0.625
prurigos,1,8,3,5,0,0.6
sprc,0,4,0,4,0,0
digger,1,6,2,4,0,0.5
neumayer,1,8,4,4,0,1
maricolous,1,10,5,5,0,1
vocondomest,0,11,4,7,0,0.571428571428571
uralubbetemisqusthun,0,20,8,12,0,0.666666666666667
pouldred,1,8,3,5,0,0.6
etwite,1,6,3,3,0,1
connemarielsonville,0,19,8,11,0,0.727272727272727
dewilliny,0,9,3,6,0,0.5
physiography,1,12,3,9,0,0.333333333333333
ocellation,1,10,5,5,0,1
spect,1,5,1,4,0,0.25
gancensivitograph,0,17,6,11,0,0.545454545454545
hriontas,0,8,3,5,0,0.6
copurified,1,10,5,5,0,1
dfrer,1,5,1,4,0,0.25
kalasky,1,7,2,5,0,0.4
skintia,0,7,3,4,0,0.75
psychoneuroimmunologist,1,23,9,14,0,0.642857142857143
a'oghiqaoggdtjkloxarezk',0,24,8,16,2,0.5
gretta,1,6,2,4,0,0.5
semuncia,1,8,4,4,0,1
slumberousness,1,14,5,9,0,0.555555555555556
farthingles,0,11,3,8,0,0.375
bizare,0,6,3,3,0,1
infibulate,1,10,5,5,0,1
scheock,0,7,2,5,0,0.4
sahosporphonelli,0,16,6,10,0,0.6
rampliste,0,9,3,6,0,0.5
flancicuigacang,0,15,6,9,0,0.666666666666667
harneen,1,7,3,4,0,0.75
lemniscal,1,9,3,6,0,0.5
semia,0,5,3,2,0,1.5
villegiately,0,12,5,7,0,0.714285714285714
ctansunghalcterangitheris,0,25,8,17,0,0.470588235294118
colophon,1,8,3,5,0,0.6
dawk,1,4,1,3,0,0.333333333333333
scarlatti,1,9,3,6,0,0.5
mauvais,0,7,4,3,0,1.33333333333333
mfzhyqvednyo,0,12,2,10,0,0.2
uoopuls,0,7,4,3,0,1.33333333333333
aplysiidae,0,10,5,5,0,1
ronope,0,6,3,3,0,1
workship,1,8,2,6,0,0.333333333333333
lightbulb,1,9,2,7,0,0.285714285714286
missal,1,6,2,4,0,0.5
jugsful,1,7,2,5,0,0.4
medicamentally,1,14,5,9,0,0.555555555555556
cararchium,0,10,4,6,0,0.666666666666667
stous,0,5,2,3,0,0.666666666666667
camorrista,1,10,4,6,0,0.666666666666667
sanativeness,1,12,5,7,0,0.714285714285714
jacone,0,6,3,3,0,1
amen,1,4,2,2,0,1
tailoress,1,9,4,5,0,0.8
microbusses,1,11,4,7,0,0.571428571428571
cataphrygianism,1,15,5,10,0,0.5
scammonyroot,1,12,4,8,0,0.5
unmemorably,1,11,4,7,0,0.571428571428571
gqs'gkphmw'he',0,14,1,13,3,0.0769230769230769
fnno'vazbqh,0,11,2,9,1,0.222222222222222
atyzispelee,0,11,5,6,0,0.833333333333333
hilts,1,5,1,4,0,0.25
unamenableness,0,14,6,8,0,0.75
discouragement,1,14,6,8,0,0.75
uncreativeness,1,14,6,8,0,0.75
defeminised,1,11,5,6,0,0.833333333333333
jqvhhikjse'jxgbu,0,16,3,13,1,0.230769230769231
wrxc,0,4,0,4,0,0
cambrian,1,8,3,5,0,0.6
impresser,1,9,3,6,0,0.5
preassumed,1,10,4,6,0,0.666666666666667
jiceite,0,7,4,3,0,1.33333333333333
retic,0,5,2,3,0,0.666666666666667
nasethmoid,1,10,4,6,0,0.666666666666667
tracrateartarsly,0,16,5,11,0,0.454545454545455
gracilariidae,1,13,7,6,0,1.16666666666667
vacanthi,0,8,3,5,0,0.6
natterers,1,9,3,6,0,0.5
layerages,1,9,4,5,0,0.8
palabrium,0,9,4,5,0,0.8
strophote,0,9,3,6,0,0.5
shnaps,1,6,1,5,0,0.2
proteus,1,7,3,4,0,0.75
esurient,1,8,4,4,0,1
zoons,1,5,2,3,0,0.666666666666667
cladio,0,6,3,3,0,1
slimsiest,1,9,3,6,0,0.5
ascophyllum,1,11,3,8,0,0.375
meyerbeek,0,9,4,5,0,0.8
displanolism,0,12,4,8,0,0.5
psignics,0,8,2,6,0,0.333333333333333
ngalitetysn,0,11,3,8,0,0.375
eparterial,1,10,5,5,0,1
divinyl,1,7,2,5,0,0.4
hypocathexis,1,12,4,8,0,0.5
jabbllaveatroniczlatam,0,22,8,14,0,0.571428571428571
ecoute,1,6,4,2,0,2
phurmmrhydarebimseluin,0,22,7,15,0,0.466666666666667
nbakhoxeouqwem,0,14,6,8,0,0.75
spectroheliogram,1,16,6,10,0,0.6
unexcerptions,0,13,5,8,0,0.625
misrepublico,0,12,5,7,0,0.714285714285714
darreterium,0,11,5,6,0,0.833333333333333
pdjxpyefgc,0,10,1,9,0,0.111111111111111
ckesetrior,0,10,4,6,0,0.666666666666667
seducer,1,7,3,4,0,0.75
diorita,0,7,4,3,0,1.33333333333333
fantasia,1,8,4,4,0,1
devian,0,6,3,3,0,1
dislinks,1,8,2,6,0,0.333333333333333
cantled,1,7,2,5,0,0.4
soot,1,4,2,2,0,1
lowery,1,6,2,4,0,0.5
fortifications,1,14,6,8,0,0.75
incodes,0,7,3,4,0,0.75
punicaceae,1,10,6,4,0,1.5
boardings,1,9,3,6,0,0.5
wickens,1,7,2,5,0,0.4
epationatoriservisomitttness,0,28,12,16,0,0.75
tornus,1,6,2,4,0,0.5
delts,1,5,1,4,0,0.25
sinctness,0,9,2,7,0,0.285714285714286
aernichtirhoponti,0,17,7,10,0,0.7
confusable,1,10,4,6,0,0.666666666666667
bitudgeadolincelvals,0,20,8,12,0,0.666666666666667
blackfigured,1,12,4,8,0,0.5
priori,1,6,3,3,0,1
literatophyte,0,13,5,8,0,0.625
atura,0,5,3,2,0,1.5
septicide,0,9,4,5,0,0.8
waysvillotrevic,0,15,5,10,0,0.5
roundhead,1,9,4,5,0,0.8
blueball,1,8,3,5,0,0.6
ciondagaured,0,12,6,6,0,1
allayed,1,7,3,4,0,0.75
taved,0,5,2,3,0,0.666666666666667
panchomerish,0,12,4,8,0,0.5
pou,0,3,2,1,0,2
cajvt,0,5,1,4,0,0.25
footdraggers,1,12,4,8,0,0.5
abwebbis,0,8,3,5,0,0.6
girdler,1,7,2,5,0,0.4
probabilism,1,11,4,7,0,0.571428571428571
sternonuchal,1,12,4,8,0,0.5
chapeaus,1,8,4,4,0,1
equiped,1,7,4,3,0,1.33333333333333
jilgie,1,6,3,3,0,1
phonaebigulopipang,0,18,8,10,0,0.8
termagantish,1,12,4,8,0,0.5
poked,1,5,2,3,0,0.666666666666667
pondville,1,9,3,6,0,0.5
cettola,0,7,3,4,0,0.75
wearhy,0,6,2,4,0,0.5
superabnormally,1,15,5,10,0,0.5
phograp,0,7,2,5,0,0.4
gatecrasher,1,11,4,7,0,0.571428571428571
clywd,1,5,0,5,0,0
lungis,1,6,2,4,0,0.5
agemiaseticras,0,14,7,7,0,1
etheful,0,7,3,4,0,0.75
wampus,1,6,2,4,0,0.5
marchical,0,9,3,6,0,0.5
heysham,1,7,2,5,0,0.4
improbities,1,11,5,6,0,0.833333333333333
predom,0,6,2,4,0,0.5
siler,1,5,2,3,0,0.666666666666667
cpm,1,3,0,3,0,0
unimpelled,1,10,4,6,0,0.666666666666667
supersexualisation,0,18,9,9,0,1
anticalliclinate,0,16,7,9,0,0.777777777777778
degering,0,8,3,5,0,0.6
necrotic,1,8,3,5,0,0.6
misprovident,0,12,4,8,0,0.5
catowhililvignattupatics,0,24,9,15,0,0.6
wedgie,1,6,3,3,0,1
latoid,0,6,3,3,0,1
yommorkstaximoncrophis,0,22,7,15,0,0.466666666666667
rounce,1,6,3,3,0,1
trenchies,0,9,3,6,0,0.5
pinonbernciation,0,16,7,9,0,0.777777777777778
hanaparm,0,8,3,5,0,0.6
detaerfelpoyspic,0,16,6,10,0,0.6
unlette,0,7,3,4,0,0.75
endometer,0,9,4,5,0,0.8
uptrail,1,7,3,4,0,0.75
coenures,1,8,4,4,0,1
tagalo,1,6,3,3,0,1
nonpurulent,1,11,4,7,0,0.571428571428571
fantoddishness,0,14,4,10,0,0.4
elasmobranchian,1,15,6,9,0,0.666666666666667
shijiazhuang,1,12,5,7,0,0.714285714285714
lareoidewabiddley're,0,20,9,11,1,0.818181818181818
alang,1,5,2,3,0,0.666666666666667
morphias,1,8,3,5,0,0.6
rationalisable,1,14,7,7,0,1
retina,1,6,3,3,0,1
conneedness,0,11,4,7,0,0.571428571428571
shoa,1,4,2,2,0,1
dispassionate,1,13,6,7,0,0.857142857142857
chargeship,1,10,3,7,0,0.428571428571429
antonionally,0,12,5,7,0,0.714285714285714
helminized,0,10,4,6,0,0.666666666666667
mphanchtexemizichvifrndlardy,0,28,7,21,0,0.333333333333333
bespecklement,1,13,4,9,0,0.444444444444444
noncorresponds,0,14,4,10,0,0.4
jammy,1,5,1,4,0,0.25
ces,0,3,1,2,0,0.5
auctary,0,7,3,4,0,0.75
propylene,1,9,3,6,0,0.5
frett,0,5,1,4,0,0.25
gunpoint,1,8,3,5,0,0.6
reinsertion,1,11,5,6,0,0.833333333333333
american,1,8,4,4,0,1
chisellings,1,11,3,8,0,0.375
wynmjslqentpoxoejkmn,0,20,4,16,0,0.25
stanislaw,1,9,3,6,0,0.5
nxljetijkjybgmfy,0,16,2,14,0,0.142857142857143
profanator,0,10,4,6,0,0.666666666666667
drummies,0,8,3,5,0,0.6
diniochawenas,0,13,6,7,0,0.857142857142857
helsingkite,1,11,4,7,0,0.571428571428571
pacolet,1,7,3,4,0,0.75
iyrenetidest,0,12,5,7,0,0.714285714285714
arthel,1,6,2,4,0,0.5
nonsburth,0,9,2,7,0,0.285714285714286
coproduct,1,9,3,6,0,0.5
impracticipial,0,14,6,8,0,0.75
becrush,1,7,2,5,0,0.4
wriggling,1,9,2,7,0,0.285714285714286
snowscape,1,9,3,6,0,0.5
bipropellant,1,12,4,8,0,0.5
mcrusin,0,7,2,5,0,0.4
tithebook,1,9,4,5,0,0.8
gellinesis,0,10,4,6,0,0.666666666666667
cumbency,0,8,2,6,0,0.333333333333333
anabaptist,1,10,4,6,0,0.666666666666667
flaments,0,8,2,6,0,0.333333333333333
quickerlitzier,0,14,6,8,0,0.75
polychlorines,0,13,4,9,0,0.444444444444444
stationman,1,10,4,6,0,0.666666666666667
hyperoxidation,1,14,6,8,0,0.75
obdckwzvs,0,9,1,8,0,0.125
alkenhayn,0,9,3,6,0,0.5
stirrers,1,8,2,6,0,0.333333333333333
unodoriferously,1,15,7,8,0,0.875
sebuikellingelisteole,0,21,10,11,0,0.909090909090909
conchalynous,0,12,4,8,0,0.5
feathlegenata,0,13,6,7,0,0.857142857142857
gerbilloaing,0,12,5,7,0,0.714285714285714
champshears,0,11,3,8,0,0.375
perfervent,1,10,3,7,0,0.428571428571429
cortadels,0,9,3,6,0,0.5
quittederitposingt,0,18,7,11,0,0.636363636363636
pine,1,4,2,2,0,1
dunsermergraph,0,14,4,10,0,0.4
cidoyriesmeos,0,13,6,7,0,0.857142857142857
m'cymmqsrlzocmdqmkasj,0,21,2,19,1,0.105263157894737
abulescence,0,11,5,6,0,0.833333333333333
overmastering,1,13,5,8,0,0.625
maeander,1,8,4,4,0,1
ravioli,1,7,4,3,0,1.33333333333333
yglysmnggueikfmvsmz'jcjfy'nk,0,28,3,25,2,0.12
nacreins,0,8,3,5,0,0.6
palmilobed,1,10,4,6,0,0.666666666666667
tinervitiali,0,12,6,6,0,1
overful,0,7,3,4,0,0.75
boreace,0,7,4,3,0,1.33333333333333
aphasmidia,1,10,5,5,0,1
botchiation,0,11,5,6,0,0.833333333333333
affrontee,1,9,4,5,0,0.8
unwich,0,6,2,4,0,0.5
biegnetisationally,0,18,8,10,0,0.8
unrecognizing,0,13,5,8,0,0.625
womeras,1,7,3,4,0,0.75
hifidakerolan,0,13,6,7,0,0.857142857142857
orefies,0,7,4,3,0,1.33333333333333
xerostomia,1,10,5,5,0,1
apostatises,1,11,5,6,0,0.833333333333333
ethelicised,0,11,5,6,0,0.833333333333333
ezskacmkveul,0,12,4,8,0,0.5
lonesomes,1,9,4,5,0,0.8
irrees,0,6,3,3,0,1
bloodier,1,8,4,4,0,1
exsiccator,1,10,4,6,0,0.666666666666667
bromoacetaldehyde,0,17,7,10,0,0.7
tollable,1,8,3,5,0,0.6
julienite,0,9,5,4,0,1.25
tipays,0,6,2,4,0,0.5
dingdong,1,8,2,6,0,0.333333333333333
pomology,1,8,3,5,0,0.6
physalospora,1,12,4,8,0,0.5
macrocin,0,8,3,5,0,0.6
barolong,1,8,3,5,0,0.6
chaircutto,0,10,4,6,0,0.666666666666667
uture,0,5,3,2,0,1.5
supraline,0,9,4,5,0,0.8
scisotte,0,8,3,5,0,0.6
qbom,0,4,1,3,0,0.333333333333333
jadda,1,5,2,3,0,0.666666666666667
octodecillionaire,0,17,9,8,0,1.125
unpumicated,1,11,5,6,0,0.833333333333333
pardo,1,5,2,3,0,0.666666666666667
causeway,1,8,4,4,0,1
snapshootied,0,12,5,7,0,0.714285714285714
camisade,1,8,4,4,0,1
unanatomical,0,12,6,6,0,1
zqrrcicsyweatbui,0,16,5,11,0,0.454545454545455
chokecoilabian,0,14,7,7,0,1
neurygan,0,8,3,5,0,0.6
haydlar,0,7,2,5,0,0.4
seemliest,1,9,4,5,0,0.8
hickwalls,1,9,2,7,0,0.285714285714286
mydicoecta,0,10,4,6,0,0.666666666666667
biliterelptionn,0,15,6,9,0,0.666666666666667
noncontentious,1,14,6,8,0,0.75
cornets,1,7,2,5,0,0.4
palaeologist,0,12,6,6,0,1
madisterium,1,11,5,6,0,0.833333333333333
iswara,1,6,3,3,0,1
plagiochusett,0,13,5,8,0,0.625
loyd,1,4,1,3,0,0.333333333333333
suboscigenic,0,12,5,7,0,0.714285714285714
xoxbyjdycyumzctu,0,16,3,13,0,0.230769230769231
temmoku,1,7,3,4,0,0.75
gracelike,1,9,4,5,0,0.8
phenothiazine,1,13,6,7,0,0.857142857142857
magmulanjus,0,11,4,7,0,0.571428571428571
bedulatopa,0,10,5,5,0,1
rophytenexylarigh,0,17,5,12,0,0.416666666666667
tachyphasias,1,12,4,8,0,0.5
burgilinges,0,11,4,7,0,0.571428571428571
poles,1,5,2,3,0,0.666666666666667
loging,0,6,2,4,0,0.5
marleight,0,9,3,6,0,0.5
lugansk,1,7,2,5,0,0.4
ambience,1,8,4,4,0,1
availmen,0,8,4,4,0,1
repeddling,1,10,3,7,0,0.428571428571429
'vkbwsxmxosfmv,0,14,1,13,1,0.0769230769230769
whiskylin,0,9,2,7,0,0.285714285714286
kura,1,4,2,2,0,1
troped,1,6,2,4,0,0.5
naphthalmouthe,0,14,5,9,0,0.555555555555556
clairsden,0,9,3,6,0,0.5
fhwcz'ucqetief,0,14,4,10,1,0.4
nonnegligibly,1,13,4,9,0,0.444444444444444
anablephamative,0,15,7,8,0,0.875
khoumaini,1,9,5,4,0,1.25
specialest,1,10,4,6,0,0.666666666666667
atinles,0,7,3,4,0,0.75
unanograsthose,0,14,6,8,0,0.75
romancical,1,10,4,6,0,0.666666666666667
abstain,1,7,3,4,0,0.75
sacrilated,0,10,4,6,0,0.666666666666667
blentralimpurs,0,14,4,10,0,0.4
blatherskite,1,12,4,8,0,0.5
dinative,0,8,4,4,0,1
hypsometer,1,10,3,7,0,0.428571428571429
overofficemax,0,13,6,7,0,0.857142857142857
ticklely,1,8,2,6,0,0.333333333333333
pate,1,4,2,2,0,1
blackhanders,1,12,3,9,0,0.333333333333333
crawdaddy,1,9,2,7,0,0.285714285714286
declarant,1,9,3,6,0,0.5
foreses,0,7,3,4,0,0.75
invalette,0,9,4,5,0,0.8
repolishednesses,0,16,6,10,0,0.6
misapperclate,0,13,5,8,0,0.625
manitoba,1,8,4,4,0,1
paroemiologists,0,15,7,8,0,0.875
overhaus,0,8,4,4,0,1
cemen,0,5,2,3,0,0.666666666666667
preunite,1,8,4,4,0,1
mogravarylogic,0,14,5,9,0,0.555555555555556
nankingese,1,10,4,6,0,0.666666666666667
embern,0,6,2,4,0,0.5
overregulatress,0,15,6,9,0,0.666666666666667
urbanities,1,10,5,5,0,1
xwylbublxzknkq,0,14,1,13,0,0.0769230769230769
ambomalant,0,10,4,6,0,0.666666666666667
isosporides,0,11,5,6,0,0.833333333333333
gectrothes,0,10,3,7,0,0.428571428571429
wahabite,1,8,4,4,0,1
adoptant,1,8,3,5,0,0.6
punchromators,0,13,4,9,0,0.444444444444444
noncolloid,1,10,4,6,0,0.666666666666667
acclaimin,0,9,4,5,0,0.8
monotrematous,1,13,6,7,0,0.857142857142857
certa,0,5,2,3,0,0.666666666666667
alvlmxvhrsesfqwoglmfxkcdz,0,25,3,22,0,0.136363636363636
bblaphrircino,0,13,4,9,0,0.444444444444444
glockened,0,9,3,6,0,0.5
entrenchymotic,0,14,4,10,0,0.4
veal,1,4,2,2,0,1
girafano,1,8,4,4,0,1
nymwegen,1,8,2,6,0,0.333333333333333
chacma,1,6,2,4,0,0.5
balantom,0,8,3,5,0,0.6
accurpans,0,9,3,6,0,0.5
chalaza,1,7,3,4,0,0.75
interrogatives,1,14,6,8,0,0.75
reddish,1,7,2,5,0,0.4
aerobraked,1,10,5,5,0,1
siophis,0,7,3,4,0,0.75
ascrive,1,7,3,4,0,0.75
icel,1,4,2,2,0,1
rumal,1,5,2,3,0,0.666666666666667
ejgbguulaevgomg,0,15,6,9,0,0.666666666666667
slsbvfzpdat,0,11,1,10,0,0.1
pseudopods,1,10,4,6,0,0.666666666666667
clanton,1,7,2,5,0,0.4
harveyizing,1,11,4,7,0,0.571428571428571
recreator,1,9,4,5,0,0.8
noncircumferentiate,0,19,8,11,0,0.727272727272727
gecko,1,5,2,3,0,0.666666666666667
hyetoonsolding,0,14,5,9,0,0.555555555555556
pigeons,1,7,3,4,0,0.75
rigling,1,7,2,5,0,0.4
sestette,1,8,3,5,0,0.6
deforesters,1,11,4,7,0,0.571428571428571
ratification,1,12,6,6,0,1
dously,0,6,2,4,0,0.5
mussmannia,0,10,4,6,0,0.666666666666667
scamphimacusis,0,14,5,9,0,0.555555555555556
macrosynther,0,12,3,9,0,0.333333333333333
roping,1,6,2,4,0,0.5
umbreres,1,8,3,5,0,0.6
twileloulylok,0,13,5,8,0,0.625
hzlhmbmpghwoo'px'acfm,0,21,3,18,2,0.166666666666667
brillianting,1,12,4,8,0,0.5
pistermes,0,9,3,6,0,0.5
twitched,1,8,2,6,0,0.333333333333333
alunile,0,7,4,3,0,1.33333333333333
mwykbov,0,7,1,6,0,0.166666666666667
elders,1,6,2,4,0,0.5
ecugmfa,0,7,3,4,0,0.75
goniopholis,1,11,5,6,0,0.833333333333333
thistrochroofishly,0,18,5,13,0,0.384615384615385
hlewm,0,5,1,4,0,0.25
leresedry,0,9,3,6,0,0.5
adularescent,1,12,5,7,0,0.714285714285714
cowpunch,1,8,2,6,0,0.333333333333333
oxford,1,6,2,4,0,0.5
westwards,1,9,2,7,0,0.285714285714286
unmarierial,0,11,6,5,0,1.2
ehvqvondhowkkayzxdip,0,20,5,15,0,0.333333333333333
mastoncus,1,9,3,6,0,0.5
annexation,1,10,5,5,0,1
towziest,1,8,3,5,0,0.6
aneides,1,7,4,3,0,1.33333333333333
svewavppcycnhixetwfzgpqb,0,24,4,20,0,0.2
cachunderlandes,0,15,5,10,0,0.5
hangasi,0,7,3,4,0,0.75
behaviouristic,1,14,7,7,0,1
costispinal,1,11,4,7,0,0.571428571428571
cracow,1,6,2,4,0,0.5
kecksies,1,8,3,5,0,0.6
intradosed,0,10,4,6,0,0.666666666666667
misgigs,0,7,2,5,0,0.4
ortlers,0,7,2,5,0,0.4
requested,1,9,4,5,0,0.8
fle,0,3,1,2,0,0.5
pioners,1,7,3,4,0,0.75
borawpistolosiacastes,0,21,9,12,0,0.75
wideboard,0,9,4,5,0,0.8
okohingerlorutounabetuse,0,24,12,12,0,1
ovoplasticised,0,14,6,8,0,0.75
beri,1,4,2,2,0,1
wrimple,1,7,2,5,0,0.4
misgovernor,1,11,4,7,0,0.571428571428571
gangrels,1,8,2,6,0,0.333333333333333
tagalo,1,6,3,3,0,1
protoctist,1,10,3,7,0,0.428571428571429
revna,0,5,2,3,0,0.666666666666667
tastevins,1,9,3,6,0,0.5
administrascarfarm,0,18,6,12,0,0.5
jaquintly,0,9,3,6,0,0.5
morrhuas,1,8,3,5,0,0.6
bpreyqgqamndzyw'g'zfxvq,0,23,2,21,2,0.0952380952380952
pepeduct,0,8,3,5,0,0.6
inactual,0,8,4,4,0,1
lynsey,1,6,1,5,0,0.2
coulometries,1,12,6,6,0,1
ctoc,0,4,1,3,0,0.333333333333333
tard,0,4,1,3,0,0.333333333333333
langshans,1,9,2,7,0,0.285714285714286
dopocehoconelolopomperd,0,23,10,13,0,0.769230769230769
catherwood,1,10,4,6,0,0.666666666666667
toxoplasmata,0,12,5,7,0,0.714285714285714
raruroiosem,0,11,6,5,0,1.2
sunkland,1,8,2,6,0,0.333333333333333
hematosalpinx,1,13,5,8,0,0.625
cephaloplegia,1,13,6,7,0,0.857142857142857
hoppercar,1,9,3,6,0,0.5
flancritest,0,11,3,8,0,0.375
gantenes,0,8,3,5,0,0.6
bowness,0,7,2,5,0,0.4
gelseminine,1,11,5,6,0,0.833333333333333
codachaboon,0,11,5,6,0,0.833333333333333
reide,0,5,3,2,0,1.5
bellerophontes,1,14,5,9,0,0.555555555555556
bill,1,4,1,3,0,0.333333333333333
discrimina,0,10,4,6,0,0.666666666666667
agonising,1,9,4,5,0,0.8
psalmic,1,7,2,5,0,0.4
vitrifactures,1,13,5,8,0,0.625
rodi,1,4,2,2,0,1
miscredits,1,10,3,7,0,0.428571428571429
stichid,1,7,2,5,0,0.4
caviller,1,8,3,5,0,0.6
deaden,1,6,3,3,0,1
reclinants,0,10,3,7,0,0.428571428571429
cornta,0,6,2,4,0,0.5
tuixmnjklxrpxuhyppmsz,0,21,3,18,0,0.166666666666667
enaces,0,6,3,3,0,1
uyng,0,4,1,3,0,0.333333333333333
noncomplacency,1,14,4,10,0,0.4
binomial,1,8,4,4,0,1
sowlth,1,6,1,5,0,0.2
cyclopteroid,1,12,4,8,0,0.5
tylerton,1,8,2,6,0,0.333333333333333
leopardbane,1,11,5,6,0,0.833333333333333
patella,1,7,3,4,0,0.75
cleveland,1,9,3,6,0,0.5
anterrisscrolino,0,16,6,10,0,0.6
trophoplasms,1,12,3,9,0,0.333333333333333
angly,0,5,1,4,0,0.25
ovant,1,5,2,3,0,0.666666666666667
malechotanculaspagra,0,20,8,12,0,0.666666666666667
symbolised,1,10,3,7,0,0.428571428571429
ixboevyoznopdf,0,14,5,9,0,0.555555555555556
tornithiformes,0,14,5,9,0,0.555555555555556
miserables,1,10,4,6,0,0.666666666666667
unins,0,5,2,3,0,0.666666666666667
lovelard,0,8,3,5,0,0.6
topmakers,1,9,3,6,0,0.5
matias,1,6,3,3,0,1
walach,1,6,2,4,0,0.5
astilbe,1,7,3,4,0,0.75
vevb,0,4,1,3,0,0.333333333333333
vhclnsnnpgxadhmqgdph'xxth,0,25,1,24,1,0.0416666666666667
stilu,1,5,2,3,0,0.666666666666667
galibi,1,6,3,3,0,1
catalogue,1,9,5,4,0,1.25
basanite,1,8,4,4,0,1
interconvention,0,15,6,9,0,0.666666666666667
carried,1,7,3,4,0,0.75
ntrngs,0,6,0,6,0,0
tyburnian,1,9,3,6,0,0.5
mentogyraily,0,12,4,8,0,0.5
rgpaullec',0,10,3,7,1,0.428571428571429
priouslavour,0,12,6,6,0,1
horsewhipped,1,12,4,8,0,0.5
analbuminemia,1,13,7,6,0,1.16666666666667
colliquativeness,1,16,7,9,0,0.777777777777778
conelonceerfledyigiosiudate,0,27,13,14,0,0.928571428571429
mabieond,0,8,4,4,0,1
eysekxcf,0,8,2,6,0,0.333333333333333
iyar,1,4,2,2,0,1
subcash,1,7,2,5,0,0.4
rtmoqepyrgrlbjgawp,0,18,3,15,0,0.2
nartjies,1,8,3,5,0,0.6
prethreadworsaktyles,0,20,6,14,0,0.428571428571429
anence,0,6,3,3,0,1
apokatastasis,1,13,6,7,0,0.857142857142857
eventrictiven,0,13,5,8,0,0.625
honolulan,1,9,4,5,0,0.8
lole,1,4,2,2,0,1
morin,1,5,2,3,0,0.666666666666667
aprets,0,6,2,4,0,0.5
venfopooslasicyme,0,17,7,10,0,0.7
uneschewed,1,10,4,6,0,0.666666666666667
blackleg,1,8,2,6,0,0.333333333333333
fetlocolans,0,11,4,7,0,0.571428571428571
needfires,1,9,4,5,0,0.8
scrimmage,1,9,3,6,0,0.5
archeus,1,7,3,4,0,0.75
percherigrawing,0,15,5,10,0,0.5
peripherocystopulmonickers,0,26,9,17,0,0.529411764705882
yukio,1,5,3,2,0,1.5
hypoploidicals,0,14,5,9,0,0.555555555555556
hindoo,1,6,3,3,0,1
cabinties,0,9,4,5,0,0.8
chapelize,1,9,4,5,0,0.8
gaslighting,1,11,3,8,0,0.375
anticlastic,1,11,4,7,0,0.571428571428571
dustus,0,6,2,4,0,0.5
sconchoscopical,0,15,5,10,0,0.5
cies,0,4,2,2,0,1
oesophagism,1,11,5,6,0,0.833333333333333
ramosity,1,8,3,5,0,0.6
brelymom,0,8,2,6,0,0.333333333333333
apporet,0,7,3,4,0,0.75
aerancepta,0,10,5,5,0,1
peonage,1,7,4,3,0,1.33333333333333
interinvolved,1,13,5,8,0,0.625
a'wvnmljxqfcyex,0,15,2,13,1,0.153846153846154
chanencereunicalytreadesmillectockling,0,38,14,24,0,0.583333333333333
cumulate,1,8,4,4,0,1
unretrograded,1,13,5,8,0,0.625
claes,1,5,2,3,0,0.666666666666667
transparency,1,12,3,9,0,0.333333333333333
bankia,1,6,3,3,0,1
anear,1,5,3,2,0,1.5
syvers,1,6,1,5,0,0.2
kthira,1,6,2,4,0,0.5
lanarkshire,1,11,4,7,0,0.571428571428571
atheimes,0,8,4,4,0,1
condensation,1,12,5,7,0,0.714285714285714
flagonet,1,8,3,5,0,0.6
ramqjjmmiseewvncubf,0,19,5,14,0,0.357142857142857
mamises,0,7,3,4,0,0.75
volitational,1,12,6,6,0,1
overattention,1,13,6,7,0,0.857142857142857
pistableawretted,0,16,6,10,0,0.6
huatimpatrkeril,0,15,6,9,0,0.666666666666667
buff,1,4,1,3,0,0.333333333333333
jejunostomy,1,11,4,7,0,0.571428571428571
outbannerous,0,12,6,6,0,1
undismayedness,0,14,5,9,0,0.555555555555556
fratchiks,0,9,2,7,0,0.285714285714286
farlike,0,7,3,4,0,0.75
caritta,1,7,3,4,0,0.75
quirksomeness,0,13,5,8,0,0.625
ptoc,0,4,1,3,0,0.333333333333333
uzsnsesqfqaxtkclzxmxzvais,0,25,5,20,0,0.25
diels,1,5,2,3,0,0.666666666666667
cornflake,1,9,3,6,0,0.5
smithianism,1,11,4,7,0,0.571428571428571
xiongnu,1,7,3,4,0,0.75
pseudoculturally,1,16,6,10,0,0.6
parger,0,6,2,4,0,0.5
lectra,1,6,2,4,0,0.5
phthalanilic,1,12,4,8,0,0.5
hypotypic,1,9,2,7,0,0.285714285714286
gripsack,1,8,2,6,0,0.333333333333333
hypnopelandroclity,0,18,5,13,0,0.384615384615385
helder,1,6,2,4,0,0.5
mertow,0,6,2,4,0,0.5
dolichosaurus,1,13,6,7,0,0.857142857142857
pentuatcating,0,13,5,8,0,0.625
compares,1,8,3,5,0,0.6
wadjcmryiqtgkdfasyqh,0,20,3,17,0,0.176470588235294
hasms,0,5,1,4,0,0.25
latifactiauts,0,13,6,7,0,0.857142857142857
lphevvlwqb'lxbnpgmnlev',0,23,2,21,2,0.0952380952380952
annonopal,0,9,4,5,0,0.8
ranitta,1,7,3,4,0,0.75
subpackall,0,10,3,7,0,0.428571428571429
cated,0,5,2,3,0,0.666666666666667
series,1,6,3,3,0,1
aradanchemioria,0,15,8,7,0,1.14285714285714
carousal,1,8,4,4,0,1
zirams,1,6,2,4,0,0.5
gmignicleerudrcicry,0,19,6,13,0,0.461538461538462
prer,0,4,1,3,0,0.333333333333333
crossingly,0,10,2,8,0,0.25
lumbashelinks,0,13,4,9,0,0.444444444444444
myroffs,0,7,1,6,0,0.166666666666667
hiromedusae,0,11,6,5,0,1.2
polioencephalomyelitis,1,22,10,12,0,0.833333333333333
diorrotedae,0,11,6,5,0,1.2
quinzieme,1,9,5,4,0,1.25
thirting,0,8,2,6,0,0.333333333333333
rediscommodem,0,13,5,8,0,0.625
bjzxmbagcmiqyvtzpo'ruqhboybm,0,28,5,23,1,0.217391304347826
psorosperm,1,10,3,7,0,0.428571428571429
paced,1,5,2,3,0,0.666666666666667
unacclaimate,1,12,6,6,0,1
ossietzky,1,9,3,6,0,0.5
molybdoparathyrohyoidal,0,23,8,15,0,0.533333333333333
crs,1,3,0,3,0,0
thysanopteri,0,12,4,8,0,0.5
diallists,1,9,3,6,0,0.5
precisive,1,9,4,5,0,0.8
faoence,1,7,4,3,0,1.33333333333333
couchantly,1,10,3,7,0,0.428571428571429
waramakerioneorevity,0,20,10,10,0,1
supercutaneously,0,16,7,9,0,0.777777777777778
balletenauctismonand,0,20,8,12,0,0.666666666666667
dbr,0,3,0,3,0,0
wfcjotnpee,0,10,3,7,0,0.428571428571429
leqz,0,4,1,3,0,0.333333333333333
lsgjosybql,0,10,1,9,0,0.111111111111111
ftxuxzpxrwhttiput,0,17,3,14,0,0.214285714285714
respirableness,1,14,5,9,0,0.555555555555556
nerved,1,6,2,4,0,0.5
lpcdf,1,5,0,5,0,0
brocatello,1,10,4,6,0,0.666666666666667
moskonfyt,1,9,2,7,0,0.285714285714286
staiths,1,7,2,5,0,0.4
fulman,0,6,2,4,0,0.5
karlis,1,6,2,4,0,0.5
phasiastere,0,11,5,6,0,0.833333333333333
perilless,1,9,3,6,0,0.5
exonerating,1,11,5,6,0,0.833333333333333
rijeka,1,6,3,3,0,1
trailles,0,8,3,5,0,0.6
lffrstan,0,8,1,7,0,0.142857142857143
moan,1,4,2,2,0,1
grquin,0,6,2,4,0,0.5
revestiaristocraticness,0,23,9,14,0,0.642857142857143
presenter,1,9,3,6,0,0.5
vjatprzuuegykdpzdnsauun,0,23,7,16,0,0.4375
nespelem,1,8,3,5,0,0.6
nikkel,0,6,2,4,0,0.5
deptioneurochaerided,0,20,10,10,0,1
lief,1,4,2,2,0,1
kaff,0,4,1,3,0,0.333333333333333
psycholinguistics,1,17,5,12,0,0.416666666666667
allurer,1,7,3,4,0,0.75
gamblers,1,8,2,6,0,0.333333333333333
ticker,1,6,2,4,0,0.5
symbolising,1,11,3,8,0,0.375
weissuasoy,0,10,5,5,0,1
zippo,1,5,2,3,0,0.666666666666667
advisable,1,9,4,5,0,0.8
erinaceus,1,9,5,4,0,1.25
forbysening,1,11,3,8,0,0.375
polytric,0,8,2,6,0,0.333333333333333
demiglossa,0,10,4,6,0,0.666666666666667
dispostexises,0,13,5,8,0,0.625
preremoval,1,10,4,6,0,0.666666666666667
planies,0,7,3,4,0,0.75
hemkbutsydcrxxrfk'globyo,0,24,4,20,1,0.2
maccabees,1,9,4,5,0,0.8
subdie,1,6,3,3,0,1
chaitya,1,7,3,4,0,0.75
indn,1,4,1,3,0,0.333333333333333
'dcrbjsgdl'dfmwn,0,16,0,16,2,0
rigmaroles,1,10,4,6,0,0.666666666666667
ambage,1,6,3,3,0,1
murrey,1,6,2,4,0,0.5
lieut,1,5,3,2,0,1.5
zqajrcxtgw,0,10,1,9,0,0.111111111111111
macroconia,0,10,5,5,0,1
arcadians,1,9,4,5,0,0.8
ophthalmorrhexis,1,16,5,11,0,0.454545454545455
mantnitable,0,11,4,7,0,0.571428571428571
graduated,1,9,4,5,0,0.8
unnameableness,1,14,6,8,0,0.75
silkwagginardablenessnesses,0,27,9,18,0,0.5
sicknesses,1,10,3,7,0,0.428571428571429
tere,0,4,2,2,0,1
joacimah,1,8,4,4,0,1
reshenter,0,9,3,6,0,0.5
hu,1,2,1,1,0,1
coinin,0,6,3,3,0,1
mantaddie,0,9,4,5,0,0.8
recropella,0,10,4,6,0,0.666666666666667
hymenomycetous,1,14,5,9,0,0.555555555555556
brakeroot,1,9,4,5,0,0.8
emissi,1,6,3,3,0,1
troia,1,5,3,2,0,1.5
chatscoratloulomnalele,0,22,9,13,0,0.692307692307692
chawia,1,6,3,3,0,1
afforestages,0,12,5,7,0,0.714285714285714
farthingsworth,1,14,3,11,0,0.272727272727273
spoilage,1,8,4,4,0,1
hrakical,0,8,3,5,0,0.6
semidifference,1,14,6,8,0,0.75
cattalievestaks,0,15,6,9,0,0.666666666666667
rimshone,0,8,3,5,0,0.6
waxflower,1,9,3,6,0,0.5
morna,1,5,2,3,0,0.666666666666667
knoblick,1,8,2,6,0,0.333333333333333
flourtyard,0,10,3,7,0,0.428571428571429
faenas,1,6,3,3,0,1
frau,1,4,2,2,0,1
predeclare,1,10,4,6,0,0.666666666666667
idkzay',0,7,2,5,1,0.4
marvella,1,8,3,5,0,0.6
disregardless,1,13,4,9,0,0.444444444444444
sporozoid,1,9,4,5,0,0.8
vipathier,0,9,4,5,0,0.8
scence,0,6,2,4,0,0.5
scesarallfocket,0,15,5,10,0,0.5
und,0,3,1,2,0,0.5
ashurbanipal,1,12,5,7,0,0.714285714285714
markomaticalite,0,15,7,8,0,0.875
rebaiting,1,9,4,5,0,0.8
collodiochloride,1,16,7,9,0,0.777777777777778
measle,1,6,3,3,0,1
prepensing,1,10,3,7,0,0.428571428571429
xanthochroias,1,13,5,8,0,0.625
gravery,1,7,2,5,0,0.4
estoile,1,7,4,3,0,1.33333333333333
presterna,1,9,3,6,0,0.5
nomographical,1,13,5,8,0,0.625
lism,0,4,1,3,0,0.333333333333333
wosvialietrenid,0,15,7,8,0,0.875
prep,0,4,1,3,0,0.333333333333333
dostoevskian,1,12,5,7,0,0.714285714285714
given,1,5,2,3,0,0.666666666666667
subsequent,1,10,4,6,0,0.666666666666667
undiostersess,0,13,5,8,0,0.625
tennuns,0,7,2,5,0,0.4
thyptinsciants,0,14,3,11,0,0.272727272727273
hopleanindly,0,12,4,8,0,0.5
unsenses,1,8,3,5,0,0.6
helmsman,1,8,2,6,0,0.333333333333333
cuscoverranelectuae,0,19,9,10,0,0.9
cryocauleanism,0,14,6,8,0,0.75
arrenotokous,1,12,6,6,0,1
graces,1,6,2,4,0,0.5
hidders,1,7,2,5,0,0.4
interdeputative,0,15,7,8,0,0.875
greekess,1,8,3,5,0,0.6
synura,1,6,2,4,0,0.5
farhatod,0,8,3,5,0,0.6
trigonometer,1,12,5,7,0,0.714285714285714
elucidators,1,11,5,6,0,0.833333333333333
roneidves,0,9,4,5,0,0.8
boronia,1,7,4,3,0,1.33333333333333
'cqw,0,4,0,4,1,0
loloisterer,0,11,5,6,0,0.833333333333333
papilio,1,7,4,3,0,1.33333333333333
forgetfulnesses,1,15,5,10,0,0.5
dviong,0,6,2,4,0,0.5
amiantievolutionalness,0,22,11,11,0,1
yciheaikznuc,0,12,5,7,0,0.714285714285714
hissculzpice,0,12,4,8,0,0.5
pwhaqlbozlmrhpwtsi,0,18,3,15,0,0.2
luxemburger,1,11,4,7,0,0.571428571428571
ferrochrome,1,11,4,7,0,0.571428571428571
nonauricular,1,12,6,6,0,1
stegocephalian,1,14,6,8,0,0.75
ckns,0,4,0,4,0,0
ostrya,1,6,2,4,0,0.5
ichannell,0,9,3,6,0,0.5
utiterdecestdosed,0,17,7,10,0,0.7
hippoboscages,0,13,5,8,0,0.625
tudgistawayste'ligazatoweenesslingionknes,0,41,16,25,1,0.64
forefeel,1,8,4,4,0,1
polygonales,1,11,4,7,0,0.571428571428571
deformalizes,1,12,5,7,0,0.714285714285714
taddsentreugh,0,13,4,9,0,0.444444444444444
carrow,0,6,2,4,0,0.5
cobol,1,5,2,3,0,0.666666666666667
ppertinthelemalnghibutimine,0,27,10,17,0,0.588235294117647
lithochromies,1,13,5,8,0,0.625
equitableness,1,13,6,7,0,0.857142857142857
gptuyeduph,0,10,3,7,0,0.428571428571429
rolfraic,0,8,3,5,0,0.6
puntaritius,0,11,5,6,0,0.833333333333333
lorationsis,0,11,5,6,0,0.833333333333333
jrsozn''oijkfy'q,0,16,3,13,3,0.230769230769231
anglophile,1,10,4,6,0,0.666666666666667
jswqwuugtlrywawy,0,16,3,13,0,0.230769230769231
priong,0,6,2,4,0,0.5
aggri,1,5,2,3,0,0.666666666666667
eroagedy,0,8,4,4,0,1
tnindhin,0,8,2,6,0,0.333333333333333
lobelines,1,9,4,5,0,0.8
wnnefy,0,6,1,5,0,0.2
jillsburg,0,9,2,7,0,0.285714285714286
mayos,1,5,2,3,0,0.666666666666667
dinics,1,6,2,4,0,0.5
unaking,1,7,3,4,0,0.75
outweeps,1,8,4,4,0,1
sonnie,1,6,3,3,0,1
baldachini,1,10,4,6,0,0.666666666666667
marionets,0,9,4,5,0,0.8
moviedom,1,8,4,4,0,1
tirled,1,6,2,4,0,0.5
nauguace,0,8,5,3,0,1.66666666666667
ravigator,0,9,4,5,0,0.8
catiosses,0,9,4,5,0,0.8
animatism,1,9,4,5,0,0.8
dontamwood,0,10,4,6,0,0.666666666666667
preformationist,1,15,6,9,0,0.666666666666667
palestinian,1,11,5,6,0,0.833333333333333
prescience,1,10,4,6,0,0.666666666666667
joannes,1,7,3,4,0,0.75
stulm,1,5,1,4,0,0.25
pleusshrirfbxwlgrkfccovw,0,24,4,20,0,0.2
jrcmpuzddzmomaqyk'n,0,19,3,16,1,0.1875
quinolinyl,1,10,4,6,0,0.666666666666667
overattached,1,12,5,7,0,0.714285714285714
grbw',0,5,0,5,1,0
ceteracy,0,8,3,5,0,0.6
acanthracitation,0,16,7,9,0,0.777777777777778
pukobincodostisederna,0,21,9,12,0,0.75
limeteorollegorical,0,19,9,10,0,0.9
unaxes,0,6,3,3,0,1
bowsings,0,8,2,6,0,0.333333333333333
chorizontic,1,11,4,7,0,0.571428571428571
nateed,0,6,3,3,0,1
logoff,1,6,2,4,0,0.5
moorgate,1,8,4,4,0,1
bspe,1,4,1,3,0,0.333333333333333
circumductive,0,13,5,8,0,0.625
if'vek'uqhxgvrjfbyia,0,20,5,15,2,0.333333333333333
mzgikfnalhafe,0,13,4,9,0,0.444444444444444
tfyctjyevu,0,10,2,8,0,0.25
fragmentatively,0,15,5,10,0,0.5
decanthocus,0,11,4,7,0,0.571428571428571
leptin,1,6,2,4,0,0.5
clamper,1,7,2,5,0,0.4
sphate,0,6,2,4,0,0.5
antifier,0,8,4,4,0,1
deaerator,1,9,5,4,0,1.25
constatations,1,13,5,8,0,0.625
immanus,0,7,3,4,0,0.75
glzbmuhotkgrw,0,13,2,11,0,0.181818181818182
engers,0,6,2,4,0,0.5
plummlersavicincormellangly,0,27,8,19,0,0.421052631578947
apdu,1,4,2,2,0,1
ploughwright,1,12,3,9,0,0.333333333333333
nolynescsarbrvydaugeetemas,0,26,9,17,0,0.529411764705882
misgrades,1,9,3,6,0,0.5
officialisation,1,15,8,7,0,1.14285714285714
lavalava,1,8,4,4,0,1
jesuist,1,7,3,4,0,0.75
microlithiformed,0,16,6,10,0,0.6
fugally,1,7,2,5,0,0.4
crowliegermist,0,14,5,9,0,0.555555555555556
roundo,1,6,3,3,0,1
frigots,1,7,2,5,0,0.4
sollicker,1,9,3,6,0,0.5
biosa,0,5,3,2,0,1.5
nium,0,4,2,2,0,1
nonnarrative,1,12,5,7,0,0.714285714285714
petrea,1,6,3,3,0,1
trauner,1,7,3,4,0,0.75
fishbein,1,8,3,5,0,0.6
acks,0,4,1,3,0,0.333333333333333
crucidslucla,0,12,4,8,0,0.5
demantoid,1,9,4,5,0,0.8
nonpassionate,1,13,6,7,0,0.857142857142857
hamamelidaceous,1,15,8,7,0,1.14285714285714
orseille,1,8,4,4,0,1
ovaj,0,4,2,2,0,1
metaphysical,1,12,4,8,0,0.5
preconcertedness,1,16,5,11,0,0.454545454545455
becarpeting,1,11,4,7,0,0.571428571428571
rexis,0,5,2,3,0,0.666666666666667
yahwe,1,5,2,3,0,0.666666666666667
yaobabbitterelacensonabsoluto,0,29,13,16,0,0.8125
microphagocytical,0,17,6,11,0,0.545454545454545
halalithuses,0,12,5,7,0,0.714285714285714
musnudger,0,9,3,6,0,0.5
lairdsville,1,11,4,7,0,0.571428571428571
apostolian,1,10,5,5,0,1
rmeyes,0,6,2,4,0,0.5
anticommercialist,1,17,7,10,0,0.7
austin,1,6,3,3,0,1
overfastidiously,1,16,7,9,0,0.777777777777778
prevising,1,9,3,6,0,0.5
rapidest,1,8,3,5,0,0.6
cantoris,1,8,3,5,0,0.6
enjambements,1,12,4,8,0,0.5
immering,0,8,3,5,0,0.6
tous,0,4,2,2,0,1
rtonctis,0,8,2,6,0,0.333333333333333
maguayulette,0,12,6,6,0,1
tprdzlqaf'geohmirugwhs'xvlbvk,0,29,5,24,2,0.208333333333333
syrets,0,6,1,5,0,0.2
coryphee,1,8,3,5,0,0.6
ovellectionsprians,0,18,7,11,0,0.636363636363636
barrette,1,8,3,5,0,0.6
fendillate,1,10,4,6,0,0.666666666666667
glacialist,1,10,4,6,0,0.666666666666667
douglassful,0,11,4,7,0,0.571428571428571
plc,1,3,0,3,0,0
nonlacteous,1,11,5,6,0,0.833333333333333
oneillin,0,8,4,4,0,1
laria,1,5,3,2,0,1.5
reemergent,1,10,4,6,0,0.666666666666667
visualising,1,11,5,6,0,0.833333333333333
parly,1,5,1,4,0,0.25
hyalinisation,1,13,6,7,0,0.857142857142857
carbureted,1,10,4,6,0,0.666666666666667
dijkstra,1,8,2,6,0,0.333333333333333
gimpion,0,7,3,4,0,0.75
sarto,1,5,2,3,0,0.666666666666667
hirundinidae,1,12,6,6,0,1
glucosia,0,8,4,4,0,1
preacesciny,0,11,4,7,0,0.571428571428571
eyeleting,1,9,4,5,0,0.8
kepu,0,4,2,2,0,1
zene,0,4,2,2,0,1
adiarceammasunverst,0,19,8,11,0,0.727272727272727
clericalist,1,11,4,7,0,0.571428571428571
anebiss,0,7,3,4,0,0.75
sunbaubolaylyr,0,14,5,9,0,0.555555555555556
pyrrhalf,0,8,1,7,0,0.142857142857143
seless,0,6,2,4,0,0.5
onolv,0,5,2,3,0,0.666666666666667
mealworm,1,8,3,5,0,0.6
honamecolemy,0,12,5,7,0,0.714285714285714
buchloe,1,7,3,4,0,0.75
heliolitidae,1,12,7,5,0,1.4
telekiness,0,10,4,6,0,0.666666666666667
hydroxides,1,10,3,7,0,0.428571428571429
butchering,1,10,3,7,0,0.428571428571429
lgajcfndeeskmafeflfbq'dkh,0,25,5,20,1,0.25
overbuilds,1,10,4,6,0,0.666666666666667
antenatally,1,11,4,7,0,0.571428571428571
xafogdfoetpilypi'lskys,0,22,6,16,1,0.375
crinanqugrs,0,11,3,8,0,0.375
xrjdhemrrfugiq'',0,16,3,13,2,0.230769230769231
ctenodont,1,9,3,6,0,0.5
vascernes,0,9,3,6,0,0.5
restrains,1,9,3,6,0,0.5
latshealy,0,9,3,6,0,0.5
clerodac,0,8,3,5,0,0.6
acina,0,5,3,2,0,1.5
picofarad,1,9,4,5,0,0.8
kindleman,0,9,3,6,0,0.5
uranoscope,1,10,5,5,0,1
silvan,1,6,2,4,0,0.5
gambreled,1,9,3,6,0,0.5
telepiser,0,9,4,5,0,0.8
unfruitfulness,1,14,5,9,0,0.555555555555556
bg,1,2,0,2,0,0
shoer,1,5,2,3,0,0.666666666666667
sesquisextal,1,12,5,7,0,0.714285714285714
liniment,1,8,3,5,0,0.6
pselar,0,6,2,4,0,0.5
beelol,1,6,3,3,0,1
hppuqxjmgutamofypglfhtdrfyehlj,0,30,5,25,0,0.2
clansman,1,8,2,6,0,0.333333333333333
chies,0,5,2,3,0,0.666666666666667
mithraist,1,9,3,6,0,0.5
farcer,1,6,2,4,0,0.5
hootling,0,8,3,5,0,0.6
amnio,1,5,3,2,0,1.5
overshowering,1,13,5,8,0,0.625
octocoralline,1,13,6,7,0,0.857142857142857
scilithol,0,9,3,6,0,0.5
kxpljmhwpfvy'bweqn,0,18,1,17,1,0.0588235294117647
polk,1,4,1,3,0,0.333333333333333
therdivlonst,0,12,3,9,0,0.333333333333333
quaal,0,5,3,2,0,1.5
jzgzkglda'ozhrwy,0,16,2,14,1,0.142857142857143
qgkynzgwr'jrra,0,14,1,13,1,0.0769230769230769
cully,1,5,1,4,0,0.25
indentureship,1,13,5,8,0,0.625
thjatsi,1,7,2,5,0,0.4
homalgenes,0,10,4,6,0,0.666666666666667
elevated,1,8,4,4,0,1
subsence,0,8,3,5,0,0.6
syzygial,1,8,2,6,0,0.333333333333333
shipman,1,7,2,5,0,0.4
abstractionisms,1,15,5,10,0,0.5
nonconculiacyte,0,15,6,9,0,0.666666666666667
cleares,0,7,3,4,0,0.75
mixicky,0,7,2,5,0,0.4
compromisee,0,11,5,6,0,0.833333333333333
dysphenograph,0,13,3,10,0,0.3
sense,1,5,2,3,0,0.666666666666667
ety,0,3,1,2,0,0.5
buwkifhfstjg'qoevvgmylkch,0,25,4,21,1,0.19047619047619
paratheas,0,9,4,5,0,0.8
mixednesses,1,11,4,7,0,0.571428571428571
kdzw'qfbbg,0,10,0,10,1,0
stenobly,0,8,2,6,0,0.333333333333333
tinding,1,7,2,5,0,0.4
vh'peuqnrrhhapck,0,16,3,13,1,0.230769230769231
exopterygidae,0,13,6,7,0,0.857142857142857
faucers,0,7,3,4,0,0.75
tailly,0,6,2,4,0,0.5
unsconne,0,8,3,5,0,0.6
rnzgipqze'vmqaovunda,0,20,6,14,1,0.428571428571429
oaduistoury,0,11,6,5,0,1.2
ngrssmul,0,8,1,7,0,0.142857142857143
dise,0,4,2,2,0,1
temedigeespational,0,18,9,9,0,1
dophic,0,6,2,4,0,0.5
varembe,0,7,3,4,0,0.75
hamanly,0,7,2,5,0,0.4
bxzlu'odyvuihiumjs,0,18,6,12,1,0.5
rockholmeter,0,12,4,8,0,0.5
ferth,1,5,1,4,0,0.25
proration,1,9,4,5,0,0.8
chiller,1,7,2,5,0,0.4
preiser,1,7,3,4,0,0.75
schismatised,1,12,4,8,0,0.5
corabella,1,9,4,5,0,0.8
bzf'p'fxdp'ivjpicoqo,0,20,4,16,3,0.25
chinnam,1,7,2,5,0,0.4
cameis,0,6,3,3,0,1
segainnemopterionoid,0,20,10,10,0,1
octose,1,6,3,3,0,1
dq,1,2,0,2,0,0
synding,1,7,1,6,0,0.166666666666667
kejdczkuaflrxibsuallhha,0,23,7,16,0,0.4375
ymtvdopfvbnckuh,0,15,2,13,0,0.153846153846154
umpirages,1,9,4,5,0,0.8
bukehunathra,0,12,5,7,0,0.714285714285714
enas,0,4,2,2,0,1
fluors,1,6,2,4,0,0.5
marris,1,6,2,4,0,0.5
dermatothertone,0,15,6,9,0,0.666666666666667
hlsietin,0,8,3,5,0,0.6
mayor,1,5,2,3,0,0.666666666666667
polyaxial,1,9,4,5,0,0.8
spallings,1,9,2,7,0,0.285714285714286
upcurledly,0,10,3,7,0,0.428571428571429
motif,1,5,2,3,0,0.666666666666667
uctdqroomc,0,10,3,7,0,0.428571428571429
ohioan,1,6,4,2,0,2
prao,1,4,2,2,0,1
tecouaneses,0,11,6,5,0,1.2
overdistance,1,12,5,7,0,0.714285714285714
linendraper,1,11,4,7,0,0.571428571428571
blileowas,0,9,4,5,0,0.8
wedpbzxjunrcjzhnlkuepoqm,0,24,5,19,0,0.263157894736842
snaking,1,7,2,5,0,0.4
hawkeye,1,7,3,4,0,0.75
ensbelleceil,0,12,5,7,0,0.714285714285714
alveary,1,7,3,4,0,0.75
loganton,1,8,3,5,0,0.6
fornix,1,6,2,4,0,0.5
greasiness,1,10,4,6,0,0.666666666666667
hebraicise,1,10,5,5,0,1
woodstock,1,9,3,6,0,0.5
iodinophilia,0,12,7,5,0,1.4
legitime,1,8,4,4,0,1
magisteriums,1,12,5,7,0,0.714285714285714
unobligative,1,12,6,6,0,1
wlqhihozkwjpjrl',0,16,2,14,1,0.142857142857143
aphalate,0,8,4,4,0,1
melotragic,1,10,4,6,0,0.666666666666667
bohme,1,5,2,3,0,0.666666666666667
paterson,1,8,3,5,0,0.6
gongology,0,9,3,6,0,0.5
quatrin,1,7,3,4,0,0.75
poneramoeba,1,11,6,5,0,1.2
adele,1,5,3,2,0,1.5
uncart,1,6,2,4,0,0.5
klestintine,0,11,4,7,0,0.571428571428571
forintegrange,0,13,5,8,0,0.625
quadrinomial,1,12,6,6,0,1
upbrast,1,7,2,5,0,0.4
centimana,0,9,4,5,0,0.8
allians,0,7,3,4,0,0.75
rearbrus,0,8,3,5,0,0.6
secretest,1,9,3,6,0,0.5
unthinning,1,10,3,7,0,0.428571428571429
mspithpzzvvrh,0,13,1,12,0,0.0833333333333333
unavertable,1,11,5,6,0,0.833333333333333
odourlessness,0,13,5,8,0,0.625
gopvsbcblggk'qtfohdabexg,0,24,4,20,1,0.2
autobacterio,0,12,7,5,0,1.4
cephalaspis,1,11,4,7,0,0.571428571428571
goner,1,5,2,3,0,0.666666666666667
fahypatowissorisckaincagntht,0,28,9,19,0,0.473684210526316
laulau,1,6,4,2,0,2
ophthalmia,1,10,4,6,0,0.666666666666667
ter,0,3,1,2,0,0.5
titanesque,1,10,5,5,0,1
falky,0,5,1,4,0,0.25
gwpyqbqrdbktcvflnagpk,0,21,1,20,0,0.05
bekallawinotration,0,18,8,10,0,0.8
cvr,1,3,0,3,0,0
sellbacks,1,9,2,7,0,0.285714285714286
sternberg,1,9,2,7,0,0.285714285714286
preevolutionist,1,15,7,8,0,0.875
epirus,1,6,3,3,0,1
qozshhm''im,0,11,2,9,2,0.222222222222222
myography,1,9,2,7,0,0.285714285714286
ctictes,0,7,2,5,0,0.4
eskishehir,1,10,4,6,0,0.666666666666667
ginn,1,4,1,3,0,0.333333333333333
gaedelia,0,8,5,3,0,1.66666666666667
malive,0,6,3,3,0,1
theorematic,1,11,5,6,0,0.833333333333333
palip,0,5,2,3,0,0.666666666666667
swifters,1,8,2,6,0,0.333333333333333
premolarisa,0,11,5,6,0,0.833333333333333
foreductorly,0,12,4,8,0,0.5
kyrbxcoptcvxzkeyjrnryda'dsl,0,27,3,24,1,0.125
scatterpunctuate,0,16,6,10,0,0.6
unsensitiveness,0,15,6,9,0,0.666666666666667
dyssyner,0,8,1,7,0,0.142857142857143
unchristochondroid,0,18,6,12,0,0.5
laodicea,1,8,5,3,0,1.66666666666667
unconfutations,0,14,6,8,0,0.75
defless,0,7,2,5,0,0.4
balemyorforynzirtieconglifiscaroveurenedd,0,41,16,25,0,0.64
mesiestle,0,9,4,5,0,0.8
sleepover,1,9,4,5,0,0.8
zimmerman,1,9,3,6,0,0.5
eraxitidghe,0,11,5,6,0,0.833333333333333
caling,0,6,2,4,0,0.5
funinarinatetugummarodrrce,0,26,11,15,0,0.733333333333333
wentzville,1,10,3,7,0,0.428571428571429
plotinize,1,9,4,5,0,0.8
broot,0,5,2,3,0,0.666666666666667
hycupidromaldaibialayring,0,25,10,15,0,0.666666666666667
chaule,1,6,3,3,0,1
maunobna,0,8,4,4,0,1
spectroheliograph,1,17,6,11,0,0.545454545454545
supzzrkwmx'ri,0,13,2,11,1,0.181818181818182
funinenvegmero,0,14,6,8,0,0.75
xtej,0,4,1,3,0,0.333333333333333
reunites,1,8,4,4,0,1
ibrinally,0,9,3,6,0,0.5
gapingly,1,8,2,6,0,0.333333333333333
isodef,1,6,3,3,0,1
redamn,0,6,2,4,0,0.5
inviability,1,11,5,6,0,0.833333333333333
unparaded,1,9,4,5,0,0.8
plumpf,0,6,1,5,0,0.2
ueausdfjscixbpmbkisqkb',0,23,6,17,1,0.352941176470588
uuyilojdoojs,0,12,6,6,0,1
unacceptant,1,11,4,7,0,0.571428571428571
reattributional,0,15,7,8,0,0.875
unresearchaeophobia,0,19,10,9,0,1.11111111111111
xylomelum,1,9,3,6,0,0.5
qulmqcmflo'ehgrbajr,0,19,4,15,1,0.266666666666667
engird,1,6,2,4,0,0.5
xfixdgufvwqdfldmuixzm,0,21,4,17,0,0.235294117647059
aromatherapies,1,14,7,7,0,1
iulidae,0,7,5,2,0,2.5
electrostaticovesical,0,21,9,12,0,0.75
outcompletely,0,13,5,8,0,0.625
ccexyx,0,6,1,5,0,0.2
terebinthus,1,11,4,7,0,0.571428571428571
choth,0,5,1,4,0,0.25
ejupollll,0,9,3,6,0,0.5
gbgluzfyf'kv,0,12,1,11,1,0.0909090909090909
adsorbed,1,8,3,5,0,0.6
himora,0,6,3,3,0,1
izcates,0,7,3,4,0,0.75
ura,0,3,2,1,0,2
quadrinucleate,1,14,7,7,0,1
oalonachinghycaswes,0,19,7,12,0,0.583333333333333
phyte,0,5,1,4,0,0.25
haersprinifermerhermeoitato,0,27,12,15,0,0.8
unmasker,1,8,3,5,0,0.6
inspirometry,0,12,4,8,0,0.5
pzzevgeewnaqaxstduop,0,20,7,13,0,0.538461538461538
dinnidechlcele,0,14,5,9,0,0.555555555555556
taighthooles,0,12,5,7,0,0.714285714285714
bograpotrocomenismargishroin,0,28,11,17,0,0.647058823529412
xyodcurbyhcvy,0,13,2,11,0,0.181818181818182
cousing,0,7,3,4,0,0.75
vetipjyzdmeifmwydvyeban,0,23,6,17,0,0.352941176470588
ointness,0,8,3,5,0,0.6
teda,1,4,2,2,0,1
briggs,1,6,1,5,0,0.2
arales,1,6,3,3,0,1
underbushing,1,12,4,8,0,0.5
semimamidstrousingly,0,20,7,13,0,0.538461538461538
petals,1,6,2,4,0,0.5
unback,0,6,2,4,0,0.5
underareadipstergee,0,19,9,10,0,0.9
seed,1,4,2,2,0,1
antetype,1,8,3,5,0,0.6
wassyngton,1,10,2,8,0,0.25
zanetinmitetinchwgatellinthantroncotresicerw,0,44,15,29,0,0.517241379310345
guardist,0,8,3,5,0,0.6
slinc,0,5,1,4,0,0.25
c'uqnmotbavkxjxysppuv,0,21,4,17,1,0.235294117647059
mlsshad,0,7,1,6,0,0.166666666666667
pachophaniflupulogistondermasivowpereowe,0,40,17,23,0,0.739130434782609
heny,0,4,1,3,0,0.333333333333333
paysagist,1,9,3,6,0,0.5
nonchopelverles,0,15,5,10,0,0.5
posceptic,0,9,3,6,0,0.5
ders,0,4,1,3,0,0.333333333333333
ency,0,4,1,3,0,0.333333333333333
mematics,0,8,3,5,0,0.6
rosanna,1,7,3,4,0,0.75
oxgates,1,7,3,4,0,0.75
broccoli,1,8,3,5,0,0.6
microhabitat,1,12,5,7,0,0.714285714285714
jekxlx'rgmnfjvylaaouilep,0,24,7,17,1,0.411764705882353
uncoveterandish,0,15,6,9,0,0.666666666666667
islay,1,5,2,3,0,0.666666666666667
elodeaceae,1,10,7,3,0,2.33333333333333
heletoniac,0,10,5,5,0,1
comonic,0,7,3,4,0,0.75
aeolocorrhagy,0,13,6,7,0,0.857142857142857
crion,0,5,2,3,0,0.666666666666667
enarthrodia,1,11,5,6,0,0.833333333333333
malblikacuspeg,0,14,5,9,0,0.555555555555556
hed,0,3,1,2,0,0.5
pfosi,1,5,2,3,0,0.666666666666667
sysgenicisation,0,15,6,9,0,0.666666666666667
papaws,1,6,2,4,0,0.5
hannally,0,8,2,6,0,0.333333333333333
fornlanculper,0,13,4,9,0,0.444444444444444
zippingly,1,9,2,7,0,0.285714285714286
blles,0,5,1,4,0,0.25
cakiness,1,8,3,5,0,0.6
polypothermen,0,13,4,9,0,0.444444444444444
hydragrook,0,10,3,7,0,0.428571428571429
leriomisetaiivelor,0,18,10,8,0,1.25
telemeteorograph,1,16,7,9,0,0.777777777777778
nonsanguishment,0,15,5,10,0,0.5
xohkpx'dysuthkhgt,0,17,2,15,1,0.133333333333333
enlevements,1,11,4,7,0,0.571428571428571
assogram,0,8,3,5,0,0.6
ypaorrcjpmqdtnamhhnqoehekmyrzi,0,30,7,23,0,0.304347826086957
archimattergregnant,0,19,6,13,0,0.461538461538462
caiacelicoulliade,0,17,10,7,0,1.42857142857143
nonsubjectival,0,14,5,9,0,0.555555555555556
dowsmosave,0,10,4,6,0,0.666666666666667
whiskers,1,8,2,6,0,0.333333333333333
prazosins,1,9,3,6,0,0.5
guacate,0,7,4,3,0,1.33333333333333
rebreeding,1,10,4,6,0,0.666666666666667
joyless,1,7,2,5,0,0.4
mpongergrealuontineteriskerolytenascatela,0,41,17,24,0,0.708333333333333
nonnah,1,6,2,4,0,0.5
rhvs,0,4,0,4,0,0
hyropity,0,8,2,6,0,0.333333333333333
giacobo,1,7,4,3,0,1.33333333333333
storybook,1,9,3,6,0,0.5
preparathyronises,0,17,6,11,0,0.545454545454545
entish,0,6,2,4,0,0.5
vardon,1,6,2,4,0,0.5
trypanosomes,1,12,4,8,0,0.5
atha,0,4,2,2,0,1
ataung,0,6,3,3,0,1
rschusep,0,8,2,6,0,0.333333333333333
unsubstantialnesses,0,19,7,12,0,0.583333333333333
morpinside,0,10,4,6,0,0.666666666666667
coggliest,1,9,3,6,0,0.5
wolving,1,7,2,5,0,0.4
bussy,1,5,1,4,0,0.25
newstail,0,8,3,5,0,0.6
solsospeall,0,11,4,7,0,0.571428571428571
znl'bbbxzfmqxrfatfjkd,0,21,1,20,1,0.05
multitasks,1,10,3,7,0,0.428571428571429
retise,0,6,3,3,0,1
discriminated,1,13,5,8,0,0.625
dialecticant,0,12,5,7,0,0.714285714285714
bytgjwfstwdz,0,12,0,12,0,0
brahambolyttle,0,14,4,10,0,0.4
kraffest,0,8,2,6,0,0.333333333333333
preministry,1,11,3,8,0,0.375
enlutedly,0,9,3,6,0,0.5
liqualay,0,8,4,4,0,1
restaurations,1,13,6,7,0,0.857142857142857
fuban,0,5,2,3,0,0.666666666666667
hesperiid,1,9,4,5,0,0.8
kkoye,0,5,2,3,0,0.666666666666667
kstiedicetel,0,12,5,7,0,0.714285714285714
repatterns,1,10,3,7,0,0.428571428571429
seoieainanese,0,13,9,4,0,2.25
myriapod,1,8,3,5,0,0.6
endochorionic,1,13,6,7,0,0.857142857142857
autoexposure,1,12,7,5,0,1.4
aguxcfzyavkchftq,0,16,3,13,0,0.230769230769231
promuscises,1,11,4,7,0,0.571428571428571
countia,0,7,4,3,0,1.33333333333333
creasol,1,7,3,4,0,0.75
utediodonterbis,0,15,7,8,0,0.875
aftercure,1,9,4,5,0,0.8
aviator,1,7,4,3,0,1.33333333333333
undiscipliness,0,14,5,9,0,0.555555555555556
washmaid,1,8,3,5,0,0.6
andese,0,6,3,3,0,1
stormville,1,10,3,7,0,0.428571428571429
cinchoninic,1,11,4,7,0,0.571428571428571
umidlotrmosc,0,12,4,8,0,0.5
niparoch,0,8,3,5,0,0.6
mitokoromono,1,12,6,6,0,1
ooconitnerivvyrmornisopactia,0,28,12,16,0,0.75
meredithville,1,13,5,8,0,0.625
cflwlfrszmuflgloip'k,0,20,3,17,1,0.176470588235294
hippidion,1,9,4,5,0,0.8
snaterita,0,9,4,5,0,0.8
unshivering,1,11,4,7,0,0.571428571428571
spermicide,1,10,4,6,0,0.666666666666667
unprofunditorial,0,16,7,9,0,0.777777777777778
unbewitched,1,11,4,7,0,0.571428571428571
htcf',0,5,0,5,1,0
beaman,1,6,3,3,0,1
precterce,0,9,3,6,0,0.5
desantis,1,8,3,5,0,0.6
activitalis,0,11,5,6,0,0.833333333333333
cyl'nbglatlhq,0,13,1,12,1,0.0833333333333333
xfwtfxvjykgtuffyswdm'lzzkuis,0,28,3,25,1,0.12
qa'kobqnxtic'ye,0,15,4,11,2,0.363636363636364
spxpisgvx,0,9,1,8,0,0.125
correctionville,1,15,6,9,0,0.666666666666667
loqrmbwfeigbofgyz,0,17,4,13,0,0.307692307692308
capitaling,1,10,4,6,0,0.666666666666667
dyikm,0,5,1,4,0,0.25
pedimental,1,10,4,6,0,0.666666666666667
tummersault,0,11,4,7,0,0.571428571428571
ellipsograph,1,12,4,8,0,0.5
bahaistica,0,10,5,5,0,1
pomato,1,6,3,3,0,1
apocalypse,1,10,4,6,0,0.666666666666667
mitee,0,5,3,2,0,1.5
loulnzwzoqpj,0,12,3,9,0,0.333333333333333
f'xoexgshfikgbhws'yexyhyjh,0,26,4,22,2,0.181818181818182
endangiitis,1,11,5,6,0,0.833333333333333
canoninae,0,9,5,4,0,1.25
intermezzo,1,10,4,6,0,0.666666666666667
reconflomaria,0,13,6,7,0,0.857142857142857
unesishinakhae,0,14,7,7,0,1
hewable,1,7,3,4,0,0.75
circumfuse,1,10,4,6,0,0.666666666666667
unbequeathalysite,0,17,8,9,0,0.888888888888889
lacrothcbacenetchitinevermushoxationcese,0,40,16,24,0,0.666666666666667
unbreediscosta,0,14,6,8,0,0.75
palaeechingly,0,13,5,8,0,0.625
und,0,3,1,2,0,0.5
electal,0,7,3,4,0,0.75
squisultanisms,0,14,5,9,0,0.555555555555556
contemplate,1,11,4,7,0,0.571428571428571
hytqbmqhorue,0,12,3,9,0,0.333333333333333
xz'vujpnq',0,10,1,9,2,0.111111111111111
ypsilanti,1,9,3,6,0,0.5
nonirritancy,1,12,4,8,0,0.5
canisters,1,9,3,6,0,0.5
monarchiannelid,0,15,6,9,0,0.666666666666667
analyzer,0,8,3,5,0,0.6
fanticards,0,10,3,7,0,0.428571428571429
enragement,1,10,4,6,0,0.666666666666667
ushiabasveripale,0,16,8,8,0,1
bidons,1,6,2,4,0,0.5
krameria,1,8,4,4,0,1
molecularity,1,12,5,7,0,0.714285714285714
pushinonbanters,0,15,5,10,0,0.5
larcallativalfher,0,17,6,11,0,0.545454545454545
fadnadoblenyerasted,0,19,7,12,0,0.583333333333333
rotises,0,7,3,4,0,0.75
reterminemake,0,13,6,7,0,0.857142857142857
asapanaxims,0,11,5,6,0,0.833333333333333
plugman,1,7,2,5,0,0.4
anoist,0,6,3,3,0,1
surnamers,1,9,3,6,0,0.5
hallowedly,1,10,3,7,0,0.428571428571429
tumming,0,7,2,5,0,0.4
clemmons,1,8,2,6,0,0.333333333333333
marygwhemelat,0,13,4,9,0,0.444444444444444
'dms'cxiehs''mlggosuuxxmmtiot,0,29,7,22,4,0.318181818181818
pedantocratically,0,17,6,11,0,0.545454545454545
conflictively,0,13,4,9,0,0.444444444444444
incienium,0,9,5,4,0,1.25
apollonic,1,9,4,5,0,0.8
perovskia,1,9,4,5,0,0.8
androphore,1,10,4,6,0,0.666666666666667
rehistricide,0,12,5,7,0,0.714285714285714
bengal,1,6,2,4,0,0.5
bdella,0,6,2,4,0,0.5
trochiluli,1,10,4,6,0,0.666666666666667
wkwrdnwixcqst,0,13,1,12,0,0.0833333333333333
eurebayens,0,10,5,5,0,1
micrifies,1,9,4,5,0,0.8
bratarius,0,9,4,5,0,0.8
ptyalises,1,9,3,6,0,0.5
mcgawed,0,7,2,5,0,0.4
profundities,1,12,5,7,0,0.714285714285714
yne,0,3,1,2,0,0.5
misseats,1,8,3,5,0,0.6
interdigital,1,12,5,7,0,0.714285714285714
pedise,0,6,3,3,0,1
qphldwnzyikw,0,12,1,11,0,0.0909090909090909
fabrillo,0,8,3,5,0,0.6
panax,1,5,2,3,0,0.666666666666667
coproteleonic,0,13,6,7,0,0.857142857142857
undisprovidence,0,15,6,9,0,0.666666666666667
steendosenfludootogingbo,0,24,10,14,0,0.714285714285714
heralded,1,8,3,5,0,0.6
cmxomqdshaw,0,11,2,9,0,0.222222222222222
ves,0,3,1,2,0,0.5
creatureling,1,12,5,7,0,0.714285714285714
lazeangy,0,8,3,5,0,0.6
improficients,0,13,5,8,0,0.625
orthographer,1,12,4,8,0,0.5
abassieh,1,8,4,4,0,1
ustiegicophsiowhetet,0,20,9,11,0,0.818181818181818
chronocarator,1,13,5,8,0,0.625
interville,0,10,4,6,0,0.666666666666667
astronavigators,1,15,6,9,0,0.666666666666667
radiochromes,0,12,5,7,0,0.714285714285714
occult,1,6,2,4,0,0.5
belvedercircling,0,16,5,11,0,0.454545454545455
hurloughs,0,9,3,6,0,0.5
adenopharynx,0,12,4,8,0,0.5
cacks,1,5,1,4,0,0.25
lorales,0,7,3,4,0,0.75
aleichem,1,8,4,4,0,1
genetyllis,1,10,3,7,0,0.428571428571429
autoerotism,1,11,6,5,0,1.2
wn,0,2,0,2,0,0
moralists,1,9,3,6,0,0.5
fairnitickless,0,14,5,9,0,0.555555555555556
lucrum,1,6,2,4,0,0.5
neumatical,0,10,5,5,0,1
rhabdoidal,1,10,4,6,0,0.666666666666667
predynastic,1,11,3,8,0,0.375
canising,0,8,3,5,0,0.6
gvxj'jz,0,7,0,7,1,0
broncobusters,1,13,4,9,0,0.444444444444444
missileman,1,10,4,6,0,0.666666666666667
richardsonia,1,12,5,7,0,0.714285714285714
makeovers,1,9,4,5,0,0.8
nering,0,6,2,4,0,0.5
supersympathy,1,13,3,10,0,0.3
ruffestinian,0,12,5,7,0,0.714285714285714
broupet,0,7,3,4,0,0.75
decomposability,1,15,6,9,0,0.666666666666667
kistation,0,9,4,5,0,0.8
rk'yspxz'ypj'bpmvqu,0,19,1,18,3,0.0555555555555556
comelantheednes,0,15,6,9,0,0.666666666666667
heydrich,1,8,2,6,0,0.333333333333333
tpvxn,0,5,0,5,0,0
imposthume,1,10,4,6,0,0.666666666666667
piezoelectroform,0,16,7,9,0,0.777777777777778
bracip,0,6,2,4,0,0.5
stitishlungfetterouver,0,22,8,14,0,0.571428571428571
rzwgoerjhnd,0,11,2,9,0,0.222222222222222
oversand,1,8,3,5,0,0.6
nhs'wlufxqbhvg'xf,0,17,1,16,2,0.0625
palaeoclimatology,1,17,8,9,0,0.888888888888889
thermopylae,1,11,4,7,0,0.571428571428571
calcareosulphurous,1,18,8,10,0,0.8
piste,1,5,2,3,0,0.666666666666667
jzvxieuwkczyij,0,14,4,10,0,0.4
masspriest,1,10,3,7,0,0.428571428571429
internarial,1,11,5,6,0,0.833333333333333
mount,1,5,2,3,0,0.666666666666667
pallahs,1,7,2,5,0,0.4
jcfvfkbctpp,0,11,0,11,0,0
batiba,0,6,3,3,0,1
alpoca,1,6,3,3,0,1
pandurah,0,8,3,5,0,0.6
catics,0,6,2,4,0,0.5
tsarevna,1,8,3,5,0,0.6
doless,1,6,2,4,0,0.5
graforevich,0,11,4,7,0,0.571428571428571
studderhood,0,11,4,7,0,0.571428571428571
potboilers,1,10,4,6,0,0.666666666666667
lec,1,3,1,2,0,0.5
sanionistran,0,12,5,7,0,0.714285714285714
topographical,1,13,5,8,0,0.625
babyishly,1,9,2,7,0,0.285714285714286
rhodic,1,6,2,4,0,0.5
subscribbos,0,11,3,8,0,0.375
ozzy,1,4,1,3,0,0.333333333333333
agricolite,1,10,5,5,0,1
mimesis,1,7,3,4,0,0.75
frink,1,5,1,4,0,0.25
psiloid,0,7,3,4,0,0.75
grundying,0,9,2,7,0,0.285714285714286
whiskerlike,1,11,4,7,0,0.571428571428571
tapacura,1,8,4,4,0,1
lyophilizer,1,11,4,7,0,0.571428571428571
sweeping,1,8,3,5,0,0.6
pradhana,1,8,3,5,0,0.6
hyaenarctos,1,11,4,7,0,0.571428571428571
apelequthsur,0,12,5,7,0,0.714285714285714
chus,0,4,1,3,0,0.333333333333333
microhymenoptera,1,16,6,10,0,0.6
heredithian,0,11,5,6,0,0.833333333333333
tzvsjyzidabhdiztol,0,18,4,14,0,0.285714285714286
cloke,1,5,2,3,0,0.666666666666667
phlebectasis,1,12,4,8,0,0.5
reprecipitation,1,15,7,8,0,0.875
gryphaea,1,8,3,5,0,0.6
pseudopodium,1,12,6,6,0,1
steenagonen,0,11,5,6,0,0.833333333333333
mintitrawaliwing,0,16,6,10,0,0.6
bushwhackers,1,12,3,9,0,0.333333333333333
waldea,0,6,3,3,0,1
goldfinnies,1,11,4,7,0,0.571428571428571
ryxdgxvq,0,8,0,8,0,0
impolished,1,10,4,6,0,0.666666666666667
jandals,1,7,2,5,0,0.4
pittering,1,9,3,6,0,0.5
intratracheally,1,15,5,10,0,0.5
ticinazeemonacoston,0,19,9,10,0,0.9
surrenderer,1,11,4,7,0,0.571428571428571
invades,1,7,3,4,0,0.75
discolorations,1,14,6,8,0,0.75
rassles,1,7,2,5,0,0.4
hairweaver,1,10,5,5,0,1
resistor,1,8,3,5,0,0.6
westmeath,1,9,3,6,0,0.5
marshalltown,1,12,3,9,0,0.333333333333333
gannet,1,6,2,4,0,0.5
reconceptualisation,1,19,9,10,0,0.9
baycuru,1,7,3,4,0,0.75
poxyhem,0,7,2,5,0,0.4
wurley,0,6,2,4,0,0.5
prdaylenichoves,0,15,5,10,0,0.5
fragment,1,8,2,6,0,0.333333333333333
abominableness,1,14,6,8,0,0.75
ahor,0,4,2,2,0,1
nobasts,0,7,2,5,0,0.4
undrab,1,6,2,4,0,0.5
romanic,1,7,3,4,0,0.75
coalescency,1,11,4,7,0,0.571428571428571
equipartition,1,13,7,6,0,1.16666666666667
vering,0,6,2,4,0,0.5
midzahhoi,0,9,4,5,0,0.8
horseshiasio,0,12,6,6,0,1
swastica,1,8,3,5,0,0.6
caboceers,1,9,4,5,0,0.8
sardonical,1,10,4,6,0,0.666666666666667
unrum,0,5,2,3,0,0.666666666666667
liew,1,4,2,2,0,1
interbbred,1,10,3,7,0,0.428571428571429
odghzpjfqltfokdmfoitdikq,0,24,5,19,0,0.263157894736842
macers,1,6,2,4,0,0.5
rota,1,4,2,2,0,1
reconclusion,1,12,5,7,0,0.714285714285714
precapitalist,1,13,5,8,0,0.625
wayside,1,7,3,4,0,0.75
lepjy,0,5,1,4,0,0.25
backhoes,1,8,3,5,0,0.6
nonsynonyms,0,11,2,9,0,0.222222222222222
merphilinism,0,12,4,8,0,0.5
gabriell,1,8,3,5,0,0.6
ercakyxiabit,0,12,5,7,0,0.714285714285714
subrigidly,1,10,3,7,0,0.428571428571429
nizam,1,5,2,3,0,0.666666666666667
nesxpwerdn,0,10,2,8,0,0.25
xylinid,1,7,2,5,0,0.4
gbesz,0,5,1,4,0,0.25
unsmugness,1,10,3,7,0,0.428571428571429
nonsynthesianised,0,17,6,11,0,0.545454545454545
fouqu,1,5,3,2,0,1.5
calif,1,5,2,3,0,0.666666666666667
gomatolucifiatreness,0,20,9,11,0,0.818181818181818
imo,1,3,2,1,0,2
distingly,0,9,2,7,0,0.285714285714286
talancalcidal,0,13,5,8,0,0.625
undead,1,6,3,3,0,1
vufj'lgoqgbdbjinnwxxmau,0,23,5,18,1,0.277777777777778
unlettableness,0,14,5,9,0,0.555555555555556
yfqdd'mwwhhadukedka,0,19,4,15,1,0.266666666666667
scanialllelluenaielisa,0,22,11,11,0,1
dangaleat,1,9,4,5,0,0.8
cowbane,1,7,3,4,0,0.75
anrecalmabillown,0,16,6,10,0,0.6
chekan,1,6,2,4,0,0.5
tariffing,1,9,3,6,0,0.5
twalkatiently,0,13,4,9,0,0.444444444444444
'yppsfzon'je,0,12,2,10,2,0.2
unstroked,1,9,3,6,0,0.5
assengeal,0,9,4,5,0,0.8
unatseraxiabidle,0,16,8,8,0,1
gluttonies,1,10,4,6,0,0.666666666666667
xrbrcenftdczggntg'g'bnmhuxtp,0,28,2,26,2,0.0769230769230769
hwih'vvkmomvmleifdffka,0,22,5,17,1,0.294117647058824
dombeathosisared,0,16,7,9,0,0.777777777777778
pretist,0,7,2,5,0,0.4
noncontranspiece,0,16,6,10,0,0.6
gastroparesis,1,13,5,8,0,0.625
moistless,1,9,3,6,0,0.5
trisotropis,1,11,4,7,0,0.571428571428571
chatti,1,6,2,4,0,0.5
indulgential,1,12,5,7,0,0.714285714285714
cheilosis,1,9,4,5,0,0.8
radiotelegram,1,13,6,7,0,0.857142857142857
elegancy,1,8,3,5,0,0.6
scowntecaephotovaspandosntacarugstabancopoopphuitis,0,51,20,31,0,0.645161290322581
snowslippy,0,10,2,8,0,0.25
proexaminator,0,13,6,7,0,0.857142857142857
viatopillarry,0,13,5,8,0,0.625
veratrias,1,9,4,5,0,0.8
corphera,0,8,3,5,0,0.6
nasalism,1,8,3,5,0,0.6
rljwxyxeeh,0,10,2,8,0,0.25
portella,0,8,3,5,0,0.6
headroominalism,0,15,7,8,0,0.875
punnings,1,8,2,6,0,0.333333333333333
tubman,1,6,2,4,0,0.5
rowted,1,6,2,4,0,0.5
nqurie,0,6,3,3,0,1
etolitc,0,7,3,4,0,0.75
subgraftocarrethocytiker,0,24,8,16,0,0.5
semionotus,1,10,5,5,0,1
calumny,1,7,2,5,0,0.4
aquariist,1,9,5,4,0,1.25
multidigitate,1,13,6,7,0,0.857142857142857
ramadans,1,8,3,5,0,0.6
sceduling,1,9,3,6,0,0.5
numberplate,1,11,4,7,0,0.571428571428571
dammanies,0,9,4,5,0,0.8
mammifer,1,8,3,5,0,0.6
ffbna'bpaprb'adafjhifutf,0,24,6,18,2,0.333333333333333
enzymolytic,1,11,3,8,0,0.375
baco,1,4,2,2,0,1
appallman,0,9,3,6,0,0.5
foremade,1,8,4,4,0,1
lanosis,0,7,3,4,0,0.75
poisonfully,1,11,4,7,0,0.571428571428571
delineating,1,11,5,6,0,0.833333333333333
bionditional,1,12,6,6,0,1
dknmid,0,6,1,5,0,0.2
mahapterdology,0,14,5,9,0,0.555555555555556
brachiosaurus,1,13,6,7,0,0.857142857142857
zmajppenzvayrqrfm,0,17,3,14,0,0.214285714285714
gerik,1,5,2,3,0,0.666666666666667
maypolite,0,9,4,5,0,0.8
disporting,1,10,3,7,0,0.428571428571429
underservice,1,12,5,7,0,0.714285714285714
mispunctuation,1,14,6,8,0,0.75
superstrikes,1,12,4,8,0,0.5
mojave,1,6,3,3,0,1
salvasses,0,9,3,6,0,0.5
tidinesses,1,10,4,6,0,0.666666666666667
adscript,1,8,2,6,0,0.333333333333333
solvolyse,0,9,3,6,0,0.5
endicter,0,8,3,5,0,0.6
wedged,1,6,2,4,0,0.5
hyperaphicness,0,14,4,10,0,0.4
ijsu'chntzxstwozz,0,17,3,14,1,0.214285714285714
pi,1,2,1,1,0,1
drdoriaftistitipibentoche,0,25,10,15,0,0.666666666666667
shritisation,0,12,5,7,0,0.714285714285714
clericalism,1,11,4,7,0,0.571428571428571
wayers,0,6,2,4,0,0.5
isolationalists,1,15,7,8,0,0.875
gyrostaccaceous,0,15,6,9,0,0.666666666666667
reevership,0,10,4,6,0,0.666666666666667
spiricization,0,13,6,7,0,0.857142857142857
edr,0,3,1,2,0,0.5
brids,0,5,1,4,0,0.25
dempstealleniae,0,15,7,8,0,0.875
sckus,0,5,1,4,0,0.25
tramrernexand,0,13,4,9,0,0.444444444444444
qualmyish,1,9,3,6,0,0.5
dunfermline,1,11,4,7,0,0.571428571428571
halazones,1,9,4,5,0,0.8
sleying,1,7,2,5,0,0.4
seclidysishatends,0,17,5,12,0,0.416666666666667
vcppmr,0,6,0,6,0,0
pollman,1,7,2,5,0,0.4
creedite,1,8,4,4,0,1
hypertherm,1,10,2,8,0,0.25
freilker,0,8,3,5,0,0.6
vintsspryrevedadncrinilis,0,25,7,18,0,0.388888888888889
subimasque,0,10,5,5,0,1
meratelelerless,0,15,6,9,0,0.666666666666667
allopurinol,1,11,5,6,0,0.833333333333333
unmind,1,6,2,4,0,0.5
ozizolf,0,7,3,4,0,0.75
attendee,1,8,4,4,0,1
coryphenley,0,11,3,8,0,0.375
opposes,1,7,3,4,0,0.75
hinconiperonikochaloxgilie,0,26,12,14,0,0.857142857142857
bersockeircascomoblimuggentethallubritubicopang,0,47,18,29,0,0.620689655172414
tikitiki,1,8,4,4,0,1
lgelhz'ipxlxopfcxoctq,0,21,4,17,1,0.235294117647059
frontolyses,1,11,3,8,0,0.375
rnpfcuim,0,8,2,6,0,0.333333333333333
scagbichin,0,10,3,7,0,0.428571428571429
calcutta,1,8,3,5,0,0.6
tric,0,4,1,3,0,0.333333333333333
outrageousnesses,1,16,8,8,0,1
quidden,0,7,3,4,0,0.75
cels,1,4,1,3,0,0.333333333333333
trigly,1,6,1,5,0,0.2
unfarming,1,9,3,6,0,0.5
liquese,0,7,4,3,0,1.33333333333333
fifth,1,5,1,4,0,0.25
meshuggenehs,1,12,4,8,0,0.5
chronologised,1,13,5,8,0,0.625
torosanoid,0,10,5,5,0,1
hanifite,1,8,4,4,0,1
eijwbybudlkjilegqmacwobssdui,0,28,9,19,0,0.473684210526316
jouysauromyxomasion,0,19,9,10,0,0.9
labolt,1,6,2,4,0,0.5
unpendant,1,9,3,6,0,0.5
predefying,1,10,3,7,0,0.428571428571429
bchar,1,5,1,4,0,0.25
corticotropins,1,14,5,9,0,0.555555555555556
hskutormydjazypkey,0,18,4,14,0,0.285714285714286
oxhead,1,6,3,3,0,1
syngly,0,6,0,6,0,0
corrupters,1,10,3,7,0,0.428571428571429
oxadiazole,1,10,6,4,0,1.5
artinskian,1,10,4,6,0,0.666666666666667
dsdrazyqcyziuanoewtaxc,0,22,7,15,0,0.466666666666667
zzxnz'rnzmkntvzrj,0,17,0,17,1,0
goody,1,5,2,3,0,0.666666666666667
overpackaged,1,12,5,7,0,0.714285714285714
unconfutative,1,13,6,7,0,0.857142857142857
pille,0,5,2,3,0,0.666666666666667
hypoxanthin,0,11,3,8,0,0.375
basiglandular,1,13,5,8,0,0.625
maytic,0,6,2,4,0,0.5
jbakjyjdlennyhxjprg'njieaovzq,0,29,6,23,1,0.260869565217391
cosystinka,0,10,3,7,0,0.428571428571429
muiqfvrglpzrtzxgzn,0,18,2,16,0,0.125
ns,0,2,0,2,0,0
pweziolz,0,8,3,5,0,0.6
ascared,1,7,3,4,0,0.75
cohbert,1,7,2,5,0,0.4
hazaki,1,6,3,3,0,1
microdiagnostic,0,15,6,9,0,0.666666666666667
psychyma,0,8,1,7,0,0.142857142857143
byer,0,4,1,3,0,0.333333333333333
kamuela,1,7,4,3,0,1.33333333333333
damyankee,1,9,4,5,0,0.8
otaycainvidetaaucrininstinckerorungly,0,37,15,22,0,0.681818181818182
kgephsgfni,0,10,2,8,0,0.25
acerates,1,8,4,4,0,1
schos,0,5,1,4,0,0.25
laymanship,1,10,3,7,0,0.428571428571429
countercommercialist,0,20,8,12,0,0.666666666666667
counterindentations,0,19,8,11,0,0.727272727272727
bulliationalise,0,15,8,7,0,1.14285714285714
robotesque,1,10,5,5,0,1
dauru,0,5,3,2,0,1.5
transversalt,0,12,3,9,0,0.333333333333333
mawger,1,6,2,4,0,0.5
pnowtome,0,8,3,5,0,0.6
punakha,1,7,3,4,0,0.75
semisidehornbrazingari,0,22,9,13,0,0.692307692307692
allomeriastrountleous,0,21,10,11,0,0.909090909090909
g'rmhchpxgsqjxbrrpinj,0,21,1,20,1,0.05
chinoidecliproo,0,15,7,8,0,0.875
szkdnydjwtxxlqjmpymby,0,21,0,21,0,0
kundalini,1,9,4,5,0,0.8
ctiveuers,0,9,4,5,0,0.8
bz'uzfa'b',0,10,2,8,3,0.25
pentes,0,6,2,4,0,0.5
sjqcsswuaipyqgq,0,15,3,12,0,0.25
upblown,1,7,2,5,0,0.4
uning,0,5,2,3,0,0.666666666666667
spumone,1,7,3,4,0,0.75
iqaluit,1,7,4,3,0,1.33333333333333
ydnogwnfuy'appgj'nusaygnioshjp,0,30,7,23,2,0.304347826086957
kowhai,1,6,3,3,0,1
tunishness,0,10,3,7,0,0.428571428571429
stempson,1,8,2,6,0,0.333333333333333
glibbing,1,8,2,6,0,0.333333333333333
femunnish,0,9,3,6,0,0.5
comerio,1,7,4,3,0,1.33333333333333
psaltie,0,7,3,4,0,0.75
nonsuppression,1,14,5,9,0,0.555555555555556
wxifaxxjgxaatgpikj,0,18,5,13,0,0.384615384615385
repictureful,0,12,5,7,0,0.714285714285714
walkylate,0,9,3,6,0,0.5
voleries,1,8,4,4,0,1
ligitcriacholierreaculthimessadiceightul,0,40,17,23,0,0.739130434782609
piated,0,6,3,3,0,1
malt,1,4,1,3,0,0.333333333333333
kindre,0,6,2,4,0,0.5
pvo,1,3,1,2,0,0.5
stranesoraterel,0,15,6,9,0,0.666666666666667
deaerate,1,8,5,3,0,1.66666666666667
mhdcwrc,0,7,0,7,0,0
carcinological,1,14,6,8,0,0.75
audian,1,6,4,2,0,2
bobadilian,1,10,5,5,0,1
benz,1,4,1,3,0,0.333333333333333
stigmatism,1,10,3,7,0,0.428571428571429
cros,0,4,1,3,0,0.333333333333333
kieselgur,1,9,4,5,0,0.8
sphenographic,1,13,4,9,0,0.444444444444444
stygian,1,7,2,5,0,0.4
individuative,1,13,7,6,0,1.16666666666667
burghbote,1,9,3,6,0,0.5
auditives,1,9,5,4,0,1.25
kingwood,1,8,3,5,0,0.6
felten,1,6,2,4,0,0.5
zoltiossostell,0,14,5,9,0,0.555555555555556
ster,0,4,1,3,0,0.333333333333333
rusag,0,5,2,3,0,0.666666666666667
noncensoriously,1,15,6,9,0,0.666666666666667
osirimoyer,0,10,5,5,0,1
semisomnambulistic,1,18,7,11,0,0.636363636363636
foxfeed,0,7,3,4,0,0.75
subcircuit,1,10,4,6,0,0.666666666666667
cathhoss,0,8,2,6,0,0.333333333333333
ligner,0,6,2,4,0,0.5
usiqdgkrqribdc'hmyjo,0,20,4,16,1,0.25
bindeasprsten,0,13,4,9,0,0.444444444444444
nonprohibitable,1,15,6,9,0,0.666666666666667
dbzqftwjoumqpapnaewyhu',0,23,6,17,1,0.352941176470588
contradiscriminability,0,22,8,14,0,0.571428571428571
teratogens,1,10,4,6,0,0.666666666666667
korah,1,5,2,3,0,0.666666666666667
kollwitz,1,8,2,6,0,0.333333333333333
hypolycineticises,0,17,6,11,0,0.545454545454545
cystoscopy,1,10,2,8,0,0.25
zebeckia,0,8,4,4,0,1
yippoters,0,9,3,6,0,0.5
orcheitis,1,9,4,5,0,0.8
shastan,1,7,2,5,0,0.4
uxbvtsvpgf,0,10,1,9,0,0.111111111111111
taiva,0,5,3,2,0,1.5
teodorants,0,10,4,6,0,0.666666666666667
holom,0,5,2,3,0,0.666666666666667
baeonalids,0,10,5,5,0,1
pcabjhdojl,0,10,2,8,0,0.25
descence,0,8,3,5,0,0.6
jotuns,1,6,2,4,0,0.5
genispairweartner,0,17,7,10,0,0.7
murkinje,0,8,3,5,0,0.6
vandalisation,1,13,6,7,0,0.857142857142857
ephrathite,1,10,4,6,0,0.666666666666667
comitadjis,1,10,4,6,0,0.666666666666667
batterie,1,8,4,4,0,1
nuwmnhrgnkbp,0,12,1,11,0,0.0909090909090909
iotization,1,10,6,4,0,1.5
unmistrustfully,1,15,4,11,0,0.363636363636364
victorian,1,9,4,5,0,0.8
procurvews,0,10,3,7,0,0.428571428571429
nethium,0,7,3,4,0,0.75
volumetrically,1,14,5,9,0,0.555555555555556
zupltxezlmons,0,13,3,10,0,0.3
sheiceptiving,0,13,5,8,0,0.625
kie,1,3,2,1,0,2
jdkecekcgdjtnzeeazlb,0,20,5,15,0,0.333333333333333
acknowellsie,0,12,5,7,0,0.714285714285714
murray,1,6,2,4,0,0.5
uroid,0,5,3,2,0,1.5
approves,1,8,3,5,0,0.6
cered,1,5,2,3,0,0.666666666666667
fhvraa,0,6,2,4,0,0.5
narghiles,1,9,3,6,0,0.5
permeggatuded,0,13,5,8,0,0.625
denteraphatims,0,14,5,9,0,0.555555555555556
foxton,1,6,2,4,0,0.5
thigger,1,7,2,5,0,0.4
spe,0,3,1,2,0,0.5
nonrevolutionary,1,16,7,9,0,0.777777777777778
jkckptcuvgqtfrmnsypedkb,0,23,2,21,0,0.0952380952380952
waistie,0,7,4,3,0,1.33333333333333
cctoipaletak,0,12,5,7,0,0.714285714285714
westborough,1,11,4,7,0,0.571428571428571
uneudeceamis,0,12,7,5,0,1.4
forritsome,1,10,4,6,0,0.666666666666667
receiverships,1,13,5,8,0,0.625
cholelithiasis,1,14,6,8,0,0.75
raddha,0,6,2,4,0,0.5
bshec,1,5,1,4,0,0.25
feflacks,0,8,2,6,0,0.333333333333333
lingence,1,8,3,5,0,0.6
juaidosuliaerielinfovessarafeayterorizes,0,40,21,19,0,1.10526315789474
hexanchipura,0,12,5,7,0,0.714285714285714
warbled,1,7,2,5,0,0.4
paynesville,1,11,4,7,0,0.571428571428571
tognk,0,5,1,4,0,0.25
candyce,1,7,2,5,0,0.4
llyneridn,0,9,2,7,0,0.285714285714286
blycus,0,6,1,5,0,0.2
reminisces,1,10,4,6,0,0.666666666666667
agneaux,1,7,4,3,0,1.33333333333333
pinge,1,5,2,3,0,0.666666666666667
compowerating,0,13,5,8,0,0.625
misalter,1,8,3,5,0,0.6
wayao,1,5,3,2,0,1.5
holothuridea,1,12,6,6,0,1
reconnetrauhquagariflushenered,0,30,13,17,0,0.764705882352941
solaptes,0,8,3,5,0,0.6
y'yqzzmxlmst,0,12,0,12,1,0
dfie'emwivwegfwfsnsgzxbf,0,24,5,19,1,0.263157894736842
rakers,1,6,2,4,0,0.5
cordel,1,6,2,4,0,0.5
farnswoggle,0,11,3,8,0,0.375
strophuluses,1,12,4,8,0,0.5
rngxsufxkhpb,0,12,1,11,0,0.0909090909090909
ascochyta,1,9,3,6,0,0.5
poes,0,4,2,2,0,1
kennerdell,1,10,3,7,0,0.428571428571429
stepuncle,1,9,3,6,0,0.5
trichidae,0,9,4,5,0,0.8
tatterdomesticity,0,17,6,11,0,0.545454545454545
exprobriation,0,13,6,7,0,0.857142857142857
casatus,1,7,3,4,0,0.75
pontiest,0,8,3,5,0,0.6
copiers,1,7,3,4,0,0.75
ramrods,1,7,2,5,0,0.4
platyptera,1,10,3,7,0,0.428571428571429
nemertea,1,8,4,4,0,1
cristivomer,1,11,4,7,0,0.571428571428571
circe,1,5,2,3,0,0.666666666666667
bucculation,0,11,5,6,0,0.833333333333333
triboelectropocaic,0,18,8,10,0,0.8
grxhbqaaxsts'mcw,0,16,2,14,1,0.142857142857143
elicatraggefilune,0,17,8,9,0,0.888888888888889
unidism,0,7,3,4,0,0.75
monomolecithal,0,14,6,8,0,0.75
cordhous,0,8,3,5,0,0.6
consultantships,1,15,4,11,0,0.363636363636364
hyperventilation,1,16,6,10,0,0.6
tilyer,1,6,2,4,0,0.5
boised,0,6,3,3,0,1
twarette,0,8,3,5,0,0.6
exultance,1,9,4,5,0,0.8
trimethoprim,1,12,4,8,0,0.5
doghousevictoria,0,16,8,8,0,1
't,0,2,0,2,1,0
ch,0,2,0,2,0,0
firoph,0,6,2,4,0,0.5
pallae,1,6,3,3,0,1
empyreuma,1,9,4,5,0,0.8
uwxol'wkvjb,0,11,2,9,1,0.222222222222222
chiliaceously,0,13,6,7,0,0.857142857142857
prosis,0,6,2,4,0,0.5
models,1,6,2,4,0,0.5
seminifical,1,11,5,6,0,0.833333333333333
testor,1,6,2,4,0,0.5
ulwed,0,5,2,3,0,0.666666666666667
imminute,1,8,4,4,0,1
gnqoyfxwitjelr'tfoor,0,20,5,15,1,0.333333333333333
basilicalike,1,12,6,6,0,1
decterwini,0,10,4,6,0,0.666666666666667
msly,0,4,0,4,0,0
proliferous,1,11,5,6,0,0.833333333333333
folky,1,5,1,4,0,0.25
t'htiewrkw,0,10,2,8,1,0.25
mstyosettibleadbal,0,18,6,12,0,0.5
dwnnaensl,0,9,2,7,0,0.285714285714286
shockstall,1,10,2,8,0,0.25
seamsters,1,9,3,6,0,0.5
ribiers,1,7,3,4,0,0.75
bbs,1,3,0,3,0,0
godber,1,6,2,4,0,0.5
darline,1,7,3,4,0,0.75
unstandardisable,1,16,6,10,0,0.6
arteritis,1,9,4,5,0,0.8
prothyle,1,8,2,6,0,0.333333333333333
sabbankson,0,10,3,7,0,0.428571428571429
cafetal,1,7,3,4,0,0.75
penavesesiontharcut,0,19,8,11,0,0.727272727272727
homerist,1,8,3,5,0,0.6
encephaloid,1,11,5,6,0,0.833333333333333
murikers,0,8,3,5,0,0.6
qxcflaiushbqjjbmgavkfyiu,0,24,6,18,0,0.333333333333333
squintingly,1,11,3,8,0,0.375
buttesties,0,10,4,6,0,0.666666666666667
ctos,0,4,1,3,0,0.333333333333333
authorgan,0,9,4,5,0,0.8
zonli,0,5,2,3,0,0.666666666666667
viversigmorantofozes,0,20,8,12,0,0.666666666666667
dhaks,1,5,1,4,0,0.25
alchemy,1,7,2,5,0,0.4
allusions,1,9,4,5,0,0.8
trustlessly,1,11,2,9,0,0.222222222222222
aelohboupwtalos,0,15,7,8,0,0.875
mous,0,4,2,2,0,1
ginside,0,7,3,4,0,0.75
sceptibly,1,9,2,7,0,0.285714285714286
fullstops,1,9,2,7,0,0.285714285714286
overdaringly,1,12,4,8,0,0.5
bumperinesses,0,13,5,8,0,0.625
ivzizrzggtrpzugsyyxdptto'mvi,0,28,5,23,1,0.217391304347826
engenia,1,7,4,3,0,1.33333333333333
bsnaftebk,0,9,2,7,0,0.285714285714286
orchioscheocele,1,15,7,8,0,0.875
swelterer,1,9,3,6,0,0.5
olenta,1,6,3,3,0,1
unsubduemblet,0,13,5,8,0,0.625
partops,0,7,2,5,0,0.4
checheherez,0,11,4,7,0,0.571428571428571
agwic,0,5,2,3,0,0.666666666666667
ganide,0,6,3,3,0,1
stormer,1,7,2,5,0,0.4
artaba,1,6,3,3,0,1
dysteleologist,1,14,5,9,0,0.555555555555556
cascadia,1,8,4,4,0,1
jerm'p,0,6,1,5,1,0.2
wateradocoriness,0,16,7,9,0,0.777777777777778
overchillis,0,11,4,7,0,0.571428571428571
boems,0,5,2,3,0,0.666666666666667
audrillaborative,0,16,8,8,0,1
rheoplankton,1,12,4,8,0,0.5
dorsolateral,1,12,5,7,0,0.714285714285714
gctgkfjddwwwxtjh,0,16,0,16,0,0
harrisburg,1,10,3,7,0,0.428571428571429
neminods,0,8,3,5,0,0.6
bejade,1,6,3,3,0,1
myrcinian,0,9,3,6,0,0.5
unsterl,0,7,2,5,0,0.4
ynes,1,4,1,3,0,0.333333333333333
cathartidae,1,11,5,6,0,0.833333333333333
rehabber,1,8,3,5,0,0.6
hampshirite,1,11,4,7,0,0.571428571428571
leptickenns,0,11,3,8,0,0.375
phthodiodorias,0,14,6,8,0,0.75
icctinepimoimmind,0,17,7,10,0,0.7
unctalbalel,0,11,4,7,0,0.571428571428571
enwreath,1,8,3,5,0,0.6
jeffersonite,1,12,5,7,0,0.714285714285714
gaol,1,4,2,2,0,1
stoichiometric,1,14,6,8,0,0.75
gilbart,1,7,2,5,0,0.4
quaquaversal,1,12,6,6,0,1
vyooozkflxzgyqtx'c,0,18,3,15,1,0.2
unoscillography,0,15,5,10,0,0.5
revaloressa,0,11,5,6,0,0.833333333333333
subrectory,1,10,3,7,0,0.428571428571429
moresques,1,9,4,5,0,0.8
halemaumau,1,10,6,4,0,1.5
bywaters,1,8,2,6,0,0.333333333333333
isoosmosis,0,10,5,5,0,1
ubilichonant,0,12,5,7,0,0.714285714285714
meteratives,0,11,5,6,0,0.833333333333333
insoluble,1,9,4,5,0,0.8
itugesetlacreatutixtyn,0,22,9,13,0,0.692307692307692
motored,1,7,3,4,0,0.75
gaulinesses,0,11,5,6,0,0.833333333333333
phobia,1,6,3,3,0,1
vkqave'maxobnpcnqfopwrjri,0,25,6,19,1,0.315789473684211
bzsxzlpfhtmpqoixzukqygopz,0,25,4,21,0,0.19047619047619
joazqgoinctgoiqflq,0,18,6,12,0,0.5
mistrist,1,8,2,6,0,0.333333333333333
electrophenous,0,14,6,8,0,0.75
witchazy,0,8,2,6,0,0.333333333333333
conmeton,0,8,3,5,0,0.6
pussywillow,1,11,3,8,0,0.375
nuvxd'adlczd'bm'krawe,0,21,4,17,3,0.235294117647059
cateesigograchateseinistiverva,0,30,14,16,0,0.875
undial,0,6,3,3,0,1
bistortionment,0,14,5,9,0,0.555555555555556
tauriferous,1,11,6,5,0,1.2
conclavist,1,10,3,7,0,0.428571428571429
ribly,0,5,1,4,0,0.25
sawlemncdj,0,10,2,8,0,0.25
honorius,1,8,4,4,0,1
finless,1,7,2,5,0,0.4
uspyqjjstoohubehmygpzf,0,22,5,17,0,0.294117647058824
altgeld,1,7,2,5,0,0.4
branumishishti,0,14,5,9,0,0.555555555555556
beneficienced,0,13,6,7,0,0.857142857142857
jpzfccbfugteniivf,0,17,4,13,0,0.307692307692308
antipapacy,1,10,4,6,0,0.666666666666667
symparer,0,8,2,6,0,0.333333333333333
zaialzzbjpygixsr,0,16,4,12,0,0.333333333333333
evive,0,5,3,2,0,1.5
uriartarbastchangrfuswadpsmphetewhezodi,0,39,13,26,0,0.5
ispdsykmqi,0,10,2,8,0,0.25
windsors,1,8,2,6,0,0.333333333333333
phytoalexin,1,11,4,7,0,0.571428571428571
yssutphoacqu,0,12,4,8,0,0.5
againsay,1,8,4,4,0,1
panicum,1,7,3,4,0,0.75
cisinoxillkatiothidilifecleicillia,0,34,16,18,0,0.888888888888889
alitangle,0,9,4,5,0,0.8
troopmen,0,8,3,5,0,0.6
nebaliidae,1,10,6,4,0,1.5
unidolome,0,9,5,4,0,1.25
impieties,1,9,5,4,0,1.25
achromatisations,1,16,7,9,0,0.777777777777778
paphoty,0,7,2,5,0,0.4
yardwand,1,8,2,6,0,0.333333333333333
carneying,1,9,3,6,0,0.5
biochemist,1,10,4,6,0,0.666666666666667
bearishnesses,1,13,5,8,0,0.625
almuce,1,6,3,3,0,1
unpatented,1,10,4,6,0,0.666666666666667
counterritornelised,0,19,8,11,0,0.727272727272727
ratchproofing,0,13,4,9,0,0.444444444444444
stannel,1,7,2,5,0,0.4
gancebe,0,7,3,4,0,0.75
hurqqfbkajxoitry,0,16,4,12,0,0.333333333333333
leanne,1,6,3,3,0,1
hylothorax,0,10,3,7,0,0.428571428571429
predentate,1,10,4,6,0,0.666666666666667
pachouser,0,9,4,5,0,0.8
bellyfull,1,9,2,7,0,0.285714285714286
feudalic,0,8,4,4,0,1
bol,0,3,1,2,0,0.5
grantham,1,8,2,6,0,0.333333333333333
caleazica,0,9,5,4,0,1.25
translation,1,11,4,7,0,0.571428571428571
cretogenesially,0,15,6,9,0,0.666666666666667
knab,1,4,1,3,0,0.333333333333333
inefficiency,1,12,5,7,0,0.714285714285714
nxkrpztfvfkiebvkoga'v,0,21,4,17,1,0.235294117647059
cognoscitive,1,12,5,7,0,0.714285714285714
mcbzf'qo,0,8,1,7,1,0.142857142857143
haterpred,0,9,3,6,0,0.5
adau,0,4,3,1,0,3
cosuffer,1,8,3,5,0,0.6
astroduodenojejuna,0,18,9,9,0,1
cobelligerent,1,13,5,8,0,0.625
presex,0,6,2,4,0,0.5
musugwlencabruzes,0,17,6,11,0,0.545454545454545
drehearthus,0,11,4,7,0,0.571428571428571
dependance,0,10,4,6,0,0.666666666666667
solidificationally,0,18,8,10,0,0.8
menaspis,1,8,3,5,0,0.6
hansardization,1,14,6,8,0,0.75
macaco,1,6,3,3,0,1
chylose,0,7,2,5,0,0.4
kalamazoo,1,9,5,4,0,1.25
northvale,1,9,3,6,0,0.5
remicated,0,9,4,5,0,0.8
aglipaya,0,8,4,4,0,1
paranyms,1,8,2,6,0,0.333333333333333
zoninnutomotarnes,0,17,7,10,0,0.7
fluoroboride,1,12,6,6,0,1
palinode,1,8,4,4,0,1
petratoservatic,0,15,6,9,0,0.666666666666667
karse,0,5,2,3,0,0.666666666666667
nartelike,0,9,4,5,0,0.8
gunnybags,1,9,2,7,0,0.285714285714286
surinamer,1,9,4,5,0,0.8
codelinquent,1,12,5,7,0,0.714285714285714
wendintorple,0,12,4,8,0,0.5
incubinate,0,10,5,5,0,1
semidurables,1,12,5,7,0,0.714285714285714
routinisation,1,13,7,6,0,1.16666666666667
vorlessness,0,11,3,8,0,0.375
pnmkovrdtejj'zoyisvdgqz,0,23,4,19,1,0.210526315789474
phainopepla,1,11,5,6,0,0.833333333333333
prentiidae,0,10,5,5,0,1
desales,0,7,3,4,0,0.75
xema,1,4,2,2,0,1
gjumblinderisine,0,16,6,10,0,0.6
molegist,0,8,3,5,0,0.6
cllluloshiakerajiovolowrobied,0,29,13,16,0,0.8125
demontoing,0,10,4,6,0,0.666666666666667
ttj'y',0,6,0,6,2,0
archetto,1,8,3,5,0,0.6
sandal,1,6,2,4,0,0.5
kilted,1,6,2,4,0,0.5
myljfncsqxthpskurtycdoc,0,23,2,21,0,0.0952380952380952
hyperhidrosis,1,13,4,9,0,0.444444444444444
hanes,0,5,2,3,0,0.666666666666667
chinkie,1,7,3,4,0,0.75
selfpreservatively,0,18,6,12,0,0.5
adaline,1,7,4,3,0,1.33333333333333
dialkyl,1,7,2,5,0,0.4
gndalicalld,0,11,3,8,0,0.375
nataraja,1,8,4,4,0,1
amithnaurs,0,10,4,6,0,0.666666666666667
anthropogenic,1,13,5,8,0,0.625
gly,0,3,0,3,0,0
tomahawker,1,10,4,6,0,0.666666666666667
pangane,1,7,3,4,0,0.75
marity,0,6,2,4,0,0.5
giscutbalerg,0,12,4,8,0,0.5
mpqllnopeusllrf,0,15,3,12,0,0.25
metatheological,0,15,7,8,0,0.875
jagecondarforuntesma,0,20,8,12,0,0.666666666666667
angioclast,1,10,4,6,0,0.666666666666667
boursed,0,7,3,4,0,0.75
bagonet,1,7,3,4,0,0.75
pently,0,6,1,5,0,0.2
outquote,0,8,5,3,0,1.66666666666667
sparklinesses,0,13,4,9,0,0.444444444444444
compressiveness,0,15,5,10,0,0.5
biouchortocinonpaggenattlehluseattenliturathacouttirnfacharien,0,62,26,36,0,0.722222222222222
epimeria,0,8,5,3,0,1.66666666666667
bzybdzjmhnqxtjixocvb,0,20,2,18,0,0.111111111111111
xksz,0,4,0,4,0,0
patryptoh,0,9,2,7,0,0.285714285714286
unhology,0,8,3,5,0,0.6
throttlerages,0,13,4,9,0,0.444444444444444
octogenies,0,10,5,5,0,1
boobscalistly,0,13,4,9,0,0.444444444444444
angelftwaildealladosco,0,22,9,13,0,0.692307692307692
nonfavouraticals,0,16,7,9,0,0.777777777777778
sciomachy,1,9,3,6,0,0.5
e'klbzlqp'j'nl,0,14,1,13,3,0.0769230769230769
weiring,1,7,3,4,0,0.75
iconise,1,7,4,3,0,1.33333333333333
slummer,1,7,2,5,0,0.4
fairburn,1,8,3,5,0,0.6
tyrosine,1,8,3,5,0,0.6
ethiopes,1,8,4,4,0,1
undivertible,1,12,5,7,0,0.714285714285714
bankeovivingsoblt,0,17,6,11,0,0.545454545454545
atuntengnatr,0,12,4,8,0,0.5
vaccio,0,6,3,3,0,1
geraviltiss,0,11,4,7,0,0.571428571428571
sortieing,1,9,4,5,0,0.8
koppograded,0,11,4,7,0,0.571428571428571
vrzqinnbhc'z,0,12,1,11,1,0.0909090909090909
antlion,1,7,3,4,0,0.75
slaggability,1,12,4,8,0,0.5
greasay,0,7,3,4,0,0.75
cytotoxins,1,10,3,7,0,0.428571428571429
oxowan,0,6,3,3,0,1
sunscalds,1,9,2,7,0,0.285714285714286
lessish,0,7,2,5,0,0.4
abnormality,1,11,4,7,0,0.571428571428571
chitinogenous,1,13,6,7,0,0.857142857142857
transactinidiaceae,0,18,9,9,0,1
madelle,1,7,3,4,0,0.75
uncircuitously,1,14,6,8,0,0.75
obivy,0,5,2,3,0,0.666666666666667
engineering,1,11,5,6,0,0.833333333333333
guisarme,1,8,4,4,0,1
dokmarok,1,8,3,5,0,0.6
tempestates,1,11,4,7,0,0.571428571428571
hippocrenic,0,11,4,7,0,0.571428571428571
vtr,1,3,0,3,0,0
calamagrostemma,0,15,6,9,0,0.666666666666667
retentivity,1,11,4,7,0,0.571428571428571
jegpresaterts,0,13,4,9,0,0.444444444444444
pharmacognostics,1,16,5,11,0,0.454545454545455
stoecanopter,0,12,5,7,0,0.714285714285714
tetrahydrofuran,1,15,5,10,0,0.5
unobstruently,1,13,4,9,0,0.444444444444444
moonraking,1,10,4,6,0,0.666666666666667
nighhandednesses,0,16,5,11,0,0.454545454545455
blt,0,3,0,3,0,0
osmometries,1,11,5,6,0,0.833333333333333
xkgqylktpogvadqskszuojvo,0,24,5,19,0,0.263157894736842
underclub,1,9,3,6,0,0.5
reinflaters,0,11,4,7,0,0.571428571428571
deratings,1,9,3,6,0,0.5
emenders,1,8,3,5,0,0.6
mugwumpian,1,10,4,6,0,0.666666666666667
tarogalvanometric,0,17,7,10,0,0.7
pac,1,3,1,2,0,0.5
nonconfined,1,11,4,7,0,0.571428571428571
foolmonger,1,10,4,6,0,0.666666666666667
noncommemorative,1,16,7,9,0,0.777777777777778
uzara,1,5,3,2,0,1.5
patriaceoid,0,11,6,5,0,1.2
b'iuqopaoxpa,0,12,6,6,1,1
theriot,1,7,3,4,0,0.75
dmumicirenn,0,11,4,7,0,0.571428571428571
preoffer,0,8,3,5,0,0.6
asshilycanoret,0,14,5,9,0,0.555555555555556
geraudairecreh,0,14,7,7,0,1
elds,1,4,1,3,0,0.333333333333333
kyasmyprpgrudgsnbzjjomtrj,0,25,3,22,0,0.136363636363636
buchtel,1,7,2,5,0,0.4
borane,1,6,3,3,0,1
ectocuneiform,1,13,6,7,0,0.857142857142857
sacked,1,6,2,4,0,0.5
leaux,0,5,3,2,0,1.5
plasmode,1,8,3,5,0,0.6
prist,0,5,1,4,0,0.25
yw,0,2,0,2,0,0
assarion,1,8,4,4,0,1
rochinefispovis,0,15,6,9,0,0.666666666666667
soapstone,1,9,4,5,0,0.8
affaite,1,7,4,3,0,1.33333333333333
pental,0,6,2,4,0,0.5
cursed,1,6,2,4,0,0.5
patrich,1,7,2,5,0,0.4
macumba,1,7,3,4,0,0.75
icehood,0,7,4,3,0,1.33333333333333
aneroidogeneses,0,15,8,7,0,1.14285714285714
oledera,0,7,4,3,0,1.33333333333333
forhooing,1,9,4,5,0,0.8
dendone,0,7,3,4,0,0.75
uncalctactineanomactticatorogless,0,33,13,20,0,0.65
syndactylists,0,13,2,11,0,0.181818181818182
franklinism,1,11,3,8,0,0.375
recomiendist,0,12,5,7,0,0.714285714285714
undercurrently,0,14,4,10,0,0.4
blindfish,1,9,2,7,0,0.285714285714286
forevalue,1,9,5,4,0,1.25
kunkah,0,6,2,4,0,0.5
antinoise,1,9,5,4,0,1.25
entriked,0,8,3,5,0,0.6
skios,1,5,2,3,0,0.666666666666667
uniwhitterfied,0,14,6,8,0,0.75
coachiate,0,9,5,4,0,1.25
grunthing,0,9,2,7,0,0.285714285714286
nagpur,1,6,2,4,0,0.5
heltltr,0,7,1,6,0,0.166666666666667
subjunctively,1,13,4,9,0,0.444444444444444
anoplus,0,7,3,4,0,0.75
slipcases,1,9,3,6,0,0.5
tetrochstal,0,11,3,8,0,0.375
inshelling,1,10,3,7,0,0.428571428571429
xdjjbzg'rwguisuveishbcjjpcq,0,27,5,22,1,0.227272727272727
schoolfell,0,10,3,7,0,0.428571428571429
reclar,0,6,2,4,0,0.5
exopteries,0,10,5,5,0,1
santonate,1,9,4,5,0,0.8
hagiographa,1,11,5,6,0,0.833333333333333
jastscedeiaces,0,14,6,8,0,0.75
boreades,1,8,4,4,0,1
hckfeqcusjdelnlgk,0,17,3,14,0,0.214285714285714
flambant,1,8,2,6,0,0.333333333333333
bopskelianenea,0,14,7,7,0,1
radiocratus,0,11,5,6,0,0.833333333333333
qzcvft,0,6,0,6,0,0
dynatrons,1,9,2,7,0,0.285714285714286
dogmatisms,1,10,3,7,0,0.428571428571429
pitic,0,5,2,3,0,0.666666666666667
crepuscular,1,11,4,7,0,0.571428571428571
quakeproofs,1,11,5,6,0,0.833333333333333
hologised,0,9,4,5,0,0.8
roindong,0,8,3,5,0,0.6
chastiment,1,10,3,7,0,0.428571428571429
igmitellomaved,0,14,6,8,0,0.75
luella,1,6,3,3,0,1
multurbaress,0,12,4,8,0,0.5
blends,1,6,1,5,0,0.2
keater,0,6,3,3,0,1
compregents,0,11,3,8,0,0.375
siggitiandeonimentingaramely,0,28,12,16,0,0.75
hyoepiglottidean,1,16,7,9,0,0.777777777777778
iaqvcekh,0,8,3,5,0,0.6
tobaccanalians,1,14,6,8,0,0.75
ewflzs'cvn,0,10,1,9,1,0.111111111111111
drumler,1,7,2,5,0,0.4
eumenes,1,7,4,3,0,1.33333333333333
arbitrageurs,1,12,5,7,0,0.714285714285714
precompensate,1,13,5,8,0,0.625
acleriatllladog,0,15,6,9,0,0.666666666666667
gorsolketioded,0,14,6,8,0,0.75
winsted,1,7,2,5,0,0.4
prommendably,0,12,3,9,0,0.333333333333333
pluriparous,1,11,5,6,0,0.833333333333333
ffwsct,0,6,0,6,0,0
dillipionisuric,0,15,7,8,0,0.875
reaplian,0,8,4,4,0,1
shavery,1,7,2,5,0,0.4
amelin,0,6,3,3,0,1
kheationakingly,0,15,6,9,0,0.666666666666667
snowboarder,1,11,4,7,0,0.571428571428571
spubnnqjbzdacveiqmcw,0,20,4,16,0,0.25
sican,0,5,2,3,0,0.666666666666667
apocinchonine,1,13,6,7,0,0.857142857142857
shrews'hares,0,12,3,9,1,0.333333333333333
statianiss,0,10,4,6,0,0.666666666666667
zhxhuowyvnnwawjerqbne,0,21,5,16,0,0.3125
palaeotherium,1,13,7,6,0,1.16666666666667
receivals,1,9,4,5,0,0.8
pisis,0,5,2,3,0,0.666666666666667
ruscoparen,0,10,4,6,0,0.666666666666667
cartroom,0,8,3,5,0,0.6
parcoprolvates,0,14,5,9,0,0.555555555555556
machin,1,6,2,4,0,0.5
threshel,1,8,2,6,0,0.333333333333333
ovey,0,4,2,2,0,1
yuapin,1,6,3,3,0,1
coronus,1,7,3,4,0,0.75
groomish,1,8,3,5,0,0.6
wpr,0,3,0,3,0,0
xenomagnetic,0,12,5,7,0,0.714285714285714
pliererinolockjawfieralists,0,27,11,16,0,0.6875
shardistefirybolaset,0,20,7,13,0,0.538461538461538
ecstasy,1,7,2,5,0,0.4
uncoagulable,1,12,6,6,0,1
predistributory,0,15,5,10,0,0.5
neurectomy,1,10,4,6,0,0.666666666666667
vorfeld,1,7,2,5,0,0.4
hopelessness,1,12,4,8,0,0.5
oniousness,0,10,5,5,0,1
stee,0,4,2,2,0,1
insularities,1,12,6,6,0,1
propercussorgsky,0,16,4,12,0,0.333333333333333
apyonin,1,7,3,4,0,0.75
qvfnlovusyvbizzheav,0,19,5,14,0,0.357142857142857
clepe,1,5,2,3,0,0.666666666666667
paucispiral,1,11,5,6,0,0.833333333333333
adoptionism,1,11,5,6,0,0.833333333333333
saggering,1,9,3,6,0,0.5
nonfaddist,1,10,3,7,0,0.428571428571429
voltaelectoration,0,17,8,9,0,0.888888888888889
suckles,1,7,2,5,0,0.4
gloiopeltis,1,11,5,6,0,0.833333333333333
extrametropolitan,1,17,7,10,0,0.7
metro,1,5,2,3,0,0.666666666666667
aldrovanda,1,10,4,6,0,0.666666666666667
nonfuturity,1,11,4,7,0,0.571428571428571
cholangiogram,1,13,5,8,0,0.625
scalawaggery,1,12,4,8,0,0.5
oniscium,0,8,4,4,0,1
ascomycetes,1,11,4,7,0,0.571428571428571
lacallalagryris,0,15,5,10,0,0.5
goldberg,1,8,2,6,0,0.333333333333333
gregationalisation,0,18,9,9,0,1
polybasicity,1,12,4,8,0,0.5
jusserand,1,9,3,6,0,0.5
inhouse,0,7,4,3,0,1.33333333333333
subarborescent,1,14,5,9,0,0.555555555555556
maihvzehgymlowvrpturutgnigf,0,27,7,20,0,0.35
conial,0,6,3,3,0,1
vwrugddjldmlw,0,13,1,12,0,0.0833333333333333
llano,1,5,2,3,0,0.666666666666667
bluewoods,1,9,4,5,0,0.8
dullama,0,7,3,4,0,0.75
deffer,1,6,2,4,0,0.5
plethrum,0,8,2,6,0,0.333333333333333
lfkdbp,0,6,0,6,0,0
thicky,1,6,1,5,0,0.2
betided,1,7,3,4,0,0.75
kioglptors,0,10,3,7,0,0.428571428571429
overrestrainably,0,16,6,10,0,0.6
aifl,0,4,2,2,0,1
affectlessly,1,12,3,9,0,0.333333333333333
stering,0,7,2,5,0,0.4
tyers,1,5,1,4,0,0.25
cogan,1,5,2,3,0,0.666666666666667
sxeycxwwoy,0,10,2,8,0,0.25
drecks,1,6,1,5,0,0.2
pulture,1,7,3,4,0,0.75
ckerule,0,7,3,4,0,0.75
vocalise,1,8,4,4,0,1
pha,0,3,1,2,0,0.5
kiliwi,1,6,3,3,0,1
syntheme,1,8,2,6,0,0.333333333333333
analyst,1,7,2,5,0,0.4
pedrero,1,7,3,4,0,0.75
aig,0,3,2,1,0,2
catanael,0,8,4,4,0,1
agamidae,1,8,5,3,0,1.66666666666667
maidservant,1,11,4,7,0,0.571428571428571
repentant,1,9,3,6,0,0.5
kowtowing,1,9,3,6,0,0.5
ymxhekrozaerj,0,13,4,9,0,0.444444444444444
heliststic,0,10,3,7,0,0.428571428571429
pinkster,1,8,2,6,0,0.333333333333333
indigestible,1,12,5,7,0,0.714285714285714
hed,0,3,1,2,0,0.5
chicomecoatl,1,12,5,7,0,0.714285714285714
nebuchadnezzars,1,15,5,10,0,0.5
ganitess,0,8,3,5,0,0.6
zoonule,1,7,4,3,0,1.33333333333333
meranghranenel,0,14,5,9,0,0.555555555555556
arrivancy,1,9,3,6,0,0.5
hedgers,1,7,2,5,0,0.4
tiran,1,5,2,3,0,0.666666666666667
rama,1,4,2,2,0,1
veadars,1,7,3,4,0,0.75
jussion,1,7,3,4,0,0.75
ekstrom,1,7,2,5,0,0.4
ronarmsher,0,10,3,7,0,0.428571428571429
noses,1,5,2,3,0,0.666666666666667
macrocephalic,1,13,5,8,0,0.625
tedc'yewbdh'gg'xazpg,0,20,3,17,3,0.176470588235294
conteke,1,7,3,4,0,0.75
flncaews,0,8,2,6,0,0.333333333333333
regarded,1,8,3,5,0,0.6
unrecapranei,0,12,6,6,0,1
maxerfil,0,8,3,5,0,0.6
voorheesville,1,13,6,7,0,0.857142857142857
nonfraternally,1,14,4,10,0,0.4
mahra,1,5,2,3,0,0.666666666666667
teradobinncaleticyola,0,21,9,12,0,0.75
heather,1,7,3,4,0,0.75
multinomial,1,11,5,6,0,0.833333333333333
granulocytopenia,1,16,7,9,0,0.777777777777778
enterectomy,1,11,4,7,0,0.571428571428571
unconstellencieux,0,17,7,10,0,0.7
chucking,1,8,2,6,0,0.333333333333333
goldenmouthed,1,13,5,8,0,0.625
solenostemonous,0,15,7,8,0,0.875
schizomycetes,1,13,4,9,0,0.444444444444444
trevah,1,6,2,4,0,0.5
xymareblet,0,10,3,7,0,0.428571428571429
geologer,1,8,4,4,0,1
rellyng,0,7,1,6,0,0.166666666666667
hearer,1,6,3,3,0,1
archduxe,1,8,3,5,0,0.6
dogribs,1,7,2,5,0,0.4
biblicists,1,10,3,7,0,0.428571428571429
toverkeraseskegs,0,16,6,10,0,0.6
saccharimetry,1,13,4,9,0,0.444444444444444
maurist,1,7,3,4,0,0.75
feudalistic,1,11,5,6,0,0.833333333333333
patriarchies,1,12,5,7,0,0.714285714285714
ebnakerstful,0,12,4,8,0,0.5
silish,0,6,2,4,0,0.5
szkdsztzocd,0,11,1,10,0,0.1
sandblastings,1,13,3,10,0,0.3
ufepgnjnqdxctyqv,0,16,2,14,0,0.142857142857143
inico,0,5,3,2,0,1.5
atarismibaitroveys,0,18,8,10,0,0.8
palazonternessiestrancid,0,24,9,15,0,0.6
abalism,0,7,3,4,0,0.75
cuticularia,0,11,6,5,0,1.2
actionoph,0,9,4,5,0,0.8
denae,1,5,3,2,0,1.5
gorgemaking,0,11,4,7,0,0.571428571428571
afterburners,1,12,4,8,0,0.5
dsmintyor,0,9,2,7,0,0.285714285714286
vietnam,1,7,3,4,0,0.75
jalapic,1,7,3,4,0,0.75
tasposbousnonweimitiveationce,0,29,14,15,0,0.933333333333333
brads,1,5,1,4,0,0.25
andirubine,0,10,5,5,0,1
pleurobrachium,0,14,6,8,0,0.75
dearansemetypechtomisackinaffs,0,30,11,19,0,0.578947368421053
impentrontronguishnessorsenko,0,29,10,19,0,0.526315789473684
dwatos,0,6,2,4,0,0.5
ellisogormawin,0,14,6,8,0,0.75
whitesville,1,11,4,7,0,0.571428571428571
'wxj,0,4,0,4,1,0
aestivate,1,9,5,4,0,1.25
counterstimulation,1,18,8,10,0,0.8
abilitherstuplodom,0,18,7,11,0,0.636363636363636
parrocheyer,0,11,4,7,0,0.571428571428571
pygaedomiths,0,12,4,8,0,0.5
interplay,1,9,3,6,0,0.5
branford,1,8,2,6,0,0.333333333333333
eopocamiqaw,0,11,6,5,0,1.2
norethindrones,1,14,5,9,0,0.555555555555556
tetrameria,0,10,5,5,0,1
coistrelsy,0,10,3,7,0,0.428571428571429
vited,0,5,2,3,0,0.666666666666667
simmesport,1,10,3,7,0,0.428571428571429
borophyte,0,9,3,6,0,0.5
premover,1,8,3,5,0,0.6
sciotheric,1,10,4,6,0,0.666666666666667
thingtosiseian,0,14,6,8,0,0.75
overintensely,1,13,5,8,0,0.625
merkle,1,6,2,4,0,0.5
bbunt,0,5,1,4,0,0.25
waiting,1,7,3,4,0,0.75
alientahdynckv,0,14,4,10,0,0.4
meropidan,1,9,4,5,0,0.8
girondisms,1,10,3,7,0,0.428571428571429
equibalancing,1,13,6,7,0,0.857142857142857
genian,1,6,3,3,0,1
osoewidrlnua,0,12,6,6,0,1
wordably,1,8,2,6,0,0.333333333333333
remixer,1,7,3,4,0,0.75
tubism,0,6,2,4,0,0.5
uncommandeered,0,14,6,8,0,0.75
anacle,0,6,3,3,0,1
jargoneer,1,9,4,5,0,0.8
parachronism,1,12,4,8,0,0.5
mjcb'cbcydpdohnwgb,0,18,1,17,1,0.0588235294117647
stiction,1,8,3,5,0,0.6
perinsk,0,7,2,5,0,0.4
moods,1,5,2,3,0,0.666666666666667
arbalisters,1,11,4,7,0,0.571428571428571
undisowning,1,11,4,7,0,0.571428571428571
butcherlike,0,11,4,7,0,0.571428571428571
hyperdelicateness,1,17,6,11,0,0.545454545454545
nonproscriptural,0,16,5,11,0,0.454545454545455
ffig,0,4,1,3,0,0.333333333333333
hicorababawashe,0,15,7,8,0,0.875
furnarius,1,9,4,5,0,0.8
owlclaws,1,8,2,6,0,0.333333333333333
eritudelamies,0,13,7,6,0,1.16666666666667
lnfgolfiyccuzcccmxtgkiic,0,24,5,19,0,0.263157894736842
finnocks,1,8,2,6,0,0.333333333333333
defaulted,1,9,4,5,0,0.8
craddock,1,8,2,6,0,0.333333333333333
bepoguore,0,9,5,4,0,1.25
connixationist,0,14,6,8,0,0.75
zs,1,2,0,2,0,0
latas,0,5,2,3,0,0.666666666666667
avilion,1,7,4,3,0,1.33333333333333
gonophysicalicuit,0,17,7,10,0,0.7
herayed,0,7,3,4,0,0.75
daisy,1,5,2,3,0,0.666666666666667
alleculates,0,11,5,6,0,0.833333333333333
primrosa,1,8,3,5,0,0.6
itrania,0,7,4,3,0,1.33333333333333
im'mgucmtvxu,0,12,3,9,1,0.333333333333333
kirkby,1,6,1,5,0,0.2
polypapilloma,1,13,5,8,0,0.625
outrage,1,7,4,3,0,1.33333333333333
enforming,1,9,3,6,0,0.5
lewisites,1,9,4,5,0,0.8
pneumoneritous,0,14,7,7,0,1
unhoplaspeckeypondoungium,0,25,10,15,0,0.666666666666667
mvqmtjchihipmgx,0,15,2,13,0,0.153846153846154
ronellated,0,10,4,6,0,0.666666666666667
bourg,1,5,2,3,0,0.666666666666667
kweernobehfqtflmnjxrj,0,21,4,17,0,0.235294117647059
niere,0,5,3,2,0,1.5
pencillers,1,10,3,7,0,0.428571428571429
mystagogues,1,11,4,7,0,0.571428571428571
balloted,1,8,3,5,0,0.6
imperforate,1,11,5,6,0,0.833333333333333
cretcherichokalidiorshapelk,0,27,10,17,0,0.588235294117647
capulatee,0,9,5,4,0,1.25
objosed,0,7,3,4,0,0.75
aivr,1,4,2,2,0,1
noctua,1,6,3,3,0,1
vyejwcjynyxsvtie,0,16,3,13,0,0.230769230769231
pue,0,3,2,1,0,2
stylaster,1,9,2,7,0,0.285714285714286
tfenynjyamxlyfpxeb'oiwjqciwb,0,28,6,22,1,0.272727272727273
amazonia,1,8,5,3,0,1.66666666666667
sability,0,8,3,5,0,0.6
brissotin,1,9,3,6,0,0.5
ocreatae,1,8,5,3,0,1.66666666666667
r'npatomppq'cgoipjzirmpiiemz,0,28,8,20,2,0.4
bilton,0,6,2,4,0,0.5
monodactylate,1,13,5,8,0,0.625
lankin,1,6,2,4,0,0.5
peptalking,1,10,3,7,0,0.428571428571429
chellstalberbian,0,16,5,11,0,0.454545454545455
porrapanchelirdertilogy,0,23,8,15,0,0.533333333333333
ermin,1,5,2,3,0,0.666666666666667
dringy,0,6,1,5,0,0.2
bicbcmsnkgcxwmngplp,0,19,1,18,0,0.0555555555555556
basutra,0,7,3,4,0,0.75
protoplasms,1,11,3,8,0,0.375
assoilzied,1,10,5,5,0,1
unposted,1,8,3,5,0,0.6
bqslqzhbpqsxldxukblvc'apmvsmae,0,30,4,26,1,0.153846153846154
vbavyjlent,0,10,2,8,0,0.25
whatkin,0,7,2,5,0,0.4
alxl'dmmghwtapo,0,15,3,12,1,0.25
vpqhyc'av'td,0,12,1,11,2,0.0909090909090909
adetidocke,0,10,5,5,0,1
dipterocarpaceae,1,16,8,8,0,1
photostatis,0,11,4,7,0,0.571428571428571
bulawayo,1,8,4,4,0,1
suprative,0,9,4,5,0,0.8
saleably,1,8,3,5,0,0.6
cisicontoleidateresenatort,0,26,12,14,0,0.857142857142857
leukaemons,0,10,5,5,0,1
shopkeepery,1,11,4,7,0,0.571428571428571
gabbert,1,7,2,5,0,0.4
saxxgapdntfi'rrnk'zrtbsbvqj,0,27,3,24,2,0.125
given,1,5,2,3,0,0.666666666666667
drachino,0,8,3,5,0,0.6
tezkererogresses,0,16,6,10,0,0.6
benzoylated,1,11,4,7,0,0.571428571428571
mareraerer,0,10,5,5,0,1
saxcornet,1,9,3,6,0,0.5
useneatolloptelicretis,0,22,10,12,0,0.833333333333333
cupels,1,6,2,4,0,0.5
teds,1,4,1,3,0,0.333333333333333
springhouse,1,11,4,7,0,0.571428571428571
hiniscisa,0,9,4,5,0,0.8
falsifiers,1,10,4,6,0,0.666666666666667
wanhap,1,6,2,4,0,0.5
bedazzlers,0,10,3,7,0,0.428571428571429
cvvvxs'zai,0,10,2,8,1,0.25
premosaic,1,9,4,5,0,0.8
paltongehabarons,0,16,6,10,0,0.6
plusch,1,6,1,5,0,0.2
gurging,0,7,2,5,0,0.4
xenarthra,1,9,3,6,0,0.5
mugeabilita,0,11,6,5,0,1.2
robigo,1,6,3,3,0,1
wils,0,4,1,3,0,0.333333333333333
unt,0,3,1,2,0,0.5
disrespectfully,1,15,4,11,0,0.363636363636364
ischool,0,7,3,4,0,0.75
legra,1,5,2,3,0,0.666666666666667
papagay,1,7,3,4,0,0.75
grippes,1,7,2,5,0,0.4
maynard,1,7,2,5,0,0.4
boubalungiorarwarg,0,18,8,10,0,0.8
lendlers,1,8,2,6,0,0.333333333333333
oppism,0,6,2,4,0,0.5
baerentwidonbter,0,16,6,10,0,0.6
nonvisualised,1,13,6,7,0,0.857142857142857
rickwood,1,8,3,5,0,0.6
disterer,0,8,3,5,0,0.6
randomises,1,10,4,6,0,0.666666666666667
scorza,1,6,2,4,0,0.5
icitia,0,6,4,2,0,2
demandable,1,10,4,6,0,0.666666666666667
communichollywoodine,0,20,8,12,0,0.666666666666667
copperbottom,1,12,4,8,0,0.5
qtblcdevse',0,11,2,9,1,0.222222222222222
borstal,1,7,2,5,0,0.4
walpurgating,0,12,4,8,0,0.5
iaps,0,4,2,2,0,1
acey,1,4,2,2,0,1
untufted,1,8,3,5,0,0.6
metamorphosian,1,14,6,8,0,0.75
enclassificatories,0,18,8,10,0,0.8
momyprildabenbsty,0,17,4,13,0,0.307692307692308
tivacandaeresicyctrizetaloureeglongaral,0,39,17,22,0,0.772727272727273
empassioned,1,11,5,6,0,0.833333333333333
diospyros,1,9,3,6,0,0.5
swatterings,0,11,3,8,0,0.375
undetectably,1,12,4,8,0,0.5
afolumjobuoh,0,12,6,6,0,1
melee,1,5,3,2,0,1.5
av'poqojkta,0,11,4,7,1,0.571428571428571
cymbella,1,8,2,6,0,0.333333333333333
zu'lkadah,1,9,3,6,1,0.5
erdelanser,0,10,4,6,0,0.666666666666667
ritivelon,0,9,4,5,0,0.8
gologism,0,8,3,5,0,0.6
accentristasis,0,14,5,9,0,0.555555555555556
diani,0,5,3,2,0,1.5
uninted,0,7,3,4,0,0.75
sarcoping,0,9,3,6,0,0.5
glossopode,1,10,4,6,0,0.666666666666667
palaeichthyologists,1,19,7,12,0,0.583333333333333
vanny,1,5,1,4,0,0.25
estheses,0,8,3,5,0,0.6
mtsqefgjfytqcoewuq'unmctrh,0,26,5,21,1,0.238095238095238
momzers,1,7,2,5,0,0.4
anisee,0,6,4,2,0,2
kalmitic,0,8,3,5,0,0.6
nigenianlike,0,12,6,6,0,1
superinsanitating,0,17,7,10,0,0.7
thbullynaralmencellulaynnallater,0,32,10,22,0,0.454545454545455
lempirism,0,9,3,6,0,0.5
basinet,1,7,3,4,0,0.75
'loych,0,6,1,5,1,0.2
beothetl,0,8,3,5,0,0.6
tayside,1,7,3,4,0,0.75
forzando,1,8,3,5,0,0.6
minifloppies,1,12,5,7,0,0.714285714285714
naturaled,0,9,4,5,0,0.8
esodrayerichonwome,0,18,8,10,0,0.8
obumeingeconrictehorsciequridinprararadiatte,0,44,20,24,0,0.833333333333333
muscavada,1,9,4,5,0,0.8
vqogoqwliptcdkwurcwo,0,20,5,15,0,0.333333333333333
fthgxwz,0,7,0,7,0,0
mistreadings,1,12,4,8,0,0.5
madeiras,1,8,4,4,0,1
toluyls,1,7,2,5,0,0.4
enfeverous,0,10,5,5,0,1
vlcaxodvhg,0,10,2,8,0,0.25
undetected,1,10,4,6,0,0.666666666666667
prenesses,0,9,3,6,0,0.5
phucetithulexinernutestoplllymbontis,0,36,12,24,0,0.5
vbmvkmjmbtlpriqe'djfey,0,22,3,19,1,0.157894736842105
lsyuixgf'ghotmy'dggyv'aage,0,26,6,20,3,0.3
jlrjogoelkndffhs''txlchiwblrva,0,30,5,25,2,0.2
seie,0,4,3,1,0,3
ccbqkssadazwqcwkhuuisa'pln,0,26,6,20,1,0.3
goedichiable,0,12,6,6,0,1
caudally,1,8,3,5,0,0.6
boscessh,0,8,2,6,0,0.333333333333333
mifen,0,5,2,3,0,0.666666666666667
bozzaris,1,8,3,5,0,0.6
nephometically,0,14,5,9,0,0.555555555555556
heuchera,1,8,4,4,0,1
cristine,1,8,3,5,0,0.6
nostarnatordemionegly,0,21,8,13,0,0.615384615384615
canthitis,1,9,3,6,0,0.5
glucosidase,1,11,5,6,0,0.833333333333333
nontoplastinopin,0,16,6,10,0,0.6
usherer,1,7,3,4,0,0.75
leniate,1,7,4,3,0,1.33333333333333
mariswlurores,0,13,5,8,0,0.625
shopbreaker,1,11,4,7,0,0.571428571428571
ordemfratistabina,0,17,7,10,0,0.7
overpermissibility,0,18,7,11,0,0.636363636363636
borrichiases,0,12,5,7,0,0.714285714285714
hexanichomepacked,0,17,7,10,0,0.7
scaphander,1,10,3,7,0,0.428571428571429
mnnatherescuss,0,14,4,10,0,0.4
deuteronomistic,1,15,7,8,0,0.875
indersion,0,9,4,5,0,0.8
gqki'mehutmkoqqqulpzlkhfudfa,0,28,7,21,1,0.333333333333333
'xyn,0,4,0,4,1,0
tsail,0,5,2,3,0,0.666666666666667
shookidae,0,9,5,4,0,1.25
cellaria,0,8,4,4,0,1
stropstrogelli,0,14,4,10,0,0.4
chmetricony,0,11,3,8,0,0.375
featherbedded,1,13,5,8,0,0.625
probat,0,6,2,4,0,0.5
properustic,0,11,4,7,0,0.571428571428571
dodmeating,0,10,4,6,0,0.666666666666667
ministership,1,12,4,8,0,0.5
lauconjuncturatinenced,0,22,9,13,0,0.692307692307692
unobjectified,1,13,6,7,0,0.857142857142857
smqbh'jvswgtf,0,13,0,13,1,0
grerc,0,5,1,4,0,0.25
reintroducing,1,13,5,8,0,0.625
preposterousness,1,16,6,10,0,0.6
gunsmithings,1,12,3,9,0,0.333333333333333
oqqdlfzjjy,0,10,1,9,0,0.111111111111111
slifter,1,7,2,5,0,0.4
unitions,1,8,4,4,0,1
semanns,0,7,2,5,0,0.4
tragmakin,0,9,3,6,0,0.5
pfalz,1,5,1,4,0,0.25
diapsida,1,8,4,4,0,1
scalemom,0,8,3,5,0,0.6
calyptrimorpha,0,14,4,10,0,0.4
defes,0,5,2,3,0,0.666666666666667
ly,1,2,0,2,0,0
arosaguntacook,1,14,7,7,0,1
plowwitten,0,10,3,7,0,0.428571428571429
finiptyg,0,8,2,6,0,0.333333333333333
wiivpxjaslrduww,0,15,4,11,0,0.363636363636364
ropyidast,0,9,3,6,0,0.5
racemations,1,11,5,6,0,0.833333333333333
limbmeal,1,8,3,5,0,0.6
energeticness,1,13,5,8,0,0.625
phthalocyanine,1,14,5,9,0,0.555555555555556
epvkhodprvkknuwrhb,0,18,3,15,0,0.2
lisarcod,0,8,3,5,0,0.6
surfacemaker,0,12,5,7,0,0.714285714285714
adiscocestogarobangulionos,0,26,12,14,0,0.857142857142857
inded,0,5,2,3,0,0.666666666666667
scelests,0,8,2,6,0,0.333333333333333
inet,0,4,2,2,0,1
elaugglot,0,9,4,5,0,0.8
groundling,1,10,3,7,0,0.428571428571429
mariastein,1,10,5,5,0,1
uneffableness,0,13,5,8,0,0.625
bunghole,1,8,3,5,0,0.6
groning,1,7,2,5,0,0.4
lowerathenjudy,0,14,5,9,0,0.555555555555556
amidofluoride,1,13,7,6,0,1.16666666666667
weogufka,1,8,4,4,0,1
deside,0,6,3,3,0,1
overdesses,0,10,4,6,0,0.666666666666667
torlyititror,0,12,4,8,0,0.5
claustrophilia,1,14,6,8,0,0.75
earuliverregmamondggrn,0,22,8,14,0,0.571428571428571
mauvein,1,7,4,3,0,1.33333333333333
sitella,1,7,3,4,0,0.75
magnetotransmitter,1,18,6,12,0,0.5
noncensurableness,1,17,6,11,0,0.545454545454545
comapy,0,6,2,4,0,0.5
winded,1,6,2,4,0,0.5
iompgbjmd,0,9,2,7,0,0.285714285714286
deoxyrrhotic,0,12,4,8,0,0.5
glucine,1,7,3,4,0,0.75
unchettologicality,0,18,7,11,0,0.636363636363636
iat,0,3,2,1,0,2
dzfazipvwsmymhyyxibkxgectky,0,27,4,23,0,0.173913043478261
ula,1,3,2,1,0,2
cheka,1,5,2,3,0,0.666666666666667
daisy,1,5,2,3,0,0.666666666666667
petitioning,1,11,5,6,0,0.833333333333333
sumas,1,5,2,3,0,0.666666666666667
tarente,1,7,3,4,0,0.75
endorsayersvillested,0,20,7,13,0,0.538461538461538
port,1,4,1,3,0,0.333333333333333
protector,1,9,3,6,0,0.5
cayce,1,5,2,3,0,0.666666666666667
potiguara,1,9,5,4,0,1.25
hamoderlaters,0,13,5,8,0,0.625
righteousnesses,1,15,6,9,0,0.666666666666667
lowriglycercourties,0,19,7,12,0,0.583333333333333
complian,0,8,3,5,0,0.6
ericetal,1,8,4,4,0,1
ishtar,1,6,2,4,0,0.5
ebh'pe'xmgcseftzsjz'tk,0,22,3,19,3,0.157894736842105
resump,0,6,2,4,0,0.5
expressures,1,11,4,7,0,0.571428571428571
barmskin,1,8,2,6,0,0.333333333333333
scientiarum,1,11,5,6,0,0.833333333333333
squalization,0,12,6,6,0,1
pretended,1,9,3,6,0,0.5
vophdawuoocpegx,0,15,6,9,0,0.666666666666667
fugened,0,7,3,4,0,0.75
nbfb'dspdpesjfyqqj'nkfqe,0,24,2,22,2,0.0909090909090909
scarfish,1,8,2,6,0,0.333333333333333
skryabinsk,0,10,2,8,0,0.25
mencenobtifel,0,13,5,8,0,0.625
pancreatomy,1,11,4,7,0,0.571428571428571
lipans,1,6,2,4,0,0.5
cebridalty,0,10,3,7,0,0.428571428571429
bleagelvanontestenstae,0,22,9,13,0,0.692307692307692
scouted,1,7,3,4,0,0.75
phenocain,1,9,4,5,0,0.8
unatesant,0,9,4,5,0,0.8
kefauver,1,8,4,4,0,1
hindusen,0,8,3,5,0,0.6
anatifa,1,7,4,3,0,1.33333333333333
hegari,1,6,3,3,0,1
linguini,1,8,4,4,0,1
celtish,1,7,2,5,0,0.4
beyle,1,5,2,3,0,0.666666666666667
qqphupcgxszfoqk'dddgmszh,0,24,2,22,1,0.0909090909090909
oblammonga,0,10,4,6,0,0.666666666666667
haematinics,1,11,5,6,0,0.833333333333333
vocality,1,8,3,5,0,0.6
intones,1,7,3,4,0,0.75
mccurdy,1,7,1,6,0,0.166666666666667
fuggi,0,5,2,3,0,0.666666666666667
roopit,1,6,3,3,0,1
misentrails,0,11,4,7,0,0.571428571428571
ealingoge,0,9,5,4,0,1.25
matavince,0,9,4,5,0,0.8
brwsweafnhahjlgrf,0,17,3,14,0,0.214285714285714
unspinsterdom,0,13,4,9,0,0.444444444444444
anticle,0,7,3,4,0,0.75
mortification,1,13,6,7,0,0.857142857142857
atenissm,0,8,3,5,0,0.6
hima,1,4,2,2,0,1
orterde,1,7,3,4,0,0.75
trypanosomiasis,1,15,6,9,0,0.666666666666667
unsparse,1,8,3,5,0,0.6
goltry,1,6,1,5,0,0.2
bogarisunbemaldonn,0,18,7,11,0,0.636363636363636
polariostaging,0,14,6,8,0,0.75
expurg,0,6,2,4,0,0.5
deasils,1,7,3,4,0,0.75
phyllome,1,8,2,6,0,0.333333333333333
shamanistically,0,15,5,10,0,0.5
eowogblfhx,0,10,3,7,0,0.428571428571429
epionychium,1,11,5,6,0,0.833333333333333
accormatothreaceae,0,18,9,9,0,1
inhomogeneously,1,15,7,8,0,0.875
cxoxfjoniuqfirszcxcvuf,0,22,6,16,0,0.375
noradabi,0,8,4,4,0,1
cdss,0,4,0,4,0,0
subworkmen,0,10,3,7,0,0.428571428571429
gckdisph'iimoajsrn,0,18,5,13,1,0.384615384615385
undermented,0,11,4,7,0,0.571428571428571
ptolemaean,1,10,5,5,0,1
penhuans,0,8,3,5,0,0.6
scc,1,3,0,3,0,0
phenomenology,1,13,5,8,0,0.625
amomeleased,0,11,6,5,0,1.2
biogen,1,6,3,3,0,1
grivoise,1,8,4,4,0,1
pourpoint,1,9,4,5,0,0.8
pbus'fm'c'aupvec,0,16,4,12,3,0.333333333333333
flouncey,1,8,3,5,0,0.6
ameers,1,6,3,3,0,1
vcmyphqvlumkrv,0,14,1,13,0,0.0769230769230769
rampanctaber,0,12,4,8,0,0.5
rotr,0,4,1,3,0,0.333333333333333
vermountainous,0,14,7,7,0,1
mowbray,1,7,2,5,0,0.4
unquestionably,1,14,6,8,0,0.75
incineramic,0,11,5,6,0,0.833333333333333
unfrete,0,7,3,4,0,0.75
diaphanie,1,9,5,4,0,1.25
aquila,1,6,4,2,0,2
collophanite,1,12,5,7,0,0.714285714285714
hemerobiidae,1,12,7,5,0,1.4
ments,0,5,1,4,0,0.25
kmevjwdkqib,0,11,2,9,0,0.222222222222222
participator,1,12,5,7,0,0.714285714285714
bumens,0,6,2,4,0,0.5
anglim,1,6,2,4,0,0.5
quirked,1,7,3,4,0,0.75
unstingingly,1,12,3,9,0,0.333333333333333
emir,1,4,2,2,0,1
classifically,1,13,4,9,0,0.444444444444444
odontidae,0,9,5,4,0,1.25
grocerdom,1,9,3,6,0,0.5
armband,1,7,2,5,0,0.4
lnxguxpcdnre,0,12,2,10,0,0.2
raudespoder,0,11,5,6,0,0.833333333333333
cinalilfos,0,10,4,6,0,0.666666666666667
dentinoblastoma,0,15,6,9,0,0.666666666666667
flinn,1,5,1,4,0,0.25
plate,1,5,2,3,0,0.666666666666667
backwort,1,8,2,6,0,0.333333333333333
neglenestic,0,11,4,7,0,0.571428571428571
noninferentially,1,16,6,10,0,0.6
blacktree,1,9,3,6,0,0.5
jutyd,0,5,1,4,0,0.25
vasodilatoriness,0,16,7,9,0,0.777777777777778
pedie,0,5,3,2,0,1.5
dropflower,1,10,3,7,0,0.428571428571429
stevenage,1,9,4,5,0,0.8
gymnasias,0,9,3,6,0,0.5
autearss,0,8,4,4,0,1
sponsien,0,8,3,5,0,0.6
stewers,1,7,2,5,0,0.4
preacquisitively,1,16,7,9,0,0.777777777777778
smbiceordurolarknaithy,0,22,8,14,0,0.571428571428571
epithelioblastoma,1,17,8,9,0,0.888888888888889
adrome,0,6,3,3,0,1
poromess,0,8,3,5,0,0.6
hyztbkdolplhpgmpynawxyacux,0,26,4,22,0,0.181818181818182
qrnsg'vljnpqozqdvtmhiimpnsg,0,27,3,24,1,0.125
whitepots,1,9,3,6,0,0.5
procatory,0,9,3,6,0,0.5
remercied,1,9,4,5,0,0.8
bount,0,5,2,3,0,0.666666666666667
wapjxkqiissyofvvdxe',0,20,5,15,1,0.333333333333333
osteology,1,9,4,5,0,0.8
paediluviating,0,14,7,7,0,1
randed,1,6,2,4,0,0.5
hoodlumism,1,10,4,6,0,0.666666666666667
gajnbotqzpri,0,12,3,9,0,0.333333333333333
phatoblbedere,0,13,5,8,0,0.625
tuberculeate,0,12,6,6,0,1
sonous,0,6,3,3,0,1
trum,0,4,1,3,0,0.333333333333333
germanophils,1,12,4,8,0,0.5
sacring,1,7,2,5,0,0.4
thering,0,7,2,5,0,0.4
photohemopyrrole,0,16,6,10,0,0.6
unphilosophised,1,15,6,9,0,0.666666666666667
unadmissible,1,12,5,7,0,0.714285714285714
codiaeum,1,8,5,3,0,1.66666666666667
skeuomorphic,1,12,5,7,0,0.714285714285714
kellihenry,0,10,3,7,0,0.428571428571429
tionikoney,0,10,5,5,0,1
endorse,1,7,3,4,0,0.75
libidinously,1,12,5,7,0,0.714285714285714
kutzer,1,6,2,4,0,0.5
gnetacentroph,0,13,4,9,0,0.444444444444444
crunt,1,5,1,4,0,0.25
rikelpha,0,8,3,5,0,0.6
fairon,0,6,3,3,0,1
irckuhqngvwttxjjqzskkv,0,22,2,20,0,0.1
whoopsie,1,8,4,4,0,1
snooking,1,8,3,5,0,0.6
haema,0,5,3,2,0,1.5
alterity,1,8,3,5,0,0.6
roidrosionewists,0,16,7,9,0,0.777777777777778
olare,0,5,3,2,0,1.5
payability,1,10,4,6,0,0.666666666666667
stretchberry,1,12,2,10,0,0.2
imytrsthons,0,11,2,9,0,0.222222222222222
nitringnessaspinglyprily,0,24,6,18,0,0.333333333333333
invertor,1,8,3,5,0,0.6
aubers,0,6,3,3,0,1
nurses,1,6,2,4,0,0.5
pangality,0,9,3,6,0,0.5
charlesworth,1,12,3,9,0,0.333333333333333
enolater,0,8,4,4,0,1
evelyn,1,6,2,4,0,0.5
hisambal,0,8,3,5,0,0.6
functus,1,7,2,5,0,0.4
hystereste,0,10,3,7,0,0.428571428571429
evoy,1,4,2,2,0,1
excoriator,1,10,5,5,0,1
antipragmatisms,0,15,5,10,0,0.5
earthquaken,1,11,5,6,0,0.833333333333333
myzostoma,1,9,3,6,0,0.5
predestined,1,11,4,7,0,0.571428571428571
balisaurs,1,9,4,5,0,0.8
deopyle,1,7,3,4,0,0.75
catfight,1,8,2,6,0,0.333333333333333
untoxicophysicographic,0,22,8,14,0,0.571428571428571
tjad,0,4,1,3,0,0.333333333333333
monity,0,6,2,4,0,0.5
illeriornersifically,0,20,8,12,0,0.666666666666667
viceronia,0,9,5,4,0,1.25
lattlecal,0,9,3,6,0,0.5
nodosariia,0,10,6,4,0,1.5
canapina,1,8,4,4,0,1
pricid,0,6,2,4,0,0.5
mgu,0,3,1,2,0,0.5
pennyworts,1,10,2,8,0,0.25
ner,0,3,1,2,0,0.5
genealogies,1,11,6,5,0,1.2
squadder,1,8,3,5,0,0.6
fishhook,1,8,3,5,0,0.6
grappeachenshable,0,17,6,11,0,0.545454545454545
nxqnbhmtarfl'cruwydm,0,20,2,18,1,0.111111111111111
irretractable,1,13,5,8,0,0.625
auburnt,0,7,3,4,0,0.75
universalist,1,12,5,7,0,0.714285714285714
symphoniousness,0,15,5,10,0,0.5
marifrangiotelephone,0,20,9,11,0,0.818181818181818
senzer,1,6,2,4,0,0.5
premiscoplanomisress,0,20,7,13,0,0.538461538461538
gillet,1,6,2,4,0,0.5
cheliphalones,0,13,5,8,0,0.625
subdititious,1,12,6,6,0,1
nonconya,0,8,3,5,0,0.6
dassins,0,7,2,5,0,0.4
herlasm,0,7,2,5,0,0.4
pushpin,1,7,2,5,0,0.4
rengeat,0,7,3,4,0,0.75
chimneybreasts,1,14,4,10,0,0.4
braun,1,5,2,3,0,0.666666666666667
blepharosynechia,1,16,6,10,0,0.6
moogrosymphobollerminitryo,0,26,9,17,0,0.529411764705882
goosey,1,6,3,3,0,1
counterlocutory,0,15,6,9,0,0.666666666666667
thurrock,1,8,2,6,0,0.333333333333333
phytenpictetizvelilsieraph,0,26,9,17,0,0.529411764705882
airbursts,1,9,3,6,0,0.5
baddyprophadioan,0,16,6,10,0,0.6
flatto,1,6,2,4,0,0.5
mannie,1,6,3,3,0,1
infaicalvoks,0,12,5,7,0,0.714285714285714
furner,0,6,2,4,0,0.5
tjdiqixpfbm,0,11,2,9,0,0.222222222222222
thyroidisms,0,11,3,8,0,0.375
whodestivemaipanncalyarid,0,25,10,15,0,0.666666666666667
teleutherners,0,13,5,8,0,0.625
songles,0,7,2,5,0,0.4
oxjtsljymnu'c,0,13,2,11,1,0.181818181818182
counterattestation,1,18,8,10,0,0.8
undesiri,0,8,4,4,0,1
gopher,1,6,2,4,0,0.5
phetacalcide,0,12,5,7,0,0.714285714285714
oarite,0,6,4,2,0,2
postholer,0,9,3,6,0,0.5
porkling,1,8,2,6,0,0.333333333333333
reinstalments,1,13,4,9,0,0.444444444444444
megahertzes,1,11,4,7,0,0.571428571428571
atheise,1,7,4,3,0,1.33333333333333
dichotricus,0,11,4,7,0,0.571428571428571
blals,0,5,1,4,0,0.25
backstarting,1,12,3,9,0,0.333333333333333
dista,0,5,2,3,0,0.666666666666667
spinoperipheral,1,15,6,9,0,0.666666666666667
reic,0,4,2,2,0,1
hammerbird,1,10,3,7,0,0.428571428571429
snivellements,0,13,4,9,0,0.444444444444444
braggings,1,9,2,7,0,0.285714285714286
neuterist,0,9,4,5,0,0.8
hundi,1,5,2,3,0,0.666666666666667
nonism,0,6,2,4,0,0.5
wxdoxkknatichzwrilkpd,0,21,4,17,0,0.235294117647059
hyposis,0,7,2,5,0,0.4
eludicatory,1,11,5,6,0,0.833333333333333
ehlke,1,5,2,3,0,0.666666666666667
auff,0,4,2,2,0,1
lemonnier,1,9,4,5,0,0.8
aiguelle,1,8,5,3,0,1.66666666666667
elstonetobtaging,0,16,6,10,0,0.6
maoritanga,1,10,5,5,0,1
vassimosgench,0,13,4,9,0,0.444444444444444
hexastillaries,0,14,6,8,0,0.75
dryopithetosity,0,15,5,10,0,0.5
angusels,0,8,3,5,0,0.6
villote,1,7,3,4,0,0.75
wyvjngfcitdgua,0,14,3,11,0,0.272727272727273
anionmitae,0,10,6,4,0,1.5
matagorda,1,9,4,5,0,0.8
inting,0,6,2,4,0,0.5
proofs,1,6,2,4,0,0.5
xzxbredmpmmdnwjbbdxhaffkuupi,0,28,5,23,0,0.217391304347826
vs'votsjgc,0,10,1,9,1,0.111111111111111
glgwqxglxgexmy,0,14,1,13,0,0.0769230769230769
reverexpreseizure,0,17,8,9,0,0.888888888888889
organization,0,12,6,6,0,1
cagn,1,4,1,3,0,0.333333333333333
larprogruss,0,11,3,8,0,0.375
pipets,1,6,2,4,0,0.5
grooming,1,8,3,5,0,0.6
scaldberry,0,10,2,8,0,0.25
iancath,0,7,3,4,0,0.75
agnates,1,7,3,4,0,0.75
babbeyance,0,10,4,6,0,0.666666666666667
nucleonics,1,10,4,6,0,0.666666666666667
sivvyyines,0,10,3,7,0,0.428571428571429
zonure,1,6,3,3,0,1
shote,1,5,2,3,0,0.666666666666667
discotshipsyllophisms,0,21,5,16,0,0.3125
swithers,1,8,2,6,0,0.333333333333333
saphar,1,6,2,4,0,0.5
hoffnung,1,8,2,6,0,0.333333333333333
n'plit,0,6,1,5,1,0.2
musnud,1,6,2,4,0,0.5
liga,0,4,2,2,0,1
megalohepatia,1,13,7,6,0,1.16666666666667
ritthizolat,0,11,4,7,0,0.571428571428571
bagpiece,0,8,4,4,0,1
supramechanical,1,15,6,9,0,0.666666666666667
boac,1,4,2,2,0,1
teleg,1,5,2,3,0,0.666666666666667
handax,1,6,2,4,0,0.5
martinson,1,9,3,6,0,0.5
icebox,1,6,3,3,0,1
lacrymations,1,12,4,8,0,0.5
euryalean,1,9,5,4,0,1.25
framboesia,1,10,5,5,0,1
bigam,1,5,2,3,0,0.666666666666667
eezpajq,0,7,3,4,0,0.75
snuffing,1,8,2,6,0,0.333333333333333
degradation,1,11,5,6,0,0.833333333333333
carnalism,1,9,3,6,0,0.5
wylma,1,5,1,4,0,0.25
petiolatry,0,10,4,6,0,0.666666666666667
burgee,1,6,3,3,0,1
archielazygotics,0,16,6,10,0,0.6
jbq'cvvggnupgbbigbvtpixwwk,0,26,3,23,1,0.130434782608696
libertarian,1,11,5,6,0,0.833333333333333
hypochlorura,0,12,4,8,0,0.5
teagle,1,6,3,3,0,1
picotaponombiseronnde,0,21,9,12,0,0.75
pteraspid,1,9,3,6,0,0.5
storewide,1,9,4,5,0,0.8
cuite,0,5,3,2,0,1.5
ambiguousness,1,13,6,7,0,0.857142857142857
'ct'as'jklxjb,0,13,1,12,3,0.0833333333333333
lieutenandt,0,11,5,6,0,0.833333333333333
q'ph'gqzwpwy,0,12,0,12,2,0
prepubl,0,7,2,5,0,0.4
unbranicipidireston,0,19,8,11,0,0.727272727272727
janitress,1,9,3,6,0,0.5
impersonate,1,11,5,6,0,0.833333333333333
chaselectrifectant,0,18,6,12,0,0.5
assekhwanging,0,13,4,9,0,0.444444444444444
pseudosomen,0,11,5,6,0,0.833333333333333
uricetsh,0,8,3,5,0,0.6
pective,0,7,3,4,0,0.75
omay,0,4,2,2,0,1
kehkmgexxcwsbrep,0,16,3,13,0,0.230769230769231
personalist,1,11,4,7,0,0.571428571428571
phyllanthes,0,11,2,9,0,0.222222222222222
enhjan,0,6,2,4,0,0.5
rger,0,4,1,3,0,0.333333333333333
preha,0,5,2,3,0,0.666666666666667
rieale,0,6,4,2,0,2
laccolitic,1,10,4,6,0,0.666666666666667
altisonant,1,10,4,6,0,0.666666666666667
heterotype,1,10,4,6,0,0.666666666666667
sonorrkoping,0,12,4,8,0,0.5
atenist,1,7,3,4,0,0.75
harbourer,1,9,4,5,0,0.8
fumiferana,1,10,5,5,0,1
favorable,0,9,4,5,0,0.8
brassate,1,8,3,5,0,0.6
arnuad,1,6,3,3,0,1
bewrays,1,7,2,5,0,0.4
overstrewing,1,12,4,8,0,0.5
barbaker,0,8,3,5,0,0.6
impactual,1,9,4,5,0,0.8
robiessed,0,9,4,5,0,0.8
nannofossil,1,11,4,7,0,0.571428571428571
bremen,1,6,2,4,0,0.5
templeville,1,11,4,7,0,0.571428571428571
gibberoses,0,10,4,6,0,0.666666666666667
blivit,1,6,2,4,0,0.5
worst,1,5,1,4,0,0.25
cade,1,4,2,2,0,1
sargasso,1,8,3,5,0,0.6
mirthsome,1,9,3,6,0,0.5
parabolanus,1,11,5,6,0,0.833333333333333
gqvcjpfvzxs,0,11,0,11,0,0
prolinmilly,0,11,3,8,0,0.375
dredianolied,0,12,6,6,0,1
gameless,1,8,3,5,0,0.6
siltlb,0,6,1,5,0,0.2
carates,1,7,3,4,0,0.75
chalcographer,1,13,4,9,0,0.444444444444444
polyphore,1,9,3,6,0,0.5
mermatics,0,9,3,6,0,0.5
icomkhxdijrqztktgdfutpc,0,23,4,19,0,0.210526315789474
pentathionic,1,12,5,7,0,0.714285714285714
phildbankt,0,10,2,8,0,0.25
yokelry,1,7,2,5,0,0.4
asweenon,0,8,4,4,0,1
predestiness,0,12,4,8,0,0.5
monembryonary,0,13,4,9,0,0.444444444444444
bulblets,1,8,2,6,0,0.333333333333333
brasser,1,7,2,5,0,0.4
fumigatories,1,12,6,6,0,1
gabriele,1,8,4,4,0,1
invariance,1,10,5,5,0,1
scoricals,0,9,3,6,0,0.5
microfiches,1,11,4,7,0,0.571428571428571
xekzisbiftq'ouvfid,0,18,6,12,1,0.5
ogcsjmaqvhforrpbqrgyz'dqgos,0,27,4,23,1,0.173913043478261
betulant,0,8,3,5,0,0.6
gravelling,1,10,3,7,0,0.428571428571429
phmos,0,5,1,4,0,0.25
anachoret,1,9,4,5,0,0.8
tztblpazkcutmjoeonqegtsivxp,0,27,7,20,0,0.35
kcdomydqflu,0,11,2,9,0,0.222222222222222
denaturalises,1,13,6,7,0,0.857142857142857
lalo,1,4,2,2,0,1
brolounsfagarjois,0,17,7,10,0,0.7
porphilists,0,11,3,8,0,0.375
misbelievingly,1,14,5,9,0,0.555555555555556
unenvyingklunky,0,15,4,11,0,0.363636363636364
overwheed,0,9,4,5,0,0.8
blrvchejntypgsmf,0,16,1,15,0,0.0666666666666667
cornfactor,1,10,3,7,0,0.428571428571429
ruscher,1,7,2,5,0,0.4
sks'wjkktgftz,0,13,0,13,1,0
leftfield,1,9,3,6,0,0.5
axemasterdom,0,12,5,7,0,0.714285714285714
min,1,3,1,2,0,0.5
hydroponist,1,11,3,8,0,0.375
apetalaceae,0,11,7,4,0,1.75
allegan,1,7,3,4,0,0.75
thrall,1,6,1,5,0,0.2
cisc,1,4,1,3,0,0.333333333333333
aventures,1,9,4,5,0,0.8
hvunyyxp,0,8,1,7,0,0.142857142857143
undeteriorated,1,14,7,7,0,1
antistalling,1,12,4,8,0,0.5
retrievings,1,11,4,7,0,0.571428571428571
diest,0,5,2,3,0,0.666666666666667
milla,1,5,2,3,0,0.666666666666667
hosta,1,5,2,3,0,0.666666666666667
faint,1,5,2,3,0,0.666666666666667
bortypretrprerstaurs,0,20,5,15,0,0.333333333333333
becramp,1,7,2,5,0,0.4
pareiasauri,1,11,7,4,0,1.75
'douqkczzfffrwtukxssj,0,21,3,18,1,0.166666666666667
swaliest,1,8,3,5,0,0.6
electrofused,1,12,5,7,0,0.714285714285714
dhaulagiri,1,10,5,5,0,1
handboard,0,9,3,6,0,0.5
nyind,0,5,1,4,0,0.25
restrism,0,8,2,6,0,0.333333333333333
aevite,0,6,4,2,0,2
qgt'xkzyelftpn,0,14,1,13,1,0.0769230769230769
upslangracioster,0,16,6,10,0,0.6
quando,1,6,3,3,0,1
accordancy,1,10,3,7,0,0.428571428571429
bers,0,4,1,3,0,0.333333333333333
disgustfulness,0,14,4,10,0,0.4
hontie,0,6,3,3,0,1
phytochemicals,1,14,4,10,0,0.4
polychromatophilia,1,18,7,11,0,0.636363636363636
unicornid,0,9,4,5,0,0.8
pertusariaceae,1,14,8,6,0,1.33333333333333
denayed,1,7,3,4,0,0.75
pedalos,1,7,3,4,0,0.75
piebald,1,7,3,4,0,0.75
dlasktwfqatpkwech,0,17,3,14,0,0.214285714285714
twaddlement,1,11,3,8,0,0.375
fulnesswombielepig,0,18,7,11,0,0.636363636363636
styloidy,0,8,2,6,0,0.333333333333333
yareta,1,6,3,3,0,1
bafta,1,5,2,3,0,0.666666666666667
indulgencing,1,12,4,8,0,0.5
demulsify,1,9,3,6,0,0.5
lae,1,3,2,1,0,2
touns,1,5,2,3,0,0.666666666666667
mism,0,4,1,3,0,0.333333333333333
sacrificialisms,0,15,6,9,0,0.666666666666667
pseudoan,0,8,4,4,0,1
assertative,1,11,5,6,0,0.833333333333333
lic,0,3,1,2,0,0.5
unallergic,1,10,4,6,0,0.666666666666667
slain,0,5,2,3,0,0.666666666666667
youthworth,0,10,3,7,0,0.428571428571429
osphygmomancy,0,13,3,10,0,0.3
batilda,1,7,3,4,0,0.75
creaser,1,7,3,4,0,0.75
wabbsts,0,7,1,6,0,0.166666666666667
balarama,1,8,4,4,0,1
novatory,1,8,3,5,0,0.6
subb,0,4,1,3,0,0.333333333333333
dearliness,0,10,4,6,0,0.666666666666667
vocimantially,0,13,5,8,0,0.625
nonwetted,1,9,3,6,0,0.5
kalamkaris,1,10,4,6,0,0.666666666666667
'robqksznzijsjbtbnlfopyhva,0,26,4,22,1,0.181818181818182
vesuvians,1,9,4,5,0,0.8
luxembourg,1,10,4,6,0,0.666666666666667
shakopee,1,8,4,4,0,1
arammicalthizallecha,0,20,8,12,0,0.666666666666667
granulary,1,9,3,6,0,0.5
classicisms,1,11,3,8,0,0.375
vamphorn,1,8,2,6,0,0.333333333333333
outechoirs,0,10,5,5,0,1
lipsone,0,7,3,4,0,0.75
poockerulliellyoin,0,18,8,10,0,0.8
serosanguineous,1,15,8,7,0,1.14285714285714
nonpassionate,1,13,6,7,0,0.857142857142857
iomi,0,4,3,1,0,3
trea,0,4,2,2,0,1
leafletting,1,11,4,7,0,0.571428571428571
subprief,0,8,3,5,0,0.6
firistraclawbircationnialle,0,27,11,16,0,0.6875
deodar,1,6,3,3,0,1
tetrain,0,7,3,4,0,0.75
pycnidium,1,9,3,6,0,0.5
ndeng,0,5,1,4,0,0.25
libiyjejtpxc,0,12,3,9,0,0.333333333333333
estafetted,1,10,4,6,0,0.666666666666667
nonabdication,1,13,6,7,0,0.857142857142857
friand,1,6,2,4,0,0.5
decompensated,1,13,5,8,0,0.625
dedramatical,0,12,5,7,0,0.714285714285714
unfrequented,1,12,5,7,0,0.714285714285714
countercry,1,10,3,7,0,0.428571428571429
grary,0,5,1,4,0,0.25
topsyturvification,1,18,7,11,0,0.636363636363636
avitic,1,6,3,3,0,1
distrates,0,9,3,6,0,0.5
hyalitises,1,10,4,6,0,0.666666666666667
mootmen,1,7,3,4,0,0.75
ardhamagadhi,1,12,5,7,0,0.714285714285714
baats,0,5,2,3,0,0.666666666666667
compkerius,0,10,4,6,0,0.666666666666667
jsdmki,0,6,1,5,0,0.2
forcienetahageniasespatel,0,25,12,13,0,0.923076923076923
pyrazoles,1,9,3,6,0,0.5
juvenolatry,0,11,4,7,0,0.571428571428571
haplochlamydeous,1,16,6,10,0,0.6
mutts,1,5,1,4,0,0.25
lakers,1,6,2,4,0,0.5
izzard,1,6,2,4,0,0.5
scalpless,1,9,2,7,0,0.285714285714286
esuen,0,5,3,2,0,1.5
pleryenounut,0,12,5,7,0,0.714285714285714
melts,1,5,1,4,0,0.25
huari,1,5,3,2,0,1.5
braggadocian,0,12,5,7,0,0.714285714285714
gramophora,0,10,4,6,0,0.666666666666667
counday,0,7,3,4,0,0.75
aram,1,4,2,2,0,1
ensnarements,1,12,4,8,0,0.5
rescuable,1,9,4,5,0,0.8
choddy,0,6,1,5,0,0.2
consolatory,1,11,4,7,0,0.571428571428571
trepan,1,6,2,4,0,0.5
zurrhduaafwloevpcxuoyl,0,22,8,14,0,0.571428571428571
cedarlane,1,9,4,5,0,0.8
rogeographian,0,13,6,7,0,0.857142857142857
ringness,0,8,2,6,0,0.333333333333333
overvalued,1,10,5,5,0,1
adrostral,1,9,3,6,0,0.5
tieric,0,6,3,3,0,1
hypersophist,0,12,3,9,0,0.333333333333333
sodomitish,1,10,4,6,0,0.666666666666667
ropishness,1,10,3,7,0,0.428571428571429
idzucryitiytrhgkuxadqjkv,0,24,6,18,0,0.333333333333333
fenneedlecretical,0,17,7,10,0,0.7
rhumb,1,5,1,4,0,0.25
stammers,1,8,2,6,0,0.333333333333333
miyasawa,1,8,4,4,0,1
salpingitis,1,11,4,7,0,0.571428571428571
macrot,0,6,2,4,0,0.5
hyperver,0,8,2,6,0,0.333333333333333
cieore,0,6,4,2,0,2
bleacheries,1,11,5,6,0,0.833333333333333
jolloped,1,8,3,5,0,0.6
proatheistic,1,12,5,7,0,0.714285714285714
dsjcxjuxcfpq,0,12,1,11,0,0.0909090909090909
byronicum,0,9,3,6,0,0.5
mudloggers,1,10,3,7,0,0.428571428571429
kylessestrook,0,13,4,9,0,0.444444444444444
slockdolagers,1,13,4,9,0,0.444444444444444
thoracostracan,1,14,5,9,0,0.555555555555556
hypercholested,0,14,4,10,0,0.4
rededicate,1,10,5,5,0,1
voetinae,0,8,5,3,0,1.66666666666667
bai,1,3,2,1,0,2
itymipeseaeanesquracarides,0,26,13,13,0,1
oztdwuqjdcukhaolfpxx,0,20,5,15,0,0.333333333333333
reediest,1,8,4,4,0,1
minoa,1,5,3,2,0,1.5
scarck,0,6,1,5,0,0.2
outpried,1,8,4,4,0,1
rzfchcbftlampufthtto'biay,0,25,5,20,1,0.25
vmjlosvkao'eajlctr',0,19,5,14,2,0.357142857142857
iodate,1,6,4,2,0,2
misosophist,1,11,4,7,0,0.571428571428571
whiners,1,7,2,5,0,0.4
arvier,0,6,3,3,0,1
ehulqn''amswcgkns,0,17,3,14,2,0.214285714285714
fwhm,1,4,0,4,0,0
lmxpyulfizfz,0,12,2,10,0,0.2
leucocythaemias,1,15,7,8,0,0.875
cuinechadecentaterary,0,21,9,12,0,0.75
intercommuned,1,13,5,8,0,0.625
newsweek,1,8,3,5,0,0.6
reaterdereobersensuscallinet,0,28,12,16,0,0.75
yeyecodndpg,0,11,3,8,0,0.375
borgeson,1,8,3,5,0,0.6
linchet,1,7,2,5,0,0.4
parky,1,5,1,4,0,0.25
brididactionworking,0,19,7,12,0,0.583333333333333
franking,1,8,2,6,0,0.333333333333333
suppression,1,11,4,7,0,0.571428571428571
maryland,1,8,2,6,0,0.333333333333333
schoolmasterhood,1,16,6,10,0,0.6
presol,0,6,2,4,0,0.5
displenishes,1,12,4,8,0,0.5
tropidoleptus,1,13,5,8,0,0.625
ingurgitation,1,13,6,7,0,0.857142857142857
polyanhydipelashebtech,0,22,7,15,0,0.466666666666667
anhaematoma,0,11,6,5,0,1.2
ablegating,0,10,4,6,0,0.666666666666667
irresolutions,1,13,6,7,0,0.857142857142857
hypsistarian,1,12,4,8,0,0.5
hydrow,0,6,1,5,0,0.2
greatish,1,8,3,5,0,0.6
ulturg,0,6,2,4,0,0.5
wingedness,1,10,3,7,0,0.428571428571429
w'nmgxxrjrtviabqyrha,0,20,3,17,1,0.176470588235294
supernation,1,11,5,6,0,0.833333333333333
cuckie,0,6,3,3,0,1
meshuggener,1,11,4,7,0,0.571428571428571
bearbines,1,9,4,5,0,0.8
dorchester,1,10,3,7,0,0.428571428571429
noncollusion,1,12,5,7,0,0.714285714285714
sarches,0,7,2,5,0,0.4
ypz'otvzomjevhnpdx,0,18,3,15,1,0.2
upleg,1,5,2,3,0,0.666666666666667
bbourvis,0,8,3,5,0,0.6
stylograph,1,10,2,8,0,0.25
compoer,1,7,3,4,0,0.75
variewed,0,8,4,4,0,1
dichromism,1,10,3,7,0,0.428571428571429
extendibility,1,13,5,8,0,0.625
monerenc,0,8,3,5,0,0.6
freelfts,0,8,2,6,0,0.333333333333333
slewer,1,6,2,4,0,0.5
sargapehatitinanthr,0,19,7,12,0,0.583333333333333
rearers,1,7,3,4,0,0.75
wisping,1,7,2,5,0,0.4
paboimpasi,0,10,5,5,0,1
chprenoxybin,0,12,3,9,0,0.333333333333333
pl,1,2,0,2,0,0
bannotarulians,0,14,6,8,0,0.75
stabilises,1,10,4,6,0,0.666666666666667
cemetery,1,8,3,5,0,0.6
zzt,1,3,0,3,0,0
walkingsticks,1,13,3,10,0,0.3
walf,0,4,1,3,0,0.333333333333333
neuromusculature,1,16,8,8,0,1
immersions,1,10,4,6,0,0.666666666666667
susists,0,7,2,5,0,0.4
fissioninae,0,11,6,5,0,1.2
undecretariat,0,13,6,7,0,0.857142857142857
gl'oswbrnxhs,0,12,1,11,1,0.0909090909090909
saccharoceptor,1,14,5,9,0,0.555555555555556
dissave,1,7,3,4,0,0.75
holnelica,0,9,4,5,0,0.8
chemicophysical,1,15,5,10,0,0.5
stubrunner,1,10,3,7,0,0.428571428571429
matorbootelboacos,0,17,8,9,0,0.888888888888889
rev,1,3,1,2,0,0.5
profite,0,7,3,4,0,0.75
chilogist,0,9,3,6,0,0.5
huguenotisms,1,12,5,7,0,0.714285714285714
eucyclic,1,8,3,5,0,0.6
joelism,0,7,3,4,0,0.75
guest,1,5,2,3,0,0.666666666666667
pedestalling,1,12,4,8,0,0.5
kryolitions,0,11,4,7,0,0.571428571428571
merrin,0,6,2,4,0,0.5
abisid,0,6,3,3,0,1
ideans,0,6,3,3,0,1
enplaned,1,8,3,5,0,0.6
riakityseachrs,0,14,5,9,0,0.555555555555556
abulfeda,1,8,4,4,0,1
clathrina,1,9,3,6,0,0.5
gulfhammonology,0,15,5,10,0,0.5
carouser,1,8,4,4,0,1
komupatioracesydogiorors,0,24,11,13,0,0.846153846153846
misentitle,1,10,4,6,0,0.666666666666667
trinitrotoluene,1,15,7,8,0,0.875
tarabar,1,7,3,4,0,0.75
inlaced,1,7,3,4,0,0.75
heminals,0,8,3,5,0,0.6
location,1,8,4,4,0,1
pseleberium,0,11,5,6,0,0.833333333333333
cornite,0,7,3,4,0,0.75
outgrowth,1,9,3,6,0,0.5
sardist,0,7,2,5,0,0.4
mifinlltorchencheblicediripotene,0,32,12,20,0,0.6
coups,1,5,2,3,0,0.666666666666667
ficomendramilly,0,15,5,10,0,0.5
stres,0,5,1,4,0,0.25
nervosanguineous,1,16,8,8,0,1
antensephesweinglaraeni,0,23,10,13,0,0.769230769230769
edwarmbrutage,0,13,5,8,0,0.625
elderly,1,7,2,5,0,0.4
hortyard,1,8,2,6,0,0.333333333333333
affeares,1,8,4,4,0,1
thuswise,1,8,3,5,0,0.6
gingelli,1,8,3,5,0,0.6
joysome,1,7,3,4,0,0.75
adagy,1,5,2,3,0,0.666666666666667
gunzian,1,7,3,4,0,0.75
posewhist,0,9,3,6,0,0.5
caqueteuses,1,11,6,5,0,1.2
polier,0,6,3,3,0,1
argyroneta,1,10,4,6,0,0.666666666666667
procta,0,6,2,4,0,0.5
microtechnic,1,12,4,8,0,0.5
clootirditidorus,0,16,7,9,0,0.777777777777778
zbkxhrerrhszct,0,14,1,13,0,0.0769230769230769
histotrophy,1,11,3,8,0,0.375
ddgattctvhzprdgixe'ze,0,21,4,17,1,0.235294117647059
deans,1,5,2,3,0,0.666666666666667
nonpenitent,1,11,4,7,0,0.571428571428571
ruessish,0,8,3,5,0,0.6
bestincket,0,10,3,7,0,0.428571428571429
pdcqr,0,5,0,5,0,0
mul,0,3,1,2,0,0.5
renarese,0,8,4,4,0,1
undrilion,0,9,4,5,0,0.8
deflatis,0,8,3,5,0,0.6
hyoplasty,0,9,2,7,0,0.285714285714286
eucoxcoricalnekts,0,17,7,10,0,0.7
garrat,1,6,2,4,0,0.5
telotaxis,1,9,4,5,0,0.8
fluolisatingly,0,14,5,9,0,0.555555555555556
herefordshire,1,13,5,8,0,0.625
flavanthrone,1,12,4,8,0,0.5
ealcoessophown,0,14,6,8,0,0.75
plutonomic,0,10,4,6,0,0.666666666666667
glabelmouthielsvilletta,0,23,9,14,0,0.642857142857143
ranomarring,0,11,4,7,0,0.571428571428571
indehiscences,1,13,5,8,0,0.625
fluorimetries,1,13,6,7,0,0.857142857142857
avokpjbbvygpvnllieutb,0,21,5,16,0,0.3125
ellipticities,1,13,6,7,0,0.857142857142857
crenella,1,8,3,5,0,0.6
gurmukhi,1,8,3,5,0,0.6
couspupered,0,11,5,6,0,0.833333333333333
mrujnefgrgnpfs,0,14,2,12,0,0.166666666666667
wetkint,0,7,2,5,0,0.4
luppdwkukyjimrbt'kaqasza,0,24,6,18,1,0.333333333333333
larner,1,6,2,4,0,0.5
cavitically,0,11,4,7,0,0.571428571428571
sfuluver,0,8,3,5,0,0.6
olich,0,5,2,3,0,0.666666666666667
'yuyjw,0,6,1,5,1,0.2
polysyllabi,0,11,3,8,0,0.375
prednisone,1,10,4,6,0,0.666666666666667
scoureetteran,0,13,6,7,0,0.857142857142857
excipula,1,8,4,4,0,1
emmity,0,6,2,4,0,0.5
gloater,1,7,3,4,0,0.75
mismaker,0,8,3,5,0,0.6
oeillades,1,9,5,4,0,1.25
quinnipiac,1,10,5,5,0,1
osselets,1,8,3,5,0,0.6
stist,0,5,1,4,0,0.25
opy,0,3,1,2,0,0.5
neur,0,4,2,2,0,1
contendance,0,11,4,7,0,0.571428571428571
facturable,0,10,4,6,0,0.666666666666667
birdcatcher,1,11,3,8,0,0.375
clayhole,1,8,3,5,0,0.6
calisedumkaryopittes,0,20,8,12,0,0.666666666666667
hoydenisms,1,10,3,7,0,0.428571428571429
pindaric,1,8,3,5,0,0.6
laric,0,5,2,3,0,0.666666666666667
obsidence,0,9,4,5,0,0.8
millines,1,8,3,5,0,0.6
archaemisationturalists,0,23,10,13,0,0.769230769230769
clingletinites,0,14,5,9,0,0.555555555555556
tiding,1,6,2,4,0,0.5
palaverer,1,9,4,5,0,0.8
exscisse,0,8,3,5,0,0.6
subconical,1,10,4,6,0,0.666666666666667
anior,0,5,3,2,0,1.5
uneffusion,0,10,5,5,0,1
yamaskino,0,9,4,5,0,0.8
calgon,1,6,2,4,0,0.5
aparance,0,8,4,4,0,1
yeoqvoeo''x',0,12,5,7,3,0.714285714285714
zolaesque,1,9,5,4,0,1.25
catiephen,0,9,4,5,0,0.8
cotemporaries,1,13,6,7,0,0.857142857142857
glaverer,0,8,3,5,0,0.6
orphipcherathiater,0,18,7,11,0,0.636363636363636
isogamy,1,7,3,4,0,0.75
severcombia,0,11,5,6,0,0.833333333333333
bracillocognes,0,14,5,9,0,0.555555555555556
shipranzans,0,11,3,8,0,0.375
misalleging,1,11,4,7,0,0.571428571428571
jookerincocklest,0,16,6,10,0,0.6
drollishness,1,12,3,9,0,0.333333333333333
rhrafogerhhoanoprifas,0,21,8,13,0,0.615384615384615
sheepfaced,1,10,4,6,0,0.666666666666667
cadecapamoubsirerudn,0,20,9,11,0,0.818181818181818
esmaria,1,7,4,3,0,1.33333333333333
nonbelligerency,1,15,5,10,0,0.5
poreticess,0,10,4,6,0,0.666666666666667
inductile,1,9,4,5,0,0.8
prioress,1,8,3,5,0,0.6
feneyanariandearloy,0,19,9,10,0,0.9
cxnrwplxuzqn'w,0,14,1,13,1,0.0769230769230769
bjnuwcb,0,7,1,6,0,0.166666666666667
hairlike,1,8,4,4,0,1
dbhp'tmdkjbsdouuecxxddxdsuxt,0,28,5,23,1,0.217391304347826
aite,0,4,3,1,0,3
adaptings,0,9,3,6,0,0.5
zxprcqic,0,8,1,7,0,0.142857142857143
gkzhqfdrsmzgpdtphbkl,0,20,0,20,0,0
kim'xnkvust,0,11,2,9,1,0.222222222222222
mecdcfgbangtbjzukgevhqzseuzapy,0,30,7,23,0,0.304347826086957
silctdkcdvmvjbsgrssdjepqqv,0,26,2,24,0,0.0833333333333333
trityles,0,8,2,6,0,0.333333333333333
jaspis,1,6,2,4,0,0.5
demibarren,0,10,4,6,0,0.666666666666667
wsbvn,0,5,0,5,0,0
sxiwpwiyfnayyupkjfujwyzdqrs,0,27,5,22,0,0.227272727272727
testicardines,1,13,5,8,0,0.625
subclauch,0,9,3,6,0,0.5
bastic,0,6,2,4,0,0.5
dustcart,1,8,2,6,0,0.333333333333333
bachella,0,8,3,5,0,0.6
oriana,1,6,4,2,0,2
mastodont,1,9,3,6,0,0.5
sunae,0,5,3,2,0,1.5
herenainontrfileilid,0,20,9,11,0,0.818181818181818
ankingraver,0,11,4,7,0,0.571428571428571
mesonemertini,1,13,6,7,0,0.857142857142857
zjlxypffer,0,10,1,9,0,0.111111111111111
sinisteries,0,11,5,6,0,0.833333333333333
carnifies,1,9,4,5,0,0.8
porphyrogenitism,1,16,5,11,0,0.454545454545455
nasute,1,6,3,3,0,1
isgwpywb,0,8,1,7,0,0.142857142857143
combinative,1,11,5,6,0,0.833333333333333
soolera,0,7,4,3,0,1.33333333333333
nwkuobdeedk,0,11,4,7,0,0.571428571428571
prudells,0,8,2,6,0,0.333333333333333
mohabidowozares,0,15,7,8,0,0.875
transposing,1,11,3,8,0,0.375
dallogenoncombries,0,18,7,11,0,0.636363636363636
nidium,0,6,3,3,0,1
messan,1,6,2,4,0,0.5
yahvistically,0,13,4,9,0,0.444444444444444
chylocaulously,1,14,5,9,0,0.555555555555556
bioactive,1,9,5,4,0,1.25
sac,1,3,1,2,0,0.5
ukokqltchuam,0,12,4,8,0,0.5
opportunisms,1,12,4,8,0,0.5
blaitially,0,10,4,6,0,0.666666666666667
diphthongised,1,13,4,9,0,0.444444444444444
whighilltbleraesucaupe,0,22,9,13,0,0.692307692307692
scanel,0,6,2,4,0,0.5
slended,0,7,2,5,0,0.4
acean,0,5,3,2,0,1.5
halimot,1,7,3,4,0,0.75
noisiness,1,9,4,5,0,0.8
raptorious,1,10,5,5,0,1
smootisericately,0,16,7,9,0,0.777777777777778
uninstanced,1,11,4,7,0,0.571428571428571
mulaprakriti,1,12,5,7,0,0.714285714285714
evols,0,5,2,3,0,0.666666666666667
sawsetter,1,9,3,6,0,0.5
wited,1,5,2,3,0,0.666666666666667
cumingtrus,0,10,3,7,0,0.428571428571429
egbeaution,0,10,6,4,0,1.5
zainer,0,6,3,3,0,1
melioratively,1,13,6,7,0,0.857142857142857
coprosma,1,8,3,5,0,0.6
qanaes,0,6,3,3,0,1
adendrium,0,9,4,5,0,0.8
chroman,0,7,2,5,0,0.4
poima,0,5,3,2,0,1.5
unliturgist,0,11,4,7,0,0.571428571428571
dwnd,0,4,0,4,0,0
gnvpon,0,6,1,5,0,0.2
mpedistisane,0,12,5,7,0,0.714285714285714
unoratown,0,9,4,5,0,0.8
ferrateen,1,9,4,5,0,0.8
cabernets,1,9,3,6,0,0.5
hermetamen,0,10,4,6,0,0.666666666666667
alienation,1,10,6,4,0,1.5
hekhsher,1,8,2,6,0,0.333333333333333
dise,0,4,2,2,0,1
collely,0,7,2,5,0,0.4
ibcba,0,5,2,3,0,0.666666666666667
ssoterldaninfis,0,15,5,10,0,0.5
magnums,1,7,2,5,0,0.4
almanontateney,0,14,6,8,0,0.75
polyganglionic,1,14,5,9,0,0.555555555555556
unenhanced,1,10,4,6,0,0.666666666666667
auditoria,1,9,6,3,0,2
allocryptic,1,11,3,8,0,0.375
drabetted,0,9,3,6,0,0.5
waylandscape,0,12,4,8,0,0.5
upupa,1,5,3,2,0,1.5
sallenerermhitaraxcouinecoanttanead,0,35,16,19,0,0.842105263157895
bedell,1,6,2,4,0,0.5
intersealingual,0,15,7,8,0,0.875
mortificator,0,12,5,7,0,0.714285714285714
povs,0,4,1,3,0,0.333333333333333
photodecomposition,1,18,8,10,0,0.8
lianatiaracilorinchedy,0,22,10,12,0,0.833333333333333
deophoniest,0,11,5,6,0,0.833333333333333
barklice,1,8,3,5,0,0.6
unimpresumpster,0,15,5,10,0,0.5
sothonganius,0,12,5,7,0,0.714285714285714
weteriaes,0,9,5,4,0,1.25
retreatant,1,10,4,6,0,0.666666666666667
airfreight,1,10,4,6,0,0.666666666666667
thermostatting,1,14,4,10,0,0.4
weigel,1,6,3,3,0,1
effluenzali,0,11,5,6,0,0.833333333333333
jesuitisms,1,10,4,6,0,0.666666666666667
reces,0,5,2,3,0,0.666666666666667
truthlessness,0,13,3,10,0,0.3
headwards,1,9,3,6,0,0.5
synaphea,1,8,3,5,0,0.6
'lgzjstrvskpobtpiskdeebcq,0,25,4,21,1,0.19047619047619
houdifid,0,8,4,4,0,1
muk,0,3,1,2,0,0.5
argyroteologist,0,15,6,9,0,0.666666666666667
flexography,1,11,3,8,0,0.375
olouansupoghe,0,13,7,6,0,1.16666666666667
thugging,1,8,2,6,0,0.333333333333333
cottekill,1,9,3,6,0,0.5
sinclairville,1,13,5,8,0,0.625
playton,0,7,2,5,0,0.4
'gvogv,0,6,1,5,1,0.2
nictitant,1,9,3,6,0,0.5
songbook,1,8,3,5,0,0.6
perjuring,1,9,3,6,0,0.5
stiones,0,7,3,4,0,0.75
scoplandaal,0,11,4,7,0,0.571428571428571
hidean,0,6,3,3,0,1
hissings,1,8,2,6,0,0.333333333333333
ttadachaeblabishets,0,19,7,12,0,0.583333333333333
schbergera,0,10,3,7,0,0.428571428571429
metropolises,1,12,5,7,0,0.714285714285714
wznmgfrddnfekbvycccxg,0,21,1,20,0,0.05
purcellville,1,12,4,8,0,0.5
cyanoguanins,0,12,5,7,0,0.714285714285714
pamphletizing,1,13,4,9,0,0.444444444444444
corporealists,1,13,5,8,0,0.625
tetic,0,5,2,3,0,0.666666666666667
chalic,0,6,2,4,0,0.5
notectric,0,9,3,6,0,0.5
mserongledonoourawr,0,19,8,11,0,0.727272727272727
extravisceral,1,13,5,8,0,0.625
respringer,0,10,3,7,0,0.428571428571429
mont,1,4,1,3,0,0.333333333333333
ogare,0,5,3,2,0,1.5
cowfuledinatinirimaygenanmuetwkeonne,0,36,16,20,0,0.8
rastles,1,7,2,5,0,0.4
willo,0,5,2,3,0,0.666666666666667
succulence,1,10,4,6,0,0.666666666666667
ultun,1,5,2,3,0,0.666666666666667
brckme,0,6,1,5,0,0.2
badgerwet,0,9,3,6,0,0.5
prognostically,1,14,4,10,0,0.4
espressos,1,9,3,6,0,0.5
toko,1,4,2,2,0,1
sterna,1,6,2,4,0,0.5
mylotyphalenosities,0,19,7,12,0,0.583333333333333
craryville,1,10,3,7,0,0.428571428571429
catholidae,0,10,5,5,0,1
lethyphidaininstircnaralteass,0,29,10,19,0,0.526315789473684
examiner,1,8,4,4,0,1
settablenesses,0,14,5,9,0,0.555555555555556
noniness,0,8,3,5,0,0.6
ungenuine,1,9,5,4,0,1.25
kacgmq'hdjbvxlfn,0,16,1,15,1,0.0666666666666667
waygooses,1,9,4,5,0,0.8
bionuntapelaciffele,0,19,9,10,0,0.9
barognosis,1,10,4,6,0,0.666666666666667
mavin,1,5,2,3,0,0.666666666666667
terwar,0,6,2,4,0,0.5
illine,0,6,3,3,0,1
qsrhnvgesjdqvnjh,0,16,1,15,0,0.0666666666666667
reests,1,6,2,4,0,0.5
aliber,1,6,3,3,0,1
allisan,1,7,3,4,0,0.75
scins,0,5,1,4,0,0.25
leavisite,1,9,5,4,0,1.25
ambushments,1,11,3,8,0,0.375
cephalus,1,8,3,5,0,0.6
pheshanonactobit,0,16,6,10,0,0.6
diffuser,1,8,3,5,0,0.6
dupuis,1,6,3,3,0,1
gidweq,0,6,2,4,0,0.5
saburration,1,11,5,6,0,0.833333333333333
sarcosmeteest,0,13,5,8,0,0.625
chrylioleaxicalatind,0,20,8,12,0,0.666666666666667
overfertilise,0,13,6,7,0,0.857142857142857
preimbursednesses,0,17,6,11,0,0.545454545454545
goie,0,4,3,1,0,3
bridarmantlist,0,14,4,10,0,0.4
pyg,0,3,0,3,0,0
accitotred,0,10,4,6,0,0.666666666666667
anomas,0,6,3,3,0,1
hyperostographic,0,16,5,11,0,0.454545454545455
excesse,0,7,3,4,0,0.75
thumby,1,6,1,5,0,0.2
brockiele,0,9,4,5,0,0.8
retried,1,7,3,4,0,0.75
aptjryucungqyirecxwwnigi,0,24,7,17,0,0.411764705882353
mpequphatiatricorilloas,0,23,10,13,0,0.769230769230769
plashingly,1,10,2,8,0,0.25
stical,0,6,2,4,0,0.5
acousiness,0,10,5,5,0,1
fisiae,0,6,4,2,0,2
langite,1,7,3,4,0,0.75
lizzie,1,6,3,3,0,1
matthau,1,7,3,4,0,0.75
oligochronin,0,12,5,7,0,0.714285714285714
attanerrizethd,0,14,5,9,0,0.555555555555556
helios,1,6,3,3,0,1
unstarting,1,10,3,7,0,0.428571428571429
overses,0,7,3,4,0,0.75
sensualists,1,11,4,7,0,0.571428571428571
foulletta,0,9,4,5,0,0.8
intemethid,0,10,4,6,0,0.666666666666667
gisharogetaplylontecly,0,22,7,15,0,0.466666666666667
dictator,1,8,3,5,0,0.6
qtksqxpcicgkqkfdzfkrxands,0,25,2,23,0,0.0869565217391304
fudder,1,6,2,4,0,0.5
megatheriid,1,11,5,6,0,0.833333333333333
jctn,1,4,0,4,0,0
sutherland,1,10,3,7,0,0.428571428571429
waverable,1,9,4,5,0,0.8
noyyietubgyykfsf,0,16,4,12,0,0.333333333333333
thogister,0,9,3,6,0,0.5
manity,1,6,2,4,0,0.5
hjerpe,1,6,2,4,0,0.5
private,1,7,3,4,0,0.75
dodgements,0,10,3,7,0,0.428571428571429
mfnchuring,0,10,2,8,0,0.25
stagists,0,8,2,6,0,0.333333333333333
epicleidium,1,11,6,5,0,1.2
gersample,0,9,3,6,0,0.5
espn,1,4,1,3,0,0.333333333333333
borde,1,5,2,3,0,0.666666666666667
presulphumpetishbaca,0,20,7,13,0,0.538461538461538
expedes,0,7,3,4,0,0.75
dintrics,0,8,2,6,0,0.333333333333333
alloxanate,1,10,5,5,0,1
leasingness,0,11,4,7,0,0.571428571428571
libril,0,6,2,4,0,0.5
dise,0,4,2,2,0,1
daler,1,5,2,3,0,0.666666666666667
lacis,1,5,2,3,0,0.666666666666667
idioticon,1,9,5,4,0,1.25
tacites,0,7,3,4,0,0.75
genova,1,6,3,3,0,1
febris,1,6,2,4,0,0.5
godspeeds,1,9,3,6,0,0.5
mangouste,1,9,4,5,0,0.8
elytrospace,0,11,4,7,0,0.571428571428571
gyeste,0,6,2,4,0,0.5
whitweek,1,8,3,5,0,0.6
emmetry,0,7,2,5,0,0.4
bivittate,1,9,4,5,0,0.8
hepatitis,1,9,4,5,0,0.8
porian,0,6,3,3,0,1
xhosan,1,6,2,4,0,0.5
oxidic,1,6,3,3,0,1
lexigraphies,1,12,5,7,0,0.714285714285714
gybkpxw,0,7,0,7,0,0
maintainable,1,12,6,6,0,1
merrimagua,0,10,5,5,0,1
hittagiustibicolour,0,19,9,10,0,0.9
antislave,0,9,4,5,0,0.8
nonlawyerliken,0,14,5,9,0,0.555555555555556
punthuntomathenirrecraminisers,0,30,11,19,0,0.578947368421053
photomy,0,7,2,5,0,0.4
coalson,0,7,3,4,0,0.75
o'rourke,1,8,4,4,1,1
kastry,0,6,1,5,0,0.2
nourisher,1,9,4,5,0,0.8
darraines,1,9,4,5,0,0.8
regelations,1,11,5,6,0,0.833333333333333
fusileers,1,9,4,5,0,0.8
diastimeter,1,11,5,6,0,0.833333333333333
nw'ioebfgkv,0,11,3,8,1,0.375
langerhans,1,10,3,7,0,0.428571428571429
bigod,1,5,2,3,0,0.666666666666667
versace,1,7,3,4,0,0.75
riboflavobacter,0,15,6,9,0,0.666666666666667
applicant,1,9,3,6,0,0.5
withdrawnnesses,1,15,4,11,0,0.363636363636364
hockedgentreps,0,14,4,10,0,0.4
t'nka''idrm,0,11,2,9,3,0.222222222222222
coautotillosishly,0,17,7,10,0,0.7
cspbvrn'd'jh,0,12,0,12,2,0
brontophobia,1,12,5,7,0,0.714285714285714
etesian,1,7,4,3,0,1.33333333333333
neel,1,4,2,2,0,1
awarn,1,5,2,3,0,0.666666666666667
amphigonous,1,11,5,6,0,0.833333333333333
paraphragmacy,0,13,4,9,0,0.444444444444444
livapoing,0,9,4,5,0,0.8
unfeverish,1,10,4,6,0,0.666666666666667
sores,1,5,2,3,0,0.666666666666667
midyear,1,7,3,4,0,0.75
outpolitic,0,10,5,5,0,1
cervicographies,1,15,6,9,0,0.666666666666667
operatenesses,0,13,6,7,0,0.857142857142857
archill,0,7,2,5,0,0.4
acuity,1,6,3,3,0,1
wrottesley,1,10,3,7,0,0.428571428571429
proiddles,0,9,3,6,0,0.5
notumers,0,8,3,5,0,0.6
hrijljzl'jietrxudgjeskajhrl,0,27,6,21,1,0.285714285714286
vent,1,4,1,3,0,0.333333333333333
bilharziasis,1,12,5,7,0,0.714285714285714
dulbert,1,7,2,5,0,0.4
presign,1,7,2,5,0,0.4
ispas,0,5,2,3,0,0.666666666666667
prodromus,1,9,3,6,0,0.5
radiopharmeceutical,1,19,9,10,0,0.9
skelm,1,5,1,4,0,0.25
overturn,1,8,3,5,0,0.6
beguilement,1,11,5,6,0,0.833333333333333
preim,0,5,2,3,0,0.666666666666667
organities,1,10,5,5,0,1
agirvictere,0,11,5,6,0,0.833333333333333
wartworts,1,9,2,7,0,0.285714285714286
patricksburg,1,12,3,9,0,0.333333333333333
anthidiales,0,11,5,6,0,0.833333333333333
doyenned,0,8,3,5,0,0.6
lucretenegardhos,0,16,6,10,0,0.6
potifer,1,7,3,4,0,0.75
callows,1,7,2,5,0,0.4
tubtail,1,7,3,4,0,0.75
ddenoturinoctelinhongat,0,23,9,14,0,0.642857142857143
austrogaea,1,10,6,4,0,1.5
malacostracan,1,13,5,8,0,0.625
smescis,0,7,2,5,0,0.4
idrryflttrhk,0,12,1,11,0,0.0909090909090909
poltophagists,0,13,4,9,0,0.444444444444444
noverrellbene,0,13,5,8,0,0.625
ezar,1,4,2,2,0,1
purchases,1,9,3,6,0,0.5
proviso,1,7,3,4,0,0.75
strix,1,5,1,4,0,0.25
aramanta,1,8,4,4,0,1
quintilis,1,9,4,5,0,0.8
rikargentaliness,0,16,6,10,0,0.6
unpendulousness,1,15,6,9,0,0.666666666666667
demise,1,6,3,3,0,1
emplasterstone,0,14,5,9,0,0.555555555555556
brodie,1,6,3,3,0,1
scenium,0,7,3,4,0,0.75
spergia,0,7,3,4,0,0.75
diploplacula,1,12,5,7,0,0.714285714285714
zuzzes,1,6,2,4,0,0.5
parently,0,8,2,6,0,0.333333333333333
nonparielle,0,11,5,6,0,0.833333333333333
demihigh,1,8,3,5,0,0.6
disillude,1,9,4,5,0,0.8
alkahe,0,6,3,3,0,1
homoclinal,1,10,4,6,0,0.666666666666667
gallinaginous,1,13,6,7,0,0.857142857142857
laggery,0,7,2,5,0,0.4
paedotribe,1,10,5,5,0,1
pemeesinmayulomoknouste,0,23,11,12,0,0.916666666666667
liquidogenous,1,13,7,6,0,1.16666666666667
alca,1,4,2,2,0,1
speakingness,1,12,4,8,0,0.5
cogalicrgoubole,0,15,7,8,0,0.875
mgucbidvcmro,0,12,3,9,0,0.333333333333333
subseverimmego,0,14,6,8,0,0.75
plantling,1,9,2,7,0,0.285714285714286
hipbaths,1,8,2,6,0,0.333333333333333
peai,1,4,3,1,0,3
wejdi,0,5,2,3,0,0.666666666666667
transferential,1,14,5,9,0,0.555555555555556
jacobson,1,8,3,5,0,0.6
roughishly,1,10,3,7,0,0.428571428571429
ronglytomollins,0,15,4,11,0,0.363636363636364
unclesfordan,0,12,4,8,0,0.5
braunite,1,8,4,4,0,1
edman,1,5,2,3,0,0.666666666666667
procreant,1,9,3,6,0,0.5
carnim,0,6,2,4,0,0.5
pizzelle,1,8,3,5,0,0.6
monickers,1,9,3,6,0,0.5
okean,1,5,3,2,0,1.5
undauntable,1,11,5,6,0,0.833333333333333
surfing,1,7,2,5,0,0.4
moleproofing,0,12,5,7,0,0.714285714285714
dimock,1,6,2,4,0,0.5
reachy,1,6,2,4,0,0.5
pachs,0,5,1,4,0,0.25
hszbxujjtztwqal',0,16,2,14,1,0.142857142857143
codelights,0,10,3,7,0,0.428571428571429
octantal,1,8,3,5,0,0.6
berginization,1,13,6,7,0,0.857142857142857
lunsford,1,8,2,6,0,0.333333333333333
carpaccios,1,10,4,6,0,0.666666666666667
stark,1,5,1,4,0,0.25
slickery,1,8,2,6,0,0.333333333333333
bethinks,1,8,2,6,0,0.333333333333333
puffinus,1,8,3,5,0,0.6
quinaquina,1,10,6,4,0,1.5
pappadams,1,9,3,6,0,0.5
pseudotetrameral,1,16,7,9,0,0.777777777777778
resoll,0,6,2,4,0,0.5
telitars,0,8,3,5,0,0.6
bitie,0,5,3,2,0,1.5
unquantified,1,12,6,6,0,1
fvozsnbwjmcdiwlnrqzacl,0,22,3,19,0,0.157894736842105
wyn,1,3,0,3,0,0
jerrymandering,1,14,4,10,0,0.4
sliddering,1,10,3,7,0,0.428571428571429
acquiets,0,8,4,4,0,1
blunter,1,7,2,5,0,0.4
pentally,0,8,2,6,0,0.333333333333333
flypapers,1,9,2,7,0,0.285714285714286
durning,1,7,2,5,0,0.4
faucets,1,7,3,4,0,0.75
fautors,1,7,3,4,0,0.75
barra,1,5,2,3,0,0.666666666666667
uncoprographottersic,0,20,7,13,0,0.538461538461538
relapse,1,7,3,4,0,0.75
atabrins,1,8,3,5,0,0.6
fubar,1,5,2,3,0,0.666666666666667
ypwkawcksxrtqouqkypcickdrs,0,26,4,22,0,0.181818181818182
neuringer,0,9,4,5,0,0.8
rigbane,1,7,3,4,0,0.75
tapur,0,5,2,3,0,0.666666666666667
lnweob,0,6,2,4,0,0.5
mwowyh,0,6,1,5,0,0.2
hounderlaud,0,11,5,6,0,0.833333333333333
magism,1,6,2,4,0,0.5
sequence,1,8,4,4,0,1
tetracadactylity,1,16,5,11,0,0.454545454545455
prgsmity,0,8,1,7,0,0.142857142857143
arrhizal,1,8,3,5,0,0.6
womanlike,1,9,4,5,0,0.8
tagerper,0,8,3,5,0,0.6
saganas,0,7,3,4,0,0.75
polyzoa,1,7,3,4,0,0.75
unbreweinshipsies,0,17,7,10,0,0.7
ogumus,0,6,3,3,0,1
bestiped,0,8,3,5,0,0.6
reppliers,0,9,3,6,0,0.5
transnationalism,1,16,6,10,0,0.6
di'vmyjaickavquu,0,16,6,10,1,0.6
fleapit,1,7,3,4,0,0.75
autoharps,1,9,4,5,0,0.8
pactolian,1,9,4,5,0,0.8
inkness,0,7,2,5,0,0.4
philomelian,1,11,5,6,0,0.833333333333333
sensitor,0,8,3,5,0,0.6
beiges,1,6,3,3,0,1
together,0,8,3,5,0,0.6
metallists,1,10,3,7,0,0.428571428571429
centonikuctozetrbar,0,19,7,12,0,0.583333333333333
nonluster,1,9,3,6,0,0.5
etymonic,1,8,3,5,0,0.6
tomines,1,7,3,4,0,0.75
disbosoms,1,9,3,6,0,0.5
hjniuflwsoae'uibywuovcv,0,23,9,14,1,0.642857142857143
rotovates,1,9,4,5,0,0.8
vatmen,1,6,2,4,0,0.5
plantad,1,7,2,5,0,0.4
unebekaa,0,8,5,3,0,1.66666666666667
antarateshudialiplacoulupunege,0,30,15,15,0,1
reuptakes,1,9,4,5,0,0.8
weatin,0,6,3,3,0,1
xbaeuaqockblktjnctdvk,0,21,5,16,0,0.3125
traceries,1,9,4,5,0,0.8
nonescram,0,9,3,6,0,0.5
alerdlowle,0,10,4,6,0,0.666666666666667
ajax,1,4,2,2,0,1
mr''qhgyxeizevmdcdcb,0,20,3,17,2,0.176470588235294
synapshood,0,10,3,7,0,0.428571428571429
incog,1,5,2,3,0,0.666666666666667
scal,0,4,1,3,0,0.333333333333333
illiveratropyrient,0,18,7,11,0,0.636363636363636
pungencies,1,10,4,6,0,0.666666666666667
regmallit,0,9,3,6,0,0.5
choreally,0,9,3,6,0,0.5
cocrustat,0,9,3,6,0,0.5
wadis,1,5,2,3,0,0.666666666666667
xtbiijlhcudexulinzbuczocqpnm,0,28,8,20,0,0.4
wendal,0,6,2,4,0,0.5
cumberment,1,10,3,7,0,0.428571428571429
overplots,1,9,3,6,0,0.5
halting,1,7,2,5,0,0.4
qulingnntonbuernkims,0,20,6,14,0,0.428571428571429
bluebuck,1,8,3,5,0,0.6
tailorbird,1,10,4,6,0,0.666666666666667
fwomqknpwc,0,10,1,9,0,0.111111111111111
cariyo,1,6,3,3,0,1
cglcqmfxyrbsm,0,13,0,13,0,0
rammerman,0,9,3,6,0,0.5
polyspermy,1,10,2,8,0,0.25
iyownve'l,0,9,3,6,1,0.5
qunetesonabah,0,13,6,7,0,0.857142857142857
deusdediting,0,12,5,7,0,0.714285714285714
nonbibliographic,1,16,6,10,0,0.6
oncopo,0,6,3,3,0,1
sawfaavvnnnnsswzlnuvw,0,21,4,17,0,0.235294117647059
otfkpavsnll,0,11,2,9,0,0.222222222222222
lamar,1,5,2,3,0,0.666666666666667
preade,0,6,3,3,0,1
zoopartition,0,12,6,6,0,1
eluted,1,6,3,3,0,1
culverkey,1,9,3,6,0,0.5
cauking,1,7,3,4,0,0.75
prudgemas,0,9,3,6,0,0.5
raymento,0,8,3,5,0,0.6
vasodilation,1,12,6,6,0,1
orphanise,1,9,4,5,0,0.8
nuttery,1,7,2,5,0,0.4
semicommunists,0,14,5,9,0,0.555555555555556
clouters,1,8,3,5,0,0.6
pyrolysate,1,10,3,7,0,0.428571428571429
hadvitavicoconcepothrillic,0,26,10,16,0,0.625
lyginvetus,0,10,3,7,0,0.428571428571429
dollingers,0,10,3,7,0,0.428571428571429
fsh,1,3,0,3,0,0
ozaznjmlocgkki'npn,0,18,4,14,1,0.285714285714286
unsaurus,0,8,4,4,0,1
brazzaville,1,11,4,7,0,0.571428571428571
eaceworm,1,8,4,4,0,1
eg'ilrqxpabwvgk,0,15,3,12,1,0.25
heriobubllun,0,12,5,7,0,0.714285714285714
wlfrlfxz,0,8,0,8,0,0
skol,1,4,1,3,0,0.333333333333333
pappea,1,6,3,3,0,1
connusable,1,10,4,6,0,0.666666666666667
nondistributional,1,17,7,10,0,0.7
vqsnzn'dty,0,10,0,10,1,0
ungrownup,0,9,3,6,0,0.5
penecontemporariness,0,20,8,12,0,0.666666666666667
lathea,0,6,3,3,0,1
faithful,1,8,3,5,0,0.6
plebianism,1,10,4,6,0,0.666666666666667
apodal,1,6,3,3,0,1
psilotic,1,8,3,5,0,0.6
unashamedness,1,13,5,8,0,0.625
holacputbrococ,0,14,5,9,0,0.555555555555556
reproduction,1,12,5,7,0,0.714285714285714
glooscap,1,8,3,5,0,0.6
right,1,5,1,4,0,0.25
senecaville,1,11,5,6,0,0.833333333333333
blephilia,1,9,4,5,0,0.8
chargentamehet,0,14,5,9,0,0.555555555555556
hiplingeses,0,11,4,7,0,0.571428571428571
enlaceous,0,9,5,4,0,1.25
rehearing,1,9,4,5,0,0.8
bashlessly,0,10,2,8,0,0.25
repunisotheteronetraodontoid,0,28,13,15,0,0.866666666666667
schoolless,1,10,3,7,0,0.428571428571429
amphibattersionarcolpigombergemishly,0,36,13,23,0,0.565217391304348
jjjiv,0,5,1,4,0,0.25
foregleams,1,10,4,6,0,0.666666666666667
huzhsbppbjpjor,0,14,2,12,0,0.166666666666667
palotty,0,7,2,5,0,0.4
carnacles,0,9,3,6,0,0.5
lighthouses,1,11,4,7,0,0.571428571428571
catogen,0,7,3,4,0,0.75
trinest,0,7,2,5,0,0.4
basisolute,1,10,5,5,0,1
perissodactylous,1,16,6,10,0,0.6
punji,1,5,2,3,0,0.666666666666667
ascc,1,4,1,3,0,0.333333333333333
wanthill,1,8,2,6,0,0.333333333333333
cotto,0,5,2,3,0,0.666666666666667
antiperidromy,0,13,5,8,0,0.625
diathermometer,1,14,6,8,0,0.75
nynor,0,5,1,4,0,0.25
protestantines,0,14,5,9,0,0.555555555555556
disclost,1,8,2,6,0,0.333333333333333
anthropus,0,9,3,6,0,0.5
end,1,3,1,2,0,0.5
planny,0,6,1,5,0,0.2
marcation,0,9,4,5,0,0.8
jaoxrnepeao,0,11,6,5,0,1.2
nonvibranchia,0,13,5,8,0,0.625
pawnbrokery,0,11,3,8,0,0.375
blebrunequaciatinke,0,19,9,10,0,0.9
precept,1,7,2,5,0,0.4
meatering,0,9,4,5,0,0.8
seekoa,0,6,4,2,0,2
berkhamsted,1,11,3,8,0,0.375
mudwrestlessness,0,16,4,12,0,0.333333333333333
subgenera,1,9,4,5,0,0.8
benzopyrazolone,1,15,6,9,0,0.666666666666667
verthip,0,7,2,5,0,0.4
recyclist,1,9,2,7,0,0.285714285714286
semi,1,4,2,2,0,1
memorisations,1,13,6,7,0,0.857142857142857
endocrinologism,0,15,6,9,0,0.666666666666667
disenchantress,1,14,4,10,0,0.4
incoherentific,1,14,6,8,0,0.75
lovirus,0,7,3,4,0,0.75
latif,1,5,2,3,0,0.666666666666667
thermometrographs,1,17,5,12,0,0.416666666666667
eletica,0,7,4,3,0,1.33333333333333
costativeness,0,13,5,8,0,0.625
matteufr,0,8,3,5,0,0.6
vepfhffjcjup,0,12,2,10,0,0.2
idahoans,1,8,4,4,0,1
ulmint,0,6,2,4,0,0.5
pericardian,1,11,5,6,0,0.833333333333333
sacchariferous,1,14,6,8,0,0.75
tiorokufowstun,0,14,6,8,0,0.75
larvacea,1,8,4,4,0,1
endmatcher,1,10,3,7,0,0.428571428571429
saccadically,1,12,4,8,0,0.5
discerpibleness,1,15,5,10,0,0.5
gneticism,0,9,3,6,0,0.5
twalterous,0,10,4,6,0,0.666666666666667
forisfamiliated,1,15,7,8,0,0.875
entomopause,0,11,6,5,0,1.2
spirochaetales,1,14,6,8,0,0.75
emmenagogue,1,11,6,5,0,1.2
sketcher,1,8,2,6,0,0.333333333333333
amicizarentripuls,0,17,7,10,0,0.7
coralligerous,1,13,6,7,0,0.857142857142857
stringhalt,1,10,2,8,0,0.25
uqorqcfyvnsrxic,0,15,3,12,0,0.25
monsibeia,0,9,5,4,0,1.25
bruang,1,6,2,4,0,0.5
oldsquawberrying,0,16,5,11,0,0.454545454545455
misconductor,0,12,4,8,0,0.5
siverise,0,8,4,4,0,1
prously,0,7,2,5,0,0.4
yirds,1,5,1,4,0,0.25
frivolling,1,10,3,7,0,0.428571428571429
ennoic,1,6,3,3,0,1
ostracoideas,0,12,6,6,0,1
barbwire,1,8,3,5,0,0.6
dismantlers,1,11,3,8,0,0.375
hdowzzoulick,0,12,4,8,0,0.5
sabble,0,6,2,4,0,0.5
ipod,1,4,2,2,0,1
subadanthrompostrical,0,21,7,14,0,0.5
ultrafidianism,1,14,6,8,0,0.75
elephanticide,0,13,6,7,0,0.857142857142857
yahganan,1,8,3,5,0,0.6
pelton,1,6,2,4,0,0.5
tortileness,0,11,4,7,0,0.571428571428571
oenophily,1,9,4,5,0,0.8
lateens,1,7,3,4,0,0.75
backslidden,1,11,3,8,0,0.375
lacoiffliend,0,12,5,7,0,0.714285714285714
unprofessionalness,1,18,7,11,0,0.636363636363636
cribla,1,6,2,4,0,0.5
arctiidae,1,9,5,4,0,1.25
ydbxukxrqfph,0,12,1,11,0,0.0909090909090909
staree,1,6,3,3,0,1
nonhereditably,1,14,5,9,0,0.555555555555556
baldacchino,0,11,4,7,0,0.571428571428571
uthitriniounzelia,0,17,9,8,0,1.125
pisidium,1,8,4,4,0,1
basicranial,1,11,5,6,0,0.833333333333333
flunders,0,8,2,6,0,0.333333333333333
tritchrytimemaniairks,0,21,7,14,0,0.5
hydromorphism,0,13,3,10,0,0.3
aletau,0,6,4,2,0,2
chondrichthys,0,13,2,11,0,0.181818181818182
yuf,0,3,1,2,0,0.5
bantry,1,6,1,5,0,0.2
nocki,0,5,2,3,0,0.666666666666667
vulpicides,1,10,4,6,0,0.666666666666667
misappreciates,1,14,6,8,0,0.75
fetichlike,1,10,4,6,0,0.666666666666667
buted,0,5,2,3,0,0.666666666666667
phecticios,0,10,4,6,0,0.666666666666667
carbaration,0,11,5,6,0,0.833333333333333
subtorrid,1,9,3,6,0,0.5
meatintinomoods,0,15,7,8,0,0.875
balaton,1,7,3,4,0,0.75
cnidos,0,6,2,4,0,0.5
tholader,0,8,3,5,0,0.6
accine,0,6,3,3,0,1
thirteenfold,1,12,4,8,0,0.5
neurohypophysicobiologies,0,25,11,14,0,0.785714285714286
qgumtjzkvlui,0,12,3,9,0,0.333333333333333
owatonna,1,8,4,4,0,1
hermy,1,5,1,4,0,0.25
uzbek,1,5,2,3,0,0.666666666666667
lication,0,8,4,4,0,1
jaeg,0,4,2,2,0,1
springtail,1,10,3,7,0,0.428571428571429
semiosis,1,8,4,4,0,1
volunteerism,1,12,5,7,0,0.714285714285714
generatively,1,12,5,7,0,0.714285714285714
ampullariidae,1,13,7,6,0,1.16666666666667
hudson,1,6,2,4,0,0.5
thrower,1,7,2,5,0,0.4
cactus,1,6,2,4,0,0.5
thondemnism,0,11,3,8,0,0.375
podispativerway,0,15,6,9,0,0.666666666666667
flacoldboacepyliracefuctivele,0,29,12,17,0,0.705882352941177
fundamentalisms,1,15,5,10,0,0.5
inatteneral,0,11,5,6,0,0.833333333333333
fillian,1,7,3,4,0,0.75
pezant,1,6,2,4,0,0.5
slcxrkvkfafpajow,0,16,3,13,0,0.230769230769231
beresthyrgrotrerield,0,20,6,14,0,0.428571428571429
clactone,0,8,3,5,0,0.6
preinducean,0,11,5,6,0,0.833333333333333
grapilforaceae,0,14,7,7,0,1
teadish,1,7,3,4,0,0.75
editorialisation,1,16,9,7,0,1.28571428571429
outthink,1,8,3,5,0,0.6
peregrine,1,9,4,5,0,0.8
ratyes,0,6,2,4,0,0.5
bjornson,1,8,2,6,0,0.333333333333333
realos,1,6,3,3,0,1
interlarger,0,11,4,7,0,0.571428571428571
fishable,1,8,3,5,0,0.6
judenberg,1,9,3,6,0,0.5
promite,0,7,3,4,0,0.75
freechurchism,1,13,4,9,0,0.444444444444444
nonconsolable,1,13,5,8,0,0.625
squintersaw,0,11,4,7,0,0.571428571428571
endotheriidae,0,13,7,6,0,1.16666666666667
asperging,1,9,3,6,0,0.5
denigrated,1,10,4,6,0,0.666666666666667
queenlier,1,9,5,4,0,1.25
overexcepties,0,13,6,7,0,0.857142857142857
intergallergic,0,14,5,9,0,0.555555555555556
queechin,0,8,4,4,0,1
larimer,1,7,3,4,0,0.75
cnidophobia,1,11,5,6,0,0.833333333333333
nonpending,1,10,3,7,0,0.428571428571429
misfying,0,8,2,6,0,0.333333333333333
gonite,0,6,3,3,0,1
temptation,1,10,4,6,0,0.666666666666667
ahishar,1,7,3,4,0,0.75
locality,1,8,3,5,0,0.6
photoplaywright,1,15,4,11,0,0.363636363636364
tagilite,1,8,4,4,0,1
vidames,1,7,3,4,0,0.75
swatchbook,1,10,3,7,0,0.428571428571429
bhnx,0,4,0,4,0,0
rescindeers,0,11,4,7,0,0.571428571428571
gastrular,1,9,3,6,0,0.5
applaudians,0,11,5,6,0,0.833333333333333
triamid,1,7,3,4,0,0.75
accaradood,0,10,5,5,0,1
procons,0,7,2,5,0,0.4
bespreads,1,9,3,6,0,0.5
pheneandreameritrinier,0,22,10,12,0,0.833333333333333
demographist,1,12,4,8,0,0.5
coxitti,0,7,3,4,0,0.75
brucellosis,1,11,4,7,0,0.571428571428571
oudnticfvjurlso,0,15,5,10,0,0.5
reascertainable,0,15,7,8,0,0.875
bywood,0,6,2,4,0,0.5
fengtien,1,8,3,5,0,0.6
densntnces,0,10,2,8,0,0.25
hypernatural,1,12,4,8,0,0.5
faletusky,0,9,3,6,0,0.5
hialeah,1,7,4,3,0,1.33333333333333
ptynderbird,0,11,2,9,0,0.222222222222222
villote,1,7,3,4,0,0.75
necturidae,1,10,5,5,0,1
nonlethargy,0,11,3,8,0,0.375
stripe,1,6,2,4,0,0.5
columnutation,0,13,6,7,0,0.857142857142857
inequipolitis,0,13,7,6,0,1.16666666666667
accessoriness,1,13,5,8,0,0.625
channovocabemonkin,0,18,7,11,0,0.636363636363636
charkhas,1,8,2,6,0,0.333333333333333
kover,0,5,2,3,0,0.666666666666667
nonsubtlety,1,11,3,8,0,0.375
coachdog,1,8,3,5,0,0.6
parsings,1,8,2,6,0,0.333333333333333
anvet'iowxugmu,0,14,6,8,1,0.75
mulcher,1,7,2,5,0,0.4
emnobbark,0,9,3,6,0,0.5
prenenorocod,0,12,5,7,0,0.714285714285714
semiglaze,1,9,4,5,0,0.8
conce,0,5,2,3,0,0.666666666666667
bonny,1,5,1,4,0,0.25
gratrnem,0,8,2,6,0,0.333333333333333
cloacanonimpetitiest,0,20,9,11,0,0.818181818181818
hurrygraph,1,10,2,8,0,0.25
quayage,1,7,4,3,0,1.33333333333333
scruncherseeds,0,14,4,10,0,0.4
ebughuglycea,0,12,5,7,0,0.714285714285714
derencephala,0,12,5,7,0,0.714285714285714
perilously,1,10,4,6,0,0.666666666666667
precommandoman,0,14,5,9,0,0.555555555555556
aevvthfuqldduzxea'jrxnwev,0,25,7,18,1,0.388888888888889
bestuds,1,7,2,5,0,0.4
spus,0,4,1,3,0,0.333333333333333
ayvntd,0,6,1,5,0,0.2
flaggers,1,8,2,6,0,0.333333333333333
donkey,1,6,2,4,0,0.5
hyolarerelia,0,12,6,6,0,1
captivate,1,9,4,5,0,0.8
bombilating,1,11,4,7,0,0.571428571428571
cardons,1,7,2,5,0,0.4
nonneedled,0,10,4,6,0,0.666666666666667
fatiguedom,0,10,5,5,0,1
toiletted,1,9,4,5,0,0.8
schmalzy,1,8,1,7,0,0.142857142857143
salamarines,0,11,5,6,0,0.833333333333333
dinitrobacteriacids,0,19,8,11,0,0.727272727272727
apneusis,1,8,4,4,0,1
smocks,1,6,1,5,0,0.2
encased,1,7,3,4,0,0.75
hypertext,1,9,2,7,0,0.285714285714286
horbrasparn,0,11,3,8,0,0.375
tang,1,4,1,3,0,0.333333333333333
gorillians,1,10,4,6,0,0.666666666666667
willet,1,6,2,4,0,0.5
euphausids,1,10,5,5,0,1
microinches,1,11,4,7,0,0.571428571428571
mesentery,1,9,3,6,0,0.5
koko,1,4,2,2,0,1
merin,0,5,2,3,0,0.666666666666667
rhamnaceae,1,10,5,5,0,1
bellmanship,1,11,3,8,0,0.375
koussevitzky,1,12,4,8,0,0.5
saggides,0,8,3,5,0,0.6
prefiedly,0,9,3,6,0,0.5
champa,1,6,2,4,0,0.5
rhidet,0,6,2,4,0,0.5
nonauthoritative,1,16,8,8,0,1
seely,1,5,2,3,0,0.666666666666667
pranginesses,0,12,4,8,0,0.5
katawa,0,6,3,3,0,1
ghouls,1,6,2,4,0,0.5
hoodgradii,0,10,5,5,0,1
beslobbered,1,11,4,7,0,0.571428571428571
spriggers,1,9,2,7,0,0.285714285714286
boothmaker,0,10,4,6,0,0.666666666666667
chrositchemoch,0,14,4,10,0,0.4
punosp,0,6,2,4,0,0.5
carrew,1,6,2,4,0,0.5
geubzesr,0,8,3,5,0,0.6
dishabilitating,1,15,6,9,0,0.666666666666667
cancel,1,6,2,4,0,0.5
parnas,1,6,2,4,0,0.5
panon,0,5,2,3,0,0.666666666666667
metpprppfy'vvxxiy'lwussjc,0,25,3,22,2,0.136363636363636
enguarded,1,9,4,5,0,0.8
hypermarkets,1,12,3,9,0,0.333333333333333
saucobs,0,7,3,4,0,0.75
chemoratymimere,0,15,6,9,0,0.666666666666667
frangonal,0,9,3,6,0,0.5
reformingly,1,11,3,8,0,0.375
bobkerry,0,8,2,6,0,0.333333333333333
bothe,1,5,2,3,0,0.666666666666667
reounot,0,7,4,3,0,1.33333333333333
etymologists,1,12,4,8,0,0.5
clubbinesses,1,12,4,8,0,0.5
unlaundered,1,11,5,6,0,0.833333333333333
uugshgi,0,7,3,4,0,0.75
quenchings,1,10,3,7,0,0.428571428571429
cantoro,0,7,3,4,0,0.75
fogramities,1,11,5,6,0,0.833333333333333
gabrielrache,1,12,5,7,0,0.714285714285714
equilibrationist,0,16,8,8,0,1
quesited,1,8,4,4,0,1
gljxwnldnmcmq',0,14,0,14,1,0
conservatrixes,1,14,5,9,0,0.555555555555556
pread,0,5,2,3,0,0.666666666666667
scaffle,1,7,2,5,0,0.4
amigenesses,0,11,5,6,0,0.833333333333333
saddredilly,0,11,3,8,0,0.375
toadrushes,1,10,4,6,0,0.666666666666667
jyrt'bgyro,0,10,1,9,1,0.111111111111111
nidor,1,5,2,3,0,0.666666666666667
difisshotranoty,0,15,5,10,0,0.5
nichus,0,6,2,4,0,0.5
pseudopregnancies,1,17,7,10,0,0.7
blqkvbcnblpinbyz,0,16,1,15,0,0.0666666666666667
baalp,0,5,2,3,0,0.666666666666667
triching,0,8,2,6,0,0.333333333333333
nonintellectual,1,15,6,9,0,0.666666666666667
hallmouth,0,9,3,6,0,0.5
padma,1,5,2,3,0,0.666666666666667
beent,1,5,2,3,0,0.666666666666667
vaselines,1,9,4,5,0,0.8
nocorimbrumilitertinable,0,24,10,14,0,0.714285714285714
whirlbone,1,9,3,6,0,0.5
moretalictoongipesisten,0,23,10,13,0,0.769230769230769
average,1,7,4,3,0,1.33333333333333
tennessean,1,10,4,6,0,0.666666666666667
horper,0,6,2,4,0,0.5
feviog,0,6,3,3,0,1
disoperation,1,12,6,6,0,1
unpropateness,0,13,5,8,0,0.625
futural,1,7,3,4,0,0.75
waterid,0,7,3,4,0,0.75
swardaic,0,8,3,5,0,0.6
excremes,0,8,3,5,0,0.6
unweinematology,0,15,7,8,0,0.875
harmsworth,1,10,2,8,0,0.25
rahed,1,5,2,3,0,0.666666666666667
unswine,0,7,3,4,0,0.75
calinog,1,7,3,4,0,0.75
clavicornia,1,11,5,6,0,0.833333333333333
togg,0,4,1,3,0,0.333333333333333
moriche,1,7,3,4,0,0.75
retically,0,9,3,6,0,0.5
dinghies,1,8,3,5,0,0.6
stin,0,4,1,3,0,0.333333333333333
maliks,1,6,2,4,0,0.5
blanca,1,6,2,4,0,0.5
exculpations,1,12,5,7,0,0.714285714285714
vflpnbdulozprjbeuhinzyg'd,0,25,5,20,1,0.25
pentachords,1,11,3,8,0,0.375
tipster,1,7,2,5,0,0.4
bewaitered,1,10,5,5,0,1
moum,0,4,2,2,0,1
amazonia,1,8,5,3,0,1.66666666666667
acanthodes,1,10,4,6,0,0.666666666666667
reactionisms,0,12,5,7,0,0.714285714285714
renhionise,0,10,5,5,0,1
hamartiologist,0,14,6,8,0,0.75
snbopogiledngegeres,0,19,7,12,0,0.583333333333333
huffings,0,8,2,6,0,0.333333333333333
onuptxr'uyupukttq,0,17,5,12,1,0.416666666666667
synecticity,1,11,3,8,0,0.375
supravaginal,1,12,5,7,0,0.714285714285714
unquailingly,1,12,5,7,0,0.714285714285714
rikisha,1,7,3,4,0,0.75
terlist,0,7,2,5,0,0.4
trochleariform,1,14,5,9,0,0.555555555555556
macing,1,6,2,4,0,0.5
n'pdqvwhwppd'cfja,0,17,1,16,2,0.0625
sphyxia,0,7,2,5,0,0.4
vq,0,2,0,2,0,0
feter,0,5,2,3,0,0.666666666666667
zkmy,0,4,0,4,0,0
carlots,1,7,2,5,0,0.4
auripunctuates,0,14,7,7,0,1
filber,0,6,2,4,0,0.5
codeclination,1,13,6,7,0,0.857142857142857
skolly,1,6,1,5,0,0.2
rountes,0,7,3,4,0,0.75
rfswifflr,0,9,1,8,0,0.125
subschp,0,7,1,6,0,0.166666666666667
kayakers,1,8,3,5,0,0.6
prefixtures,1,11,4,7,0,0.571428571428571
bajardo,1,7,3,4,0,0.75
thesium,1,7,3,4,0,0.75
somlo,1,5,2,3,0,0.666666666666667
vapourishness,1,13,5,8,0,0.625
unwieceriety,0,12,6,6,0,1
dolde,0,5,2,3,0,0.666666666666667
columinancelluretishness,0,24,9,15,0,0.6
cristry,0,7,1,6,0,0.166666666666667
crossfishes,1,11,3,8,0,0.375
lobulifeguards,0,14,6,8,0,0.75
starboard,1,9,3,6,0,0.5
suidine,0,7,4,3,0,1.33333333333333
chaptreck,0,9,2,7,0,0.285714285714286
quadrienniumutile,1,17,9,8,0,1.125
sggz,0,4,0,4,0,0
whitneyite,1,10,4,6,0,0.666666666666667
nematelmia,1,10,5,5,0,1
coypou,1,6,3,3,0,1
tankbusters,1,11,3,8,0,0.375
cubencies,0,9,4,5,0,0.8
fartled,0,7,2,5,0,0.4
eurasianism,1,11,6,5,0,1.2
praesphenoidal,0,14,6,8,0,0.75
rosations,0,9,4,5,0,0.8
cenobies,1,8,4,4,0,1
unmolten,1,8,3,5,0,0.6
noibwornness,0,12,4,8,0,0.5
amabel,1,6,3,3,0,1
pluggerrenal,0,12,4,8,0,0.5
terrough,0,8,3,5,0,0.6
subprecoalfishhoods,0,19,7,12,0,0.583333333333333
nomand,0,6,2,4,0,0.5
luxury,1,6,2,4,0,0.5
whipstaff,1,9,2,7,0,0.285714285714286
blackhearted,1,12,4,8,0,0.5
astrophysicist,1,14,4,10,0,0.4
sporophyte,1,10,3,7,0,0.428571428571429
pendulation,1,11,5,6,0,0.833333333333333
superdecorated,1,14,6,8,0,0.75
coenthrones,0,11,4,7,0,0.571428571428571
uztdkqmvconptu'x,0,16,3,13,1,0.230769230769231
gni,0,3,1,2,0,0.5
mplatypicuieorgimapalecoucca,0,28,13,15,0,0.866666666666667
eugeosynclines,1,14,6,8,0,0.75
ineber,0,6,3,3,0,1
mptid,0,5,1,4,0,0.25
pilows,1,6,2,4,0,0.5
semiclose,1,9,4,5,0,0.8
faminstranger,0,13,4,9,0,0.444444444444444
lentner,1,7,2,5,0,0.4
permalloys,1,10,3,7,0,0.428571428571429
foreroyal,1,9,4,5,0,0.8
jag,1,3,1,2,0,0.5
aquifoux,0,8,5,3,0,1.66666666666667
telnet,1,6,2,4,0,0.5
spheriest,1,9,3,6,0,0.5
interlaboratory,1,15,6,9,0,0.666666666666667
astulidae,0,9,5,4,0,1.25
prestreptive,0,12,4,8,0,0.5
igniting,1,8,3,5,0,0.6
abusee,1,6,4,2,0,2
omb,1,3,1,2,0,0.5
screenman,1,9,3,6,0,0.5
militaryment,1,12,4,8,0,0.5
innumerablenesses,1,17,7,10,0,0.7
conepate,1,8,4,4,0,1
antimeter,1,9,4,5,0,0.8
despiritualizing,1,16,7,9,0,0.777777777777778
weipping,0,8,3,5,0,0.6
cuirassier,1,10,5,5,0,1
ewbqmyvxjxicxzeovegwdmlw,0,24,5,19,0,0.263157894736842
rothe,0,5,2,3,0,0.666666666666667
surebutted,1,10,4,6,0,0.666666666666667
drosera,1,7,3,4,0,0.75
altify,1,6,2,4,0,0.5
worman,0,6,2,4,0,0.5
rycararbe,0,9,3,6,0,0.5
finlander,1,9,3,6,0,0.5
coud,0,4,2,2,0,1
bonum,1,5,2,3,0,0.666666666666667
lychnomancy,1,11,2,9,0,0.222222222222222
nfrtayisoq,0,10,3,7,0,0.428571428571429
gaper,1,5,2,3,0,0.666666666666667
kebed,0,5,2,3,0,0.666666666666667
overgrossness,1,13,4,9,0,0.444444444444444
thwartness,1,10,2,8,0,0.25
hoaxer,1,6,3,3,0,1
enamellers,1,10,4,6,0,0.666666666666667
sibucao,1,7,4,3,0,1.33333333333333
basanita,0,8,4,4,0,1
hyperostosis,1,12,4,8,0,0.5
ssuede,0,6,3,3,0,1
bleshiness,0,10,3,7,0,0.428571428571429
qytxviunldnap,0,13,3,10,0,0.3
nwobeotinerbwetaytt,0,19,7,12,0,0.583333333333333
txkjfedetprjzpcbrzqnobib'uz,0,27,5,22,1,0.227272727272727
intemporalise,0,13,6,7,0,0.857142857142857
naquin,1,6,3,3,0,1
biophotor,0,9,4,5,0,0.8
mva,1,3,1,2,0,0.5
equibblive,0,10,5,5,0,1
pygostyle,1,9,2,7,0,0.285714285714286
disputacity,1,11,4,7,0,0.571428571428571
meretrices,1,10,4,6,0,0.666666666666667
hapology,0,8,3,5,0,0.6
hiphymus,0,8,2,6,0,0.333333333333333
triethylamine,1,13,5,8,0,0.625
massinissa,1,10,4,6,0,0.666666666666667
doyst,1,5,1,4,0,0.25
vetkoeksotenontotorism,0,22,9,13,0,0.692307692307692
gluthenist,0,10,3,7,0,0.428571428571429
xmztgijnfcs,0,11,1,10,0,0.1
subnatural,1,10,4,6,0,0.666666666666667
outreach,1,8,4,4,0,1
ensign,1,6,2,4,0,0.5
solitaires,1,10,5,5,0,1
willyt,1,6,1,5,0,0.2
quixotry,1,8,3,5,0,0.6
asiatized,0,9,5,4,0,1.25
codeia,1,6,4,2,0,2
'aioobrlgvg'wvok,0,16,5,11,2,0.454545454545455
phytochemicals,1,14,4,10,0,0.4
o'ndfmfoooqp'ebxpldavckinoc,0,27,8,19,2,0.421052631578947
dkoxavsbcrut,0,12,3,9,0,0.333333333333333
nlrvnafgkoghzsswbmlvpfxg,0,24,2,22,0,0.0909090909090909
bocynthromy,0,11,2,9,0,0.222222222222222
steganopodes,1,12,5,7,0,0.714285714285714
nana,1,4,2,2,0,1
piezoelectrically,1,17,7,10,0,0.7
xeroprivataranch,0,16,6,10,0,0.6
dmodgxjkgals,0,12,2,10,0,0.2
ttinzeivaurtsbabrerchavabris,0,28,10,18,0,0.555555555555556
mahiranits,0,10,4,6,0,0.666666666666667
postgame,1,8,3,5,0,0.6
cumuli,1,6,3,3,0,1
gastrous,0,8,3,5,0,0.6
millionist,0,10,4,6,0,0.666666666666667
seropositivity,1,14,6,8,0,0.75
solokwic,0,8,3,5,0,0.6
hunkey,1,6,2,4,0,0.5
superocubicund,0,14,6,8,0,0.75
surrogateship,1,13,5,8,0,0.625
unwist,1,6,2,4,0,0.5
enculturated,1,12,5,7,0,0.714285714285714
passmenting,1,11,3,8,0,0.375
copolary,0,8,3,5,0,0.6
furnishinomiya,0,14,6,8,0,0.75
arthrotomy,1,10,3,7,0,0.428571428571429
skutterudite,1,12,5,7,0,0.714285714285714
phaenogenetic,1,13,6,7,0,0.857142857142857
fosterosities,0,13,6,7,0,0.857142857142857
libnah,1,6,2,4,0,0.5
arachnid,1,8,3,5,0,0.6
duncaton,0,8,3,5,0,0.6
aatech,1,6,3,3,0,1
reistier,1,8,4,4,0,1
demia,0,5,3,2,0,1.5
splash,1,6,1,5,0,0.2
jorvavoces,0,10,4,6,0,0.666666666666667
demiwivern,1,10,4,6,0,0.666666666666667
okx'cvwslbvsplm,0,15,1,14,1,0.0714285714285714
poplilia,1,8,4,4,0,1
exsert,1,6,2,4,0,0.5
dendrolongmires,0,15,5,10,0,0.5
ancyrean,1,8,3,5,0,0.6
kkyra,1,5,1,4,0,0.25
ctenostomata,1,12,5,7,0,0.714285714285714
officiously,1,11,5,6,0,0.833333333333333
linyu,1,5,2,3,0,0.666666666666667
salian,1,6,3,3,0,1
dometricities,0,13,6,7,0,0.857142857142857
aculat,0,6,3,3,0,1
telesmanesthesia,0,16,7,9,0,0.777777777777778
uninus,0,6,3,3,0,1
bsheredukeliseaguisinaticate,0,28,14,14,0,1
promonarchicalness,1,18,6,12,0,0.5
deorientalize,1,13,7,6,0,1.16666666666667
monicidi,0,8,4,4,0,1
nonisise,0,8,4,4,0,1
nonprescriber,1,13,4,9,0,0.444444444444444
convulgarring,0,13,4,9,0,0.444444444444444
gration,0,7,3,4,0,0.75
illucidated,0,11,5,6,0,0.833333333333333
guilefulness,1,12,5,7,0,0.714285714285714
colugos,1,7,3,4,0,0.75
yplmdjcsfo,0,10,1,9,0,0.111111111111111
hewes,1,5,2,3,0,0.666666666666667
helluo,0,6,3,3,0,1
speaking,1,8,3,5,0,0.6
bhre,0,4,1,3,0,0.333333333333333
sonorific,1,9,4,5,0,0.8
rachelor,0,8,3,5,0,0.6
profarchieldom,0,14,5,9,0,0.555555555555556
curiositions,0,12,6,6,0,1
jeroma,1,6,3,3,0,1
permissibility,1,14,5,9,0,0.555555555555556
colluvium,1,9,4,5,0,0.8
smenzanammurna,0,14,5,9,0,0.555555555555556
chutmensemathilphae,0,19,7,12,0,0.583333333333333
bvoerxxl'cdqjszwt,0,17,2,15,1,0.133333333333333
venedotian,1,10,5,5,0,1
grangeability,0,13,5,8,0,0.625
a'dbilunt'''vzp,0,15,3,12,4,0.25
atmometer,1,9,4,5,0,0.8
tralira,1,7,3,4,0,0.75
traditionings,0,13,5,8,0,0.625
retriser,0,8,3,5,0,0.6
pseudoarchaecrania,0,18,9,9,0,1
wirelike,1,8,4,4,0,1
ampinct,0,7,2,5,0,0.4
mansioneer,1,10,5,5,0,1
stylohyoidean,1,13,5,8,0,0.625
sxzsybp',0,8,0,8,1,0
doggrel,1,7,2,5,0,0.4
tfyuoluuonwbfgktvqpgh,0,21,5,16,0,0.3125
rwslmxhwi,0,9,1,8,0,0.125
homerology,1,10,4,6,0,0.666666666666667
blindfolded,1,11,3,8,0,0.375
abiogeogram,0,11,6,5,0,1.2
guese,0,5,3,2,0,1.5
cragsmen,1,8,2,6,0,0.333333333333333
unfish,0,6,2,4,0,0.5
louverte,0,8,4,4,0,1
derib,1,5,2,3,0,0.666666666666667
myfh'c'g'zlizkcfvfwvpflrgh'o,0,28,2,26,4,0.0769230769230769
puf,0,3,1,2,0,0.5
canadianism,1,11,5,6,0,0.833333333333333
mudpuppylike,0,12,4,8,0,0.5
naas,1,4,2,2,0,1
infed,0,5,2,3,0,0.666666666666667
unzip,1,5,2,3,0,0.666666666666667
tlkgfliulstederearmapocatoneconane,0,34,14,20,0,0.7
orthoepy,1,8,3,5,0,0.6
xfcmtb'h'nyjk,0,13,0,13,2,0
ciout,0,5,3,2,0,1.5
feldt,1,5,1,4,0,0.25
sperischele,0,11,4,7,0,0.571428571428571
reapprehension,1,14,6,8,0,0.75
hophorn,0,7,2,5,0,0.4
unseminared,1,11,5,6,0,0.833333333333333
schnabelkanne,1,13,4,9,0,0.444444444444444
outflash,1,8,3,5,0,0.6
sprunny,1,7,1,6,0,0.166666666666667
rqp'vohqfkpdljbyvgewlkcfq,0,25,2,23,1,0.0869565217391304
incivilization,1,14,7,7,0,1
mats,1,4,1,3,0,0.333333333333333
nkhmor,0,6,1,5,0,0.2
miabr,0,5,2,3,0,0.666666666666667
vlwpts'gzpkwot,0,14,1,13,1,0.0769230769230769
lerons,0,6,2,4,0,0.5
ginhouses,1,9,4,5,0,0.8
tasselled,1,9,3,6,0,0.5
mairily,0,7,3,4,0,0.75
tunel,0,5,2,3,0,0.666666666666667
coloureds,1,9,4,5,0,0.8
cavorter,1,8,3,5,0,0.6
sictpeveitallexpenchianotriam,0,29,12,17,0,0.705882352941177
vistrypron,0,10,2,8,0,0.25
syzxdijegxqdifqcpf,0,18,3,15,0,0.2
jmldxuefzyckkdesegzhzgdtilne,0,28,6,22,0,0.272727272727273
periscopise,0,11,5,6,0,0.833333333333333
upbraided,1,9,4,5,0,0.8
underfarmer,1,11,4,7,0,0.571428571428571
villsama,0,8,3,5,0,0.6
preadmirer,1,10,4,6,0,0.666666666666667
astrophysical,1,13,4,9,0,0.444444444444444
oline,0,5,3,2,0,1.5
cpilhamo'w,0,10,3,7,1,0.428571428571429
luanne,1,6,3,3,0,1
smitarerrieawheuribencomatushyseronlamiqungasi,0,46,20,26,0,0.769230769230769
retarsuses,0,10,4,6,0,0.666666666666667
faccybal,0,8,2,6,0,0.333333333333333
borofluoromethane,0,17,8,9,0,0.888888888888889
dury,0,4,1,3,0,0.333333333333333
biotome,1,7,4,3,0,1.33333333333333
rousant,1,7,3,4,0,0.75
hemfologitionflic,0,17,7,10,0,0.7
stier,1,5,2,3,0,0.666666666666667
unpriestherium,0,14,6,8,0,0.75
nursable,1,8,3,5,0,0.6
biddies,1,7,3,4,0,0.75
parochites,0,10,4,6,0,0.666666666666667
codesigning,1,11,4,7,0,0.571428571428571
kolkhozniks,1,11,3,8,0,0.375
subfreshen,0,10,3,7,0,0.428571428571429
rbczlaxwqjvfypmhu''p,0,20,2,18,2,0.111111111111111
phziixxyomvekeshkhgidunut,0,25,8,17,0,0.470588235294118
cordierstuben,0,13,5,8,0,0.625
overdrainability,0,16,7,9,0,0.777777777777778
playedlesses,0,12,4,8,0,0.5
laud,1,4,2,2,0,1
edictum,1,7,3,4,0,0.75
overbrushlessness,0,17,5,12,0,0.416666666666667
angeromyck,0,10,3,7,0,0.428571428571429
goosegobs,1,9,4,5,0,0.8
coiffeurs,1,9,4,5,0,0.8
conourisher,0,11,5,6,0,0.833333333333333
presxzjftdo,0,11,2,9,0,0.222222222222222
maeterlinck,1,11,4,7,0,0.571428571428571
esere,1,5,3,2,0,1.5
apas,0,4,2,2,0,1
tampion,1,7,3,4,0,0.75
unoblockishly,0,13,4,9,0,0.444444444444444
hallegomuti,0,11,5,6,0,0.833333333333333
dospalos,1,8,3,5,0,0.6
unthronic,0,9,3,6,0,0.5
unclouds,1,8,3,5,0,0.6
alphabet,1,8,3,5,0,0.6
theobromatites,0,14,6,8,0,0.75
unputridness,1,12,4,8,0,0.5
fantastrychnisms,0,16,3,13,0,0.230769230769231
workstation,1,11,4,7,0,0.571428571428571
synclinically,0,13,3,10,0,0.3
waukesha,1,8,4,4,0,1
lynchromer,0,10,2,8,0,0.25
tdgbtezedxjx'g'gadxtql,0,22,3,19,2,0.157894736842105
icamananiplile,0,14,7,7,0,1
unconcernino,0,12,5,7,0,0.714285714285714
thereaway,1,9,4,5,0,0.8
eticied,0,7,4,3,0,1.33333333333333
blise,0,5,2,3,0,0.666666666666667
ultrationalia,0,13,7,6,0,1.16666666666667
ktkjckhj'',0,10,0,10,2,0
vaws,1,4,1,3,0,0.333333333333333
ankeyiedenes,0,12,6,6,0,1
matricarinate,0,13,6,7,0,0.857142857142857
treponemata,1,11,5,6,0,0.833333333333333
normentiner,0,11,4,7,0,0.571428571428571
q'tcqlhxai'cjpwgpg,0,18,2,16,2,0.125
unautomated,1,11,6,5,0,1.2
misadvise,1,9,4,5,0,0.8
unforgeability,1,14,6,8,0,0.75
zapupe,1,6,3,3,0,1
utci'qborqyhm'burmabviuf,0,24,7,17,2,0.411764705882353
hystionselldene,0,15,5,10,0,0.5
lauretan,0,8,4,4,0,1
hemotherapeutics,1,16,7,9,0,0.777777777777778
counterefficiency,1,17,7,10,0,0.7
krwsupaguzej,0,12,4,8,0,0.5
irchismatipo,0,12,5,7,0,0.714285714285714
polyonymal,1,10,3,7,0,0.428571428571429
homoeomerae,1,11,7,4,0,1.75
conclusive,1,10,4,6,0,0.666666666666667
monoglycaemia,0,13,6,7,0,0.857142857142857
kbonctes,0,8,2,6,0,0.333333333333333
skeweepetskysanaconed,0,21,8,13,0,0.615384615384615
gualty,0,6,2,4,0,0.5
jjgqdhutlugyqqeymqn,0,19,3,16,0,0.1875
miswording,1,10,3,7,0,0.428571428571429
laydown,1,7,2,5,0,0.4
peterisk,0,8,3,5,0,0.6
andkeel,0,7,3,4,0,0.75
crawahamler,0,11,4,7,0,0.571428571428571
fbiynhtmiqbifqkjprtxelo,0,23,5,18,0,0.277777777777778
parostotis,1,10,4,6,0,0.666666666666667
cozad,1,5,2,3,0,0.666666666666667
obile,0,5,3,2,0,1.5
motozintlec,1,11,4,7,0,0.571428571428571
reapportions,1,12,5,7,0,0.714285714285714
tether,1,6,2,4,0,0.5
enteroischiocele,1,16,8,8,0,1
dss,0,3,0,3,0,0
nonequivocally,1,14,6,8,0,0.75
bittner,1,7,2,5,0,0.4
occipitoscapular,1,16,7,9,0,0.777777777777778
krinthos,1,8,2,6,0,0.333333333333333
negrophobia,1,11,5,6,0,0.833333333333333
swedeborg,1,9,3,6,0,0.5
azotic,1,6,3,3,0,1
chargement,0,10,3,7,0,0.428571428571429
uzwwlcfivd,0,10,2,8,0,0.25
unpainful,1,9,4,5,0,0.8
nimbed,1,6,2,4,0,0.5
preshower,0,9,3,6,0,0.5
uybpddtzrhnopqfrn,0,17,2,15,0,0.133333333333333
deinotheres,1,11,5,6,0,0.833333333333333
kurtistown,1,10,3,7,0,0.428571428571429
chupeeronsichomolarbed,0,22,9,13,0,0.692307692307692
noncuriously,1,12,5,7,0,0.714285714285714
har,0,3,1,2,0,0.5
linse,0,5,2,3,0,0.666666666666667
pisopabirranulatre,0,18,8,10,0,0.8
mis,1,3,1,2,0,0.5
pierpont,1,8,3,5,0,0.6
wyandottes,1,10,3,7,0,0.428571428571429
strawn,1,6,1,5,0,0.2
cocote,0,6,3,3,0,1
sneakishnesses,1,14,5,9,0,0.555555555555556
dedvaracarntienolessomar,0,24,10,14,0,0.714285714285714
restorer,1,8,3,5,0,0.6
dsss,0,4,0,4,0,0
jilomine,0,8,4,4,0,1
predraectincensurpitines,0,24,9,15,0,0.6
sermonised,1,10,4,6,0,0.666666666666667
uleipronnticoiph,0,16,7,9,0,0.777777777777778
spinefinned,1,11,4,7,0,0.571428571428571
arbitron,1,8,3,5,0,0.6
superabundant,1,13,5,8,0,0.625
bipronger,0,9,3,6,0,0.5
lubroous,0,8,4,4,0,1
trestling,1,9,2,7,0,0.285714285714286
polytrichum,1,11,3,8,0,0.375
leurheadlan,0,11,5,6,0,0.833333333333333
vachel,1,6,2,4,0,0.5
eva,1,3,2,1,0,2
irdes,0,5,2,3,0,0.666666666666667
identia,0,7,4,3,0,1.33333333333333
oversalneols,0,12,5,7,0,0.714285714285714
gyrostatics,1,11,3,8,0,0.375
hexadactylous,1,13,5,8,0,0.625
pienaar,1,7,4,3,0,1.33333333333333
lunchpails,1,10,3,7,0,0.428571428571429
delopingraphagua,0,16,7,9,0,0.777777777777778
phrygianism,0,11,3,8,0,0.375
suberiform,1,10,4,6,0,0.666666666666667
nonpermitudings,0,15,5,10,0,0.5
polysulfides,1,12,4,8,0,0.5
adaptate,0,8,4,4,0,1
huntedly,1,8,2,6,0,0.333333333333333
l'e,0,3,1,2,1,0.5
aulerizy,0,8,4,4,0,1
sweeds,0,6,2,4,0,0.5
denote,1,6,3,3,0,1
nsvrstfuknxarwdeqtpcjdsstb,0,26,3,23,0,0.130434782608696
tantrisms,1,9,2,7,0,0.285714285714286
scrouns,0,7,2,5,0,0.4
charmeuse,1,9,4,5,0,0.8
hypocrater,1,10,3,7,0,0.428571428571429
douar,1,5,3,2,0,1.5
'vhhsizf,0,8,1,7,1,0.142857142857143
lindly,1,6,1,5,0,0.2
unfarmed,1,8,3,5,0,0.6
fianchetti,1,10,4,6,0,0.666666666666667
meningococcocci,1,15,6,9,0,0.666666666666667
electrothermic,1,14,5,9,0,0.555555555555556
uhrpafwmw,0,9,2,7,0,0.285714285714286
brachillaboric,0,14,5,9,0,0.555555555555556
postado,0,7,3,4,0,0.75
bradycrotic,0,11,3,8,0,0.375
thromata,0,8,3,5,0,0.6
begored,1,7,3,4,0,0.75
drephyroinstrarere,0,18,6,12,0,0.5
genetika,1,8,4,4,0,1
uf,0,2,1,1,0,1
glim,1,4,1,3,0,0.333333333333333
mbwjudxtlatiwgrg,0,16,3,13,0,0.230769230769231
lfiny,0,5,1,4,0,0.25
undercurrents,1,13,4,9,0,0.444444444444444
timbuktu,1,8,3,5,0,0.6
allees,1,6,3,3,0,1
annarbor,1,8,3,5,0,0.6
procalcarrations,0,16,6,10,0,0.6
adventuring,1,11,4,7,0,0.571428571428571
euder,0,5,3,2,0,1.5
eyeholes,1,8,4,4,0,1
scyllidae,1,9,3,6,0,0.5
morristels,0,10,3,7,0,0.428571428571429
enterobacterium,1,15,7,8,0,0.875
declassification,1,16,7,9,0,0.777777777777778
deerflies,1,9,4,5,0,0.8
cherynchrocrorhot,0,17,4,13,0,0.307692307692308
prohydrotechnofear,0,18,6,12,0,0.5
murmuremediencydloperaxa,0,24,10,14,0,0.714285714285714
venderface,0,10,4,6,0,0.666666666666667
bepastured,1,10,4,6,0,0.666666666666667
basilian,1,8,4,4,0,1
acmontrephallidae,0,17,7,10,0,0.7
virement,1,8,3,5,0,0.6
gloversville,1,12,4,8,0,0.5
limingler,0,9,3,6,0,0.5
fanaticising,1,12,5,7,0,0.714285714285714
clewgarnet,1,10,3,7,0,0.428571428571429
rayleness,0,9,3,6,0,0.5
iur,0,3,2,1,0,2
egocerus,1,8,4,4,0,1
channate,0,8,3,5,0,0.6
ucrgrtierochoncull,0,18,6,12,0,0.5
efatese,1,7,4,3,0,1.33333333333333
endocrinous,1,11,5,6,0,0.833333333333333
rhynes,1,6,1,5,0,0.2
acontium,1,8,4,4,0,1
dazhppfgeoltlion,0,16,5,11,0,0.454545454545455
reinterparts,0,12,4,8,0,0.5
grodiest,1,8,3,5,0,0.6
vedism,1,6,2,4,0,0.5
cratokenchee,0,12,5,7,0,0.714285714285714
plthuvcpzlyafxplwodsejai,0,24,6,18,0,0.333333333333333
arustle,1,7,3,4,0,0.75
galla,1,5,2,3,0,0.666666666666667
chefounhamopeckstatistro,0,24,9,15,0,0.6
councillors,1,11,4,7,0,0.571428571428571
saks,1,4,1,3,0,0.333333333333333
bamicorshan,0,11,4,7,0,0.571428571428571
pheazars,1,8,3,5,0,0.6
riettest,0,8,3,5,0,0.6
nazificatorisms,0,15,6,9,0,0.666666666666667
coryl,1,5,1,4,0,0.25
leckrone,1,8,3,5,0,0.6
brassageway,0,11,4,7,0,0.571428571428571
terelic,0,7,3,4,0,0.75
coprojector,1,11,4,7,0,0.571428571428571
dwalkalist,0,10,3,7,0,0.428571428571429
valence,1,7,3,4,0,0.75
mqwyrrisgbrgscht,0,16,1,15,0,0.0666666666666667
anrvingitsudmyla,0,16,5,11,0,0.454545454545455
patwari,1,7,3,4,0,0.75
pupmalcwrpbw'mm,0,15,2,13,1,0.153846153846154
colli,0,5,2,3,0,0.666666666666667
erythrophilous,1,14,5,9,0,0.555555555555556
reagingalisations,0,17,8,9,0,0.888888888888889
donchat,0,7,2,5,0,0.4
unluckier,1,9,4,5,0,0.8
hyperodontogeny,1,15,5,10,0,0.5
stitrigynkesinneschirstopstegrorulmoo,0,37,12,25,0,0.48
cill,1,4,1,3,0,0.333333333333333
eeninepatis,0,11,6,5,0,1.2
protelytron,0,11,3,8,0,0.375
perukier,1,8,4,4,0,1
pigswill,1,8,2,6,0,0.333333333333333
wilone,1,6,3,3,0,1
kjs,0,3,0,3,0,0
exofeieniang,0,12,7,5,0,1.4
xipharmonsburg,0,14,4,10,0,0.4
carryon,1,7,2,5,0,0.4
profiteering,1,12,5,7,0,0.714285714285714
docuddermatospective,0,20,8,12,0,0.666666666666667
luxembourgeoisie,0,16,9,7,0,1.28571428571429
gautaoicwqdwsujmsfbs,0,20,6,14,0,0.428571428571429
avekfquus,0,9,4,5,0,0.8
jyorqlecyc'wmztgbxud,0,20,3,17,1,0.176470588235294
gol,1,3,1,2,0,0.5
chuvash,1,7,2,5,0,0.4
admeasured,1,10,5,5,0,1
trif,0,4,1,3,0,0.333333333333333
btyyp,0,5,0,5,0,0
plasexuarbutchoy,0,16,6,10,0,0.6
phaemiak,0,8,4,4,0,1
ladroitures,0,11,5,6,0,0.833333333333333
warly,1,5,1,4,0,0.25
prers,0,5,1,4,0,0.25
hydrocyanogenetic,0,17,6,11,0,0.545454545454545
nodon,0,5,2,3,0,0.666666666666667
mielnau'iyugljtsbc,0,18,6,12,1,0.5
harvel,1,6,2,4,0,0.5
preseafcakick,0,13,5,8,0,0.625
superjumbo,1,10,4,6,0,0.666666666666667
masutralism,0,11,4,7,0,0.571428571428571
toggizzlenure,0,13,5,8,0,0.625
californio,1,10,5,5,0,1
parvati,1,7,3,4,0,0.75
threshing,1,9,2,7,0,0.285714285714286
dendrium,1,8,3,5,0,0.6
vxrpcothfrgw',0,13,1,12,1,0.0833333333333333
sectorshing,0,11,3,8,0,0.375
girondelicitly,0,14,5,9,0,0.555555555555556
braisintegyptogamic,0,19,7,12,0,0.583333333333333
wrain,0,5,2,3,0,0.666666666666667
gurgical,0,8,3,5,0,0.6
scaberulous,1,11,5,6,0,0.833333333333333
hicasslosed,0,11,4,7,0,0.571428571428571
asixafas,0,8,4,4,0,1
onixagydwovr,0,12,4,8,0,0.5
datos,1,5,2,3,0,0.666666666666667
euglenophyta,1,12,5,7,0,0.714285714285714
proscamaianchaloinceasigarconiagizes,0,36,17,19,0,0.894736842105263
mischaracterises,1,16,6,10,0,0.6
subtrend,1,8,2,6,0,0.333333333333333
hiroko,1,6,3,3,0,1
misima,1,6,3,3,0,1
ustiand,0,7,3,4,0,0.75
butteviounopalafesamognoneytialoxiokinaiatinedanus,0,50,26,24,0,1.08333333333333
moderniece,0,10,5,5,0,1
sakaise,0,7,4,3,0,1.33333333333333
hidomenidnean,0,13,6,7,0,0.857142857142857
entangledly,1,11,3,8,0,0.375
fanciers,1,8,3,5,0,0.6
unstewardlike,1,13,5,8,0,0.625
reticness,0,9,3,6,0,0.5
amoralisms,1,10,4,6,0,0.666666666666667
nonfederatae,0,12,6,6,0,1
policellersysgranist,0,20,6,14,0,0.428571428571429
hitobesa,0,8,4,4,0,1
kgswjkbxmn,0,10,0,10,0,0
overtopper,0,10,4,6,0,0.666666666666667
woopie,1,6,4,2,0,2
disarme,0,7,3,4,0,0.75
aloggodinasisses,0,16,7,9,0,0.777777777777778
tarkiesque,0,10,5,5,0,1
nabalisation,0,12,6,6,0,1
peskier,1,7,3,4,0,0.75
groundcloth,1,11,3,8,0,0.375
yqtblyacv,0,9,1,8,0,0.125
boris,1,5,2,3,0,0.666666666666667
reciprocatio,0,12,6,6,0,1
sirrah,1,6,2,4,0,0.5
blownds,0,7,1,6,0,0.166666666666667
bistipulate,1,11,5,6,0,0.833333333333333
zoopaschistonia,0,15,7,8,0,0.875
shonistomanians,0,15,6,9,0,0.666666666666667
halous,0,6,3,3,0,1
pleurotus,1,9,4,5,0,0.8
semirefined,1,11,5,6,0,0.833333333333333
organogenesis,1,13,6,7,0,0.857142857142857
tzg,0,3,0,3,0,0
ticapialurgeska,0,15,7,8,0,0.875
sanguineovascular,1,17,8,9,0,0.888888888888889
unr,0,3,1,2,0,0.5
paddymelon,1,10,3,7,0,0.428571428571429
boverrilla,0,10,4,6,0,0.666666666666667
podiceps,1,8,3,5,0,0.6
talon,1,5,2,3,0,0.666666666666667
mirabilis,1,9,4,5,0,0.8
dodontusia,0,10,5,5,0,1
estanciero,1,10,5,5,0,1
nonsubcompositiously,0,20,8,12,0,0.666666666666667
assoriums,0,9,4,5,0,0.8
devonport,1,9,3,6,0,0.5
dollaeuomutecsson,0,17,8,9,0,0.888888888888889
unembezzled,1,11,4,7,0,0.571428571428571
strepitantly,1,12,3,9,0,0.333333333333333
mitrogotranoteritrravohedenacomume,0,34,15,19,0,0.789473684210526
austenoscope,0,12,6,6,0,1
loudishness,0,11,4,7,0,0.571428571428571
ribbah,0,6,2,4,0,0.5
hexade,1,6,3,3,0,1
mardizertilembbinetennmipisidrcgirs,0,35,12,23,0,0.521739130434783
medflies,1,8,3,5,0,0.6
cardiospermum,1,13,5,8,0,0.625
usolosluarcutrmanedeer,0,22,10,12,0,0.833333333333333
incred,0,6,2,4,0,0.5
misderivating,0,13,5,8,0,0.625
coscloolus,0,10,4,6,0,0.666666666666667
tongueflower,1,12,5,7,0,0.714285714285714
martaker,0,8,3,5,0,0.6
chuckholts,0,10,2,8,0,0.25
eqqmysdqnvcrmgioifmnxevwte,0,26,6,20,0,0.3
catagmatic,1,10,4,6,0,0.666666666666667
prockin,0,7,2,5,0,0.4
dinglernamegars,0,15,5,10,0,0.5
lepte,0,5,2,3,0,0.666666666666667
ataghans,1,8,3,5,0,0.6
pipylepear,0,10,4,6,0,0.666666666666667
fastinkleform,0,13,4,9,0,0.444444444444444
urer,0,4,2,2,0,1
demandativeness,0,15,6,9,0,0.666666666666667
tailifical,0,10,5,5,0,1
winkier,0,7,3,4,0,0.75
gwenni,1,6,2,4,0,0.5
coastwaiter,1,11,5,6,0,0.833333333333333
schisms,1,7,1,6,0,0.166666666666667
leuconosed,0,10,5,5,0,1
aghlabite,1,9,4,5,0,0.8
adroituricchio,0,14,7,7,0,1
rshyozxmxxnlsrllkagdpzphxzbqn,0,29,2,27,0,0.0740740740740741
footpostsis,0,11,4,7,0,0.571428571428571
sylvabishead,0,12,4,8,0,0.5
ditzier,1,7,3,4,0,0.75
swarthoughts,0,12,3,9,0,0.333333333333333
ellicottville,1,13,5,8,0,0.625
dqkobzxjjuqppxnpgucxuhsm,0,24,4,20,0,0.2
pterylae,1,8,3,5,0,0.6
overconquerspreattribunitiate,0,29,13,16,0,0.8125
dedy,0,4,1,3,0,0.333333333333333
psyle,0,5,1,4,0,0.25
syngman,1,7,1,6,0,0.166666666666667
tl,1,2,0,2,0,0
jiffs,1,5,1,4,0,0.25
irogerre,0,8,4,4,0,1
ftuiegaduwiyawkepwwlc,0,21,8,13,0,0.615384615384615
hyperacidity,1,12,4,8,0,0.5
lupe,1,4,2,2,0,1
pownding,1,8,2,6,0,0.333333333333333
poninc,0,6,2,4,0,0.5
pseudocumyl,1,11,4,7,0,0.571428571428571
protopteris,0,11,4,7,0,0.571428571428571
ochorabstin,0,11,4,7,0,0.571428571428571
oilla,1,5,3,2,0,1.5
maragy,0,6,2,4,0,0.5
oncolporteni,0,12,5,7,0,0.714285714285714
commensal,1,9,3,6,0,0.5
vertibility,1,11,4,7,0,0.571428571428571
trustlessness,1,13,3,10,0,0.3
lorrayne,1,8,3,5,0,0.6
vocabularia,0,11,6,5,0,1.2
mation,0,6,3,3,0,1
unilamellar,1,11,5,6,0,0.833333333333333
amalia,1,6,4,2,0,2
argumentalise,0,13,6,7,0,0.857142857142857
criophore,1,9,4,5,0,0.8
debeaker,1,8,4,4,0,1
tsam,0,4,1,3,0,0.333333333333333
cremos,0,6,2,4,0,0.5
jstyfvksfpbj,0,12,0,12,0,0
evectedness,0,11,4,7,0,0.571428571428571
mhhqhwsaqduodkbqwbi,0,19,4,15,0,0.266666666666667
heptangular,1,11,4,7,0,0.571428571428571
phrygian,1,8,2,6,0,0.333333333333333
presumers,1,9,3,6,0,0.5
dreadlocks,1,10,3,7,0,0.428571428571429
uninucleated,1,12,6,6,0,1
lakhs,1,5,1,4,0,0.25
davidinetopmen,0,14,6,8,0,0.75
sosabilarentrant,0,16,6,10,0,0.6
chancinees,0,10,4,6,0,0.666666666666667
importunates,1,12,5,7,0,0.714285714285714
maigre,1,6,3,3,0,1
vailefying,0,10,4,6,0,0.666666666666667
flabilities,0,11,5,6,0,0.833333333333333
mamery,0,6,2,4,0,0.5
acalnes,0,7,3,4,0,0.75
itolas,0,6,3,3,0,1
compreemighterpiologitutanadvers,0,32,13,19,0,0.684210526315789
kraurauiaceae,0,13,9,4,0,2.25
danelage,1,8,4,4,0,1
unlesoman,0,9,4,5,0,0.8
swakara,1,7,3,4,0,0.75
baidar,1,6,3,3,0,1
occasionate,1,11,6,5,0,1.2
particina,0,9,4,5,0,0.8
retreatant,1,10,4,6,0,0.666666666666667
prographicago,0,13,5,8,0,0.625
refully,0,7,2,5,0,0.4
catholiatical,0,13,6,7,0,0.857142857142857
onug,0,4,2,2,0,1
bicameralist,1,12,5,7,0,0.714285714285714
dedness,0,7,2,5,0,0.4
monsignori,1,10,4,6,0,0.666666666666667
squirrelsstagnate,1,17,6,11,0,0.545454545454545
neidhardt,1,9,3,6,0,0.5
potherbs,1,8,2,6,0,0.333333333333333
oscillar,0,8,3,5,0,0.6
obstructionary,0,14,5,9,0,0.555555555555556
spectroheliogram,1,16,6,10,0,0.6
protext,1,7,2,5,0,0.4
isolvolete,0,10,5,5,0,1
unstridulating,1,14,5,9,0,0.555555555555556
beasess,0,7,3,4,0,0.75
creoles,1,7,3,4,0,0.75
ficus,1,5,2,3,0,0.666666666666667
virginville,1,11,4,7,0,0.571428571428571
megropondroverin,0,16,6,10,0,0.6
mieiterycankieootumimeermesuciomiteiomiraeferat,0,47,26,21,0,1.23809523809524
lienopancreatic,1,15,7,8,0,0.875
discommunity,1,12,4,8,0,0.5
relets,1,6,2,4,0,0.5
naemorhedinae,1,13,7,6,0,1.16666666666667
isativelyragran,0,15,6,9,0,0.666666666666667
hazeless,1,8,3,5,0,0.6
eilat,1,5,3,2,0,1.5
nostalgia,1,9,4,5,0,0.8
sludginess,1,10,3,7,0,0.428571428571429
chew,1,4,1,3,0,0.333333333333333
readestainomochoclate,0,21,10,11,0,0.909090909090909
croctsoredi,0,11,4,7,0,0.571428571428571
sarine,1,6,3,3,0,1
recurvature,1,11,5,6,0,0.833333333333333
qsbxmgfvwvbhoj,0,14,1,13,0,0.0769230769230769
kethidisensities,0,16,7,9,0,0.777777777777778
sweetner,0,8,3,5,0,0.6
tiresomeness,1,12,5,7,0,0.714285714285714
unfined,1,7,3,4,0,0.75
uigurian,1,8,5,3,0,1.66666666666667
sayoner,0,7,3,4,0,0.75
bimmeler,1,8,3,5,0,0.6
ed'zmj,0,6,1,5,1,0.2
upcounty,0,8,3,5,0,0.6
ricardiac,0,9,4,5,0,0.8
ridiory,0,7,3,4,0,0.75
unamusement,1,11,5,6,0,0.833333333333333
hyperconcentrations,1,19,6,13,0,0.461538461538462
isabellas,1,9,4,5,0,0.8
uge,0,3,2,1,0,2
logocracies,0,11,5,6,0,0.833333333333333
strick,1,6,1,5,0,0.2
stenandioturabliephtily,0,23,9,14,0,0.642857142857143
noncompetences,0,14,5,9,0,0.555555555555556
exposurfboardee,0,15,7,8,0,0.875
debt,1,4,1,3,0,0.333333333333333
regumechent,0,11,4,7,0,0.571428571428571
nanhai,1,6,3,3,0,1
chiko,0,5,2,3,0,0.666666666666667
heteronical,0,11,5,6,0,0.833333333333333
virologist,1,10,4,6,0,0.666666666666667
fineer,0,6,3,3,0,1
fiddliest,1,9,3,6,0,0.5
proggies,0,8,3,5,0,0.6
piuuq'kazzhvhuja,0,16,6,10,1,0.6
echal,0,5,2,3,0,0.666666666666667
yznvzdhp'dies,0,13,2,11,1,0.181818181818182
tacsonia,1,8,4,4,0,1
thatch,1,6,1,5,0,0.2
phycoerythrin,1,13,3,10,0,0.3
submittable,1,11,4,7,0,0.571428571428571
fragmentative,0,13,5,8,0,0.625
submortgagee,0,12,5,7,0,0.714285714285714
pharmacopolist,1,14,5,9,0,0.555555555555556
colascioni,1,10,5,5,0,1
enewetak,1,8,4,4,0,1
klastiongtomicathyllastatanistalipplettarcotte,0,46,16,30,0,0.533333333333333
complacentesis,0,14,5,9,0,0.555555555555556
carcane,0,7,3,4,0,0.75
taea,0,4,3,1,0,3
misrecite,1,9,4,5,0,0.8
fascists,1,8,2,6,0,0.333333333333333
dindon,1,6,2,4,0,0.5
whosociophophenope,0,18,8,10,0,0.8
pisemiternour,0,13,6,7,0,0.857142857142857
upejyehuklb,0,11,4,7,0,0.571428571428571
yamalka,1,7,3,4,0,0.75
nenonrapocchoponetatorontafly,0,29,11,18,0,0.611111111111111
alternateness,1,13,5,8,0,0.625
adisebrope,0,10,5,5,0,1
crewcuts,1,8,2,6,0,0.333333333333333
tsaritsa,1,8,3,5,0,0.6
hackberry,1,9,2,7,0,0.285714285714286
vasoreflex,1,10,4,6,0,0.666666666666667
oiwqkcgkqgtyrqfftfefebxpwwwxj,0,29,4,25,0,0.16
canln,0,5,1,4,0,0.25
methylene,1,9,3,6,0,0.5
saprocercoolhalia,0,17,8,9,0,0.888888888888889
cophetencrourebosms,0,19,7,12,0,0.583333333333333
preemlapirthinicidadjurg,0,24,9,15,0,0.6
pinetums,0,8,3,5,0,0.6
forsakes,1,8,3,5,0,0.6
giaourt,0,7,4,3,0,1.33333333333333
parvirostrate,1,13,5,8,0,0.625
biracialist,0,11,5,6,0,0.833333333333333
phillosalpart,0,13,4,9,0,0.444444444444444
unsalutz,0,8,3,5,0,0.6
overconstructed,1,15,5,10,0,0.5
pedicled,1,8,3,5,0,0.6
susy,1,4,1,3,0,0.333333333333333
frand,0,5,1,4,0,0.25
expuggedani,0,11,5,6,0,0.833333333333333
murled,1,6,2,4,0,0.5
unsuppression,1,13,5,8,0,0.625
coaxiderthonitis,0,16,7,9,0,0.777777777777778
ombkiadolsrreijduvdio,0,21,9,12,0,0.75
kusha,1,5,2,3,0,0.666666666666667
mestizos,1,8,3,5,0,0.6
wjms,0,4,0,4,0,0
cholecystectasia,1,16,6,10,0,0.6
anderdrailloch,0,14,5,9,0,0.555555555555556
hedonianism,0,11,5,6,0,0.833333333333333
atacoscopeptibleness,0,20,8,12,0,0.666666666666667
resive,0,6,3,3,0,1
ukrainian,1,9,5,4,0,1.25
aldolatry,0,9,3,6,0,0.5
gpinguwncid,0,11,3,8,0,0.375
stancracarm,0,11,3,8,0,0.375
perognathus,1,11,4,7,0,0.571428571428571
reflecasurvinivelchora,0,22,9,13,0,0.692307692307692
speelings,0,9,3,6,0,0.5
gojbfpth,0,8,1,7,0,0.142857142857143
bjxarf'rfkinu,0,13,3,10,1,0.3
millerstown,1,11,3,8,0,0.375
emilie,1,6,4,2,0,2
gentler,1,7,2,5,0,0.4
haudoovarretimersation,0,22,11,11,0,1
macromidiculting,0,16,6,10,0,0.6
demonstrately,0,13,4,9,0,0.444444444444444
nonexcitative,1,13,6,7,0,0.857142857142857
ctlsheaiphiloubacsphacoblliveress,0,33,12,21,0,0.571428571428571
rhavenia,0,8,4,4,0,1
uribi,0,5,3,2,0,1.5
caromel,1,7,3,4,0,0.75
beaux,1,5,3,2,0,1.5
escrol,1,6,2,4,0,0.5
cochinae,0,8,4,4,0,1
chalkstone,1,10,3,7,0,0.428571428571429
culgee,1,6,3,3,0,1
gi'p,0,4,1,3,1,0.333333333333333
bundistulative,0,14,6,8,0,0.75
unclassify,1,10,3,7,0,0.428571428571429
dissonance,1,10,4,6,0,0.666666666666667
beduckings,0,10,3,7,0,0.428571428571429
estren,1,6,2,4,0,0.5
euthrasene,0,10,5,5,0,1
rugger,1,6,2,4,0,0.5
awabakal,1,8,4,4,0,1
dzb'jrdnunrd,0,12,1,11,1,0.0909090909090909
ideoglyph,1,9,3,6,0,0.5
conflagrates,1,12,4,8,0,0.5
tommie,1,6,3,3,0,1
physalian,1,9,3,6,0,0.5
blouboks,1,8,3,5,0,0.6
turkeys,1,7,2,5,0,0.4
colorimetry,1,11,4,7,0,0.571428571428571
lqbybdmvrru'crdobwnbkhzq,0,24,2,22,1,0.0909090909090909
'ukhpgxdvz,0,10,1,9,1,0.111111111111111
tassie,1,6,3,3,0,1
clausal,1,7,3,4,0,0.75
kqbniixrivzbcwtfvgt,0,19,3,16,0,0.1875
possible,1,8,3,5,0,0.6
aoln,0,4,2,2,0,1
bambino,1,7,3,4,0,0.75
agnexpine,0,9,4,5,0,0.8
angiohyalinosis,1,15,7,8,0,0.875
swink,1,5,1,4,0,0.25
snytllzhgivw'zgjhtn,0,19,1,18,1,0.0555555555555556
tadashi,1,7,3,4,0,0.75
mellaticata,0,11,5,6,0,0.833333333333333
astylosporous,0,13,5,8,0,0.625
hemoerythrin,1,12,4,8,0,0.5
unequivocalness,1,15,7,8,0,0.875
reindoctrinate,1,14,6,8,0,0.75
imus,1,4,2,2,0,1
overexpanded,1,12,5,7,0,0.714285714285714
efrsh'esprwa',0,13,3,10,2,0.3
pythilociployddamorpenton,0,25,8,17,0,0.470588235294118
dissector,1,9,3,6,0,0.5
coppelia,1,8,4,4,0,1
etomqxwguhylqe't,0,16,4,12,1,0.333333333333333
fuirena,1,7,4,3,0,1.33333333333333
fritfulness,0,11,3,8,0,0.375
bordylar,0,8,2,6,0,0.333333333333333
lenche,0,6,2,4,0,0.5
deliberative,1,12,6,6,0,1
sacchitah,0,9,3,6,0,0.5
d'hihinplfucuqprhnregrqtmkdg,0,28,5,23,1,0.217391304347826
omadhaun,1,8,4,4,0,1
slaticifiralatasempu,0,20,9,11,0,0.818181818181818
evenhanded,1,10,4,6,0,0.666666666666667
coreign,1,7,3,4,0,0.75
kellysville,1,11,3,8,0,0.375
overspeedy,1,10,4,6,0,0.666666666666667
intitussism,0,11,4,7,0,0.571428571428571
monophyllous,1,12,4,8,0,0.5
ychoriletrtoaoomimelcanamerolenenisocas,0,39,18,21,0,0.857142857142857
muz,0,3,1,2,0,0.5
clui,0,4,2,2,0,1
repadding,1,9,3,6,0,0.5
lotase,1,6,3,3,0,1
pavlovian,1,9,4,5,0,0.8
pkqcvhgyzbprhfkkftuzn,0,21,1,20,0,0.05
violinosing,0,11,5,6,0,0.833333333333333
turnpin,1,7,2,5,0,0.4
mucopolysaccum,0,14,5,9,0,0.555555555555556
cavaed,0,6,3,3,0,1
photogram,1,9,3,6,0,0.5
virt,0,4,1,3,0,0.333333333333333
governall,1,9,3,6,0,0.5
'uvsa'obidicgfzzwjofm,0,21,6,15,2,0.4
todends,0,7,2,5,0,0.4
hollister,1,9,3,6,0,0.5
undural,0,7,3,4,0,0.75
unperfumed,1,10,4,6,0,0.666666666666667
fluing,1,6,2,4,0,0.5
bgsnawk,0,7,1,6,0,0.166666666666667
tarlton,1,7,2,5,0,0.4
vicatingis,0,10,4,6,0,0.666666666666667
hecatonchires,1,13,5,8,0,0.625
arcantolerel,0,12,5,7,0,0.714285714285714
karolynne,0,9,3,6,0,0.5
mussinesses,1,11,4,7,0,0.571428571428571
kwnolmocafuismmangs,0,19,6,13,0,0.461538461538462
linkier,1,7,3,4,0,0.75
dragonroot,1,10,4,6,0,0.666666666666667
palindromes,1,11,4,7,0,0.571428571428571
slaglessness,1,12,3,9,0,0.333333333333333
clasp,1,5,1,4,0,0.25
gremial,1,7,3,4,0,0.75
ovangangela,1,11,5,6,0,0.833333333333333
superream,0,9,4,5,0,0.8
vghz,0,4,0,4,0,0
rebesiege,1,9,5,4,0,1.25
houghtlies,0,10,4,6,0,0.666666666666667
tripodic,1,8,3,5,0,0.6
corwin,1,6,2,4,0,0.5
attrits,1,7,2,5,0,0.4
prement,0,7,2,5,0,0.4
duped,1,5,2,3,0,0.666666666666667
ck,0,2,0,2,0,0
ycejkgwe'cy,0,11,2,9,1,0.222222222222222
trinette,1,8,3,5,0,0.6
triphammer,1,10,3,7,0,0.428571428571429
shited,1,6,2,4,0,0.5
polypomorpha,1,12,4,8,0,0.5
horyanus,0,8,3,5,0,0.6
compeers,1,8,3,5,0,0.6
groupies,1,8,4,4,0,1
seak,0,4,2,2,0,1
thoracotomy,1,11,4,7,0,0.571428571428571
reparations,1,11,5,6,0,0.833333333333333
cacafugo,1,8,4,4,0,1
psente,0,6,2,4,0,0.5
se,1,2,1,1,0,1
delible,1,7,3,4,0,0.75
wwf'rsnuvgoclcua,0,16,4,12,1,0.333333333333333
juns,0,4,1,3,0,0.333333333333333
cooccurs,1,8,3,5,0,0.6
kols,0,4,1,3,0,0.333333333333333
mf'baedfrzzlfaspxmdipovjmyz,0,27,5,22,1,0.227272727272727
incumbents,1,10,3,7,0,0.428571428571429
simiidae,1,8,5,3,0,1.66666666666667
unfold,1,6,2,4,0,0.5
sayeds,1,6,2,4,0,0.5
limusdjtb,0,9,2,7,0,0.285714285714286
anguinidae,1,10,6,4,0,1.5
multiciliate,1,12,6,6,0,1
olyzel,0,6,2,4,0,0.5
tovementablenesis,0,17,7,10,0,0.7
snailery,1,8,3,5,0,0.6
pachyderma,1,10,3,7,0,0.428571428571429
diffusioninesses,0,16,7,9,0,0.777777777777778
brunellia,1,9,4,5,0,0.8
qmlzbrlilnmi'eqcr,0,17,3,14,1,0.214285714285714
franza,1,6,2,4,0,0.5
tsarina,1,7,3,4,0,0.75
laconia,1,7,4,3,0,1.33333333333333
bobbish,1,7,2,5,0,0.4
souths,1,6,2,4,0,0.5
skups,0,5,1,4,0,0.25
waratess,0,8,3,5,0,0.6
prostacyclin,1,12,3,9,0,0.333333333333333
jovinianistic,1,13,6,7,0,0.857142857142857
pandating,0,9,3,6,0,0.5
flinty,1,6,1,5,0,0.2
uninferable,1,11,5,6,0,0.833333333333333
unmentampwormalay,0,17,6,11,0,0.545454545454545
bergamot,1,8,3,5,0,0.6
photochordateau,0,15,7,8,0,0.875
esbay,1,5,2,3,0,0.666666666666667
iodinium,1,8,5,3,0,1.66666666666667
farmelo,1,7,3,4,0,0.75
cerebralise,1,11,5,6,0,0.833333333333333
stoeber,1,7,3,4,0,0.75
nondiscriminates,0,16,6,10,0,0.6
oaf,1,3,2,1,0,2
ciliosciophite,0,14,7,7,0,1
hawkweed,1,8,3,5,0,0.6
amidoazobenzene,1,15,8,7,0,1.14285714285714
oxysulfide,1,10,4,6,0,0.666666666666667
plowfdeplk',0,11,2,9,1,0.222222222222222
anilopyrin,1,10,4,6,0,0.666666666666667
n',0,2,0,2,1,0
motyperinateremo,0,16,7,9,0,0.777777777777778
ablepharia,1,10,5,5,0,1
outstat,0,7,3,4,0,0.75
consolversion,0,13,5,8,0,0.625
liddiard,1,8,3,5,0,0.6
priced,1,6,2,4,0,0.5
fing,0,4,1,3,0,0.333333333333333
dialogised,1,10,5,5,0,1
tomeevilasclermatiptardrypenify,0,31,11,20,0,0.55
venenate,1,8,4,4,0,1
hyperpanegyric,1,14,4,10,0,0.4
coappearing,1,11,5,6,0,0.833333333333333
pakhtun,1,7,2,5,0,0.4
nonderite,0,9,4,5,0,0.8
embeaub,0,7,4,3,0,1.33333333333333
snibberyearly,0,13,4,9,0,0.444444444444444
lcobtenadhancobsachizzzebai,0,27,10,17,0,0.588235294117647
concernments,1,12,3,9,0,0.333333333333333
unbosoming,1,10,4,6,0,0.666666666666667
corrugatorily,0,13,5,8,0,0.625
amplitude,1,9,4,5,0,0.8
disnesting,1,10,3,7,0,0.428571428571429
unwarrantably,1,13,4,9,0,0.444444444444444
'zbqfuzlrnwe'wvvbydjjqa,0,23,3,20,2,0.15
excoryishwist,0,13,4,9,0,0.444444444444444
snuffboxes,1,10,3,7,0,0.428571428571429
dereliction,1,11,5,6,0,0.833333333333333
mckean,1,6,2,4,0,0.5
ttfqzh'zlzvp'vzmz'tibiw'hqoneg,0,30,4,26,4,0.153846153846154
charterist,1,10,3,7,0,0.428571428571429
seepansudanelopilines,0,21,10,11,0,0.909090909090909
chiser,0,6,2,4,0,0.5
devalorises,1,11,5,6,0,0.833333333333333
sortableness,0,12,4,8,0,0.5
otides,1,6,3,3,0,1
scrutineer,1,10,4,6,0,0.666666666666667
thevenot,1,8,3,5,0,0.6
codia,0,5,3,2,0,1.5
heterozeted,0,11,5,6,0,0.833333333333333
grjxnhgdfivui,0,13,3,10,0,0.3
stestic,0,7,2,5,0,0.4
isuridae,1,8,5,3,0,1.66666666666667
aphs,0,4,1,3,0,0.333333333333333
propic,0,6,2,4,0,0.5
spint,0,5,1,4,0,0.25
astop,0,5,2,3,0,0.666666666666667
janglings,1,9,2,7,0,0.285714285714286
fibs,1,4,1,3,0,0.333333333333333
kissogram,1,9,3,6,0,0.5
fieriness,1,9,4,5,0,0.8
cerogenae,0,9,5,4,0,1.25
spotling,0,8,2,6,0,0.333333333333333
sparring,1,8,2,6,0,0.333333333333333
hetictionemationspher,0,21,9,12,0,0.75
romantic,1,8,3,5,0,0.6
cassandra,1,9,3,6,0,0.5
xrf,0,3,0,3,0,0
schlumps,1,8,1,7,0,0.142857142857143
irefully,1,8,3,5,0,0.6
wimpikewskisits,0,15,5,10,0,0.5
outsatisfied,1,12,6,6,0,1
lappels,1,7,2,5,0,0.4
belsky,1,6,1,5,0,0.2
tarp,1,4,1,3,0,0.333333333333333
blatherskites,1,13,4,9,0,0.444444444444444
peeve,1,5,3,2,0,1.5
acetoucan,0,9,5,4,0,1.25
tanzine,1,7,3,4,0,0.75
oldstein,0,8,3,5,0,0.6
counderming,0,11,4,7,0,0.571428571428571
lability,1,8,3,5,0,0.6
altmanid,0,8,3,5,0,0.6
brufsky,1,7,1,6,0,0.166666666666667
costlew,1,7,2,5,0,0.4
depiedmontize,1,13,6,7,0,0.857142857142857
plautine,1,8,4,4,0,1
cn'vzpw'urvonaf,0,15,3,12,2,0.25
plenisher,0,9,3,6,0,0.5
nonsilicious,1,12,6,6,0,1
photoporotrichery,0,17,6,11,0,0.545454545454545
foreslows,1,9,3,6,0,0.5
strummers,1,9,2,7,0,0.285714285714286
imption,0,7,3,4,0,0.75
myosins,1,7,2,5,0,0.4
yqjiion,0,7,3,4,0,0.75
adiathetic,1,10,5,5,0,1
hume,1,4,2,2,0,1
jellos,1,6,2,4,0,0.5
cyclosis,1,8,2,6,0,0.333333333333333
lenchioncychillum,0,17,5,12,0,0.416666666666667
searlesperedeniames,0,19,9,10,0,0.9
linkwork,1,8,2,6,0,0.333333333333333
footeuvepemafumore,0,18,10,8,0,1.25
arsmea,0,6,3,3,0,1
phuly,0,5,1,4,0,0.25
hypnum,1,6,1,5,0,0.2
nouranodermaries,0,16,8,8,0,1
geanine,1,7,4,3,0,1.33333333333333
tilting,1,7,2,5,0,0.4
grutitzaly,0,10,3,7,0,0.428571428571429
stacisms,0,8,2,6,0,0.333333333333333
uanis,0,5,3,2,0,1.5
crumenian,0,9,4,5,0,0.8
cake,1,4,2,2,0,1
pinards,1,7,2,5,0,0.4
mlbbobfxbdqjdjoxnvmwrdja,0,24,3,21,0,0.142857142857143
preindisposition,1,16,7,9,0,0.777777777777778
liaison,1,7,4,3,0,1.33333333333333
unclimbablenesses,1,17,6,11,0,0.545454545454545
summonsing,1,10,3,7,0,0.428571428571429
alypsylike,0,10,3,7,0,0.428571428571429
montestatic,0,11,4,7,0,0.571428571428571
cheesebox,1,9,4,5,0,0.8
jakob,1,5,2,3,0,0.666666666666667
myxochondromas,0,14,4,10,0,0.4
uzdt,0,4,1,3,0,0.333333333333333
outrings,1,8,3,5,0,0.6
vishnavite,1,10,4,6,0,0.666666666666667
gles,0,4,1,3,0,0.333333333333333
laterifa,0,8,4,4,0,1
mystagogus,1,10,3,7,0,0.428571428571429
baalath,1,7,3,4,0,0.75
stereospecifically,1,18,7,11,0,0.636363636363636
glazier,1,7,3,4,0,0.75
anfracoscopier,0,14,6,8,0,0.75
presship,0,8,2,6,0,0.333333333333333
phalacrocoracidae,1,17,8,9,0,0.888888888888889
booking,1,7,3,4,0,0.75
shilled,1,7,2,5,0,0.4
outpressing,1,11,4,7,0,0.571428571428571
ror,0,3,1,2,0,0.5
nonowner,1,8,3,5,0,0.6
esperance,1,9,4,5,0,0.8
gages,0,5,2,3,0,0.666666666666667
perist,0,6,2,4,0,0.5
gonionia,1,8,5,3,0,1.66666666666667
reemerging,1,10,4,6,0,0.666666666666667
frankforts,1,10,2,8,0,0.25
xanadu,1,6,3,3,0,1
lithotrities,1,12,5,7,0,0.714285714285714
gauntry,1,7,2,5,0,0.4
nyvwnradhffgyuyusnlpjwvki,0,25,4,21,0,0.19047619047619
thymonucleic,1,12,4,8,0,0.5
undecorative,1,12,6,6,0,1
platonianismatoid,0,17,8,9,0,0.888888888888889
amarillis,1,9,4,5,0,0.8
biternate,1,9,4,5,0,0.8
wsw,1,3,0,3,0,0
palaeeudyptes,1,13,6,7,0,0.857142857142857
umbersick,0,9,3,6,0,0.5
cinquercialected,0,16,7,9,0,0.777777777777778
datecapa,0,8,4,4,0,1
sporoniarist,0,12,5,7,0,0.714285714285714
uncurbedly,1,10,3,7,0,0.428571428571429
tardive,1,7,3,4,0,0.75
uigursh,0,7,3,4,0,0.75
universatile,0,12,6,6,0,1
rodewdrously,0,12,4,8,0,0.5
ljrsekqvvxzassi'moym'm'd,0,24,4,20,3,0.2
yup,1,3,1,2,0,0.5
backsbordificarpulate,0,21,8,13,0,0.615384615384615
zdf,0,3,0,3,0,0
microlepidopteron,0,17,7,10,0,0.7
fragmas,0,7,2,5,0,0.4
absolutista,1,11,5,6,0,0.833333333333333
sokemen,1,7,3,4,0,0.75
polatheliticheilly,0,18,7,11,0,0.636363636363636
tasteless,1,9,3,6,0,0.5
gymnosophs,1,10,2,8,0,0.25
nutjobber,1,9,3,6,0,0.5
rhetoric,1,8,3,5,0,0.6
vectrogue,0,9,4,5,0,0.8
branslatrix,0,11,3,8,0,0.375
magsmen,1,7,2,5,0,0.4
technicipien,0,12,5,7,0,0.714285714285714
doxographer,1,11,4,7,0,0.571428571428571
epai,0,4,3,1,0,3
unprays,1,7,2,5,0,0.4
rcqf,0,4,0,4,0,0
jocundity,1,9,3,6,0,0.5
varifically,0,11,4,7,0,0.571428571428571
nontangibly,1,11,3,8,0,0.375
opisthosomata,0,13,6,7,0,0.857142857142857
cappal,0,6,2,4,0,0.5
zinfandousnesses,0,16,6,10,0,0.6
lavouretry,0,10,4,6,0,0.666666666666667
galeneness,0,10,4,6,0,0.666666666666667
assimilationisms,1,16,7,9,0,0.777777777777778
webster,1,7,2,5,0,0.4
pyrientonishman,0,15,5,10,0,0.5
vitriolise,1,10,5,5,0,1
iridescence,1,11,5,6,0,0.833333333333333
unruefulness,1,12,5,7,0,0.714285714285714
fankling,1,8,2,6,0,0.333333333333333
interry,0,7,2,5,0,0.4
ruckus,1,6,2,4,0,0.5
misrecognition,1,14,6,8,0,0.75
unhinged,1,8,3,5,0,0.6
eggler,1,6,2,4,0,0.5
mogliting,0,9,3,6,0,0.5
metempiricisms,1,14,5,9,0,0.555555555555556
octorsus,0,8,3,5,0,0.6
lituus,1,6,3,3,0,1
rhamnoside,1,10,4,6,0,0.666666666666667
abscesses,1,9,3,6,0,0.5
villamaria,1,10,5,5,0,1
currel,0,6,2,4,0,0.5
electromyography,1,16,5,11,0,0.454545454545455
ploycoslurocthlllietryluns,0,26,7,19,0,0.368421052631579
subprottier,0,11,4,7,0,0.571428571428571
katherylonychidachrachous,0,25,8,17,0,0.470588235294118
ric,1,3,1,2,0,0.5
vondsira,1,8,3,5,0,0.6
feminesses,0,10,4,6,0,0.666666666666667
metif,1,5,2,3,0,0.666666666666667
trilizing,0,9,3,6,0,0.5
stopia,0,6,3,3,0,1
microcystal,0,11,3,8,0,0.375
decharinterr,0,12,4,8,0,0.5
pcp,1,3,0,3,0,0
shiomanwayingens,0,16,6,10,0,0.6
megaloceras,0,11,5,6,0,0.833333333333333
machroid,0,8,3,5,0,0.6
holliquitous,0,12,6,6,0,1
recipitaka,0,10,5,5,0,1
neoanthropine,0,13,6,7,0,0.857142857142857
weemlxwjv'kbaznqdnyd'ejalhki,0,28,6,22,2,0.272727272727273
barrackings,1,11,3,8,0,0.375
alaunes,0,7,4,3,0,1.33333333333333
intergeneric,1,12,5,7,0,0.714285714285714
pseudocystment,0,14,4,10,0,0.4
heringer,1,8,3,5,0,0.6
markeviking,0,11,4,7,0,0.571428571428571
mimond,0,6,2,4,0,0.5
botinep,0,7,3,4,0,0.75
anencephalia,1,12,6,6,0,1
jarvie,1,6,3,3,0,1
suicidologies,1,13,7,6,0,1.16666666666667
decordiidae,0,11,6,5,0,1.2
cediserwhaliseilled,0,19,8,11,0,0.727272727272727
lulhfarby'jwjggvyz,0,18,2,16,1,0.125
meme,1,4,2,2,0,1
medicinated,0,11,5,6,0,0.833333333333333
comminister,1,11,4,7,0,0.571428571428571
meless,0,6,2,4,0,0.5
pasteurelleae,1,13,7,6,0,1.16666666666667
dumosities,1,10,5,5,0,1
carpopodite,1,11,5,6,0,0.833333333333333
kircurriness,0,12,4,8,0,0.5
certosina,1,9,4,5,0,0.8
repackager,1,10,4,6,0,0.666666666666667
exara,0,5,3,2,0,1.5
bulcibersh,0,10,3,7,0,0.428571428571429
hontdealasa,0,11,5,6,0,0.833333333333333
phelonion,1,9,4,5,0,0.8
edenioodename,0,13,8,5,0,1.6
leavenworth,1,11,4,7,0,0.571428571428571
auxo,1,4,3,1,0,3
sanoserous,1,10,5,5,0,1
lltutumuiwkdkzpjdnnxpns,0,23,4,19,0,0.210526315789474
innobedient,1,11,5,6,0,0.833333333333333
imbraction,0,10,4,6,0,0.666666666666667
huca,0,4,2,2,0,1
yodghsrcsnyk,0,12,1,11,0,0.0909090909090909
tunney,1,6,2,4,0,0.5
veraguira,0,9,5,4,0,1.25
brannungur,0,10,3,7,0,0.428571428571429
evables,0,7,3,4,0,0.75
sceptring,1,9,2,7,0,0.285714285714286
calanthe,1,8,3,5,0,0.6
reife,0,5,3,2,0,1.5
kapila,1,6,3,3,0,1
plaidmen,1,8,3,5,0,0.6
laager,1,6,3,3,0,1
gokoitret,0,9,4,5,0,0.8
antidiabetic,1,12,6,6,0,1
juramenta,1,9,4,5,0,0.8
complimentator,0,14,5,9,0,0.555555555555556
schwitters,1,10,2,8,0,0.25
aeuplole,0,8,5,3,0,1.66666666666667
bedbugs,1,7,2,5,0,0.4
unstepping,1,10,3,7,0,0.428571428571429
vi'tucan,0,8,3,5,1,0.6
postmodernisms,1,14,4,10,0,0.4
lamoille,1,8,4,4,0,1
mncjevfjwpfcfhnchsurruyv,0,24,3,21,0,0.142857142857143
pynetpkcqugpkgiu,0,16,4,12,0,0.333333333333333
yeldrocks,1,9,2,7,0,0.285714285714286
rjyzoaoljqknb,0,13,3,10,0,0.3
nonalinement,1,12,5,7,0,0.714285714285714
radioanaphoric,0,14,7,7,0,1
falconer,1,8,3,5,0,0.6
hawknose,1,8,3,5,0,0.6
unprejudice,1,11,5,6,0,0.833333333333333
detrimenting,0,12,4,8,0,0.5
mindfucks,1,9,2,7,0,0.285714285714286
wanemons,0,8,3,5,0,0.6
pationacks,0,10,4,6,0,0.666666666666667
calefactional,0,13,6,7,0,0.857142857142857
womeuivehs,0,10,5,5,0,1
qghsxgsdrkjbahgwjx,0,18,1,17,0,0.0588235294117647
dogfox,1,6,2,4,0,0.5
dificiously,0,11,5,6,0,0.833333333333333
outscorns,1,9,3,6,0,0.5
clyoperrgamoschntirroumadrtinlilicoliuandogilaschtrbisegwane,0,60,22,38,0,0.578947368421053
wordmaking,1,10,3,7,0,0.428571428571429
folkland,1,8,2,6,0,0.333333333333333
balladeroyal,1,12,5,7,0,0.714285714285714
halaming,0,8,3,5,0,0.6
nontemperateness,1,16,6,10,0,0.6
pouter,1,6,3,3,0,1
hior,0,4,2,2,0,1
glycemia,0,8,3,5,0,0.6
kickau,0,6,3,3,0,1
mowas,1,5,2,3,0,0.666666666666667
cystennuinian,0,13,5,8,0,0.625
unbureaucratically,1,18,8,10,0,0.8
tazomisltercimablas,0,19,7,12,0,0.583333333333333
chnvabamenganesearel,0,20,8,12,0,0.666666666666667
cappery,0,7,2,5,0,0.4
hlwn,0,4,0,4,0,0
cle,0,3,1,2,0,0.5
yqwazzsnyduflzes,0,16,3,13,0,0.230769230769231
prefishnerger,0,13,4,9,0,0.444444444444444
sphenomena,0,10,4,6,0,0.666666666666667
progue,0,6,3,3,0,1
bathtsvilladisacquatic,0,22,8,14,0,0.571428571428571
bioush,0,6,3,3,0,1
overwidely,1,10,4,6,0,0.666666666666667
hhofpxpiytxvbuzdsz,0,18,3,15,0,0.2
suln,0,4,1,3,0,0.333333333333333
layoquousness,0,13,6,7,0,0.857142857142857
mettie,1,6,3,3,0,1
marshflower,1,11,3,8,0,0.375
ballman,1,7,2,5,0,0.4
deducive,1,8,4,4,0,1
limericks,1,9,3,6,0,0.5
preopsis,0,8,3,5,0,0.6
pobue'rjdcpuoxipowjsagwfzq,0,26,8,18,1,0.444444444444444
myrmer,0,6,1,5,0,0.2
labourites,1,10,5,5,0,1
forestantial,0,12,5,7,0,0.714285714285714
antty,0,5,1,4,0,0.25
nonbeneficence,1,14,6,8,0,0.75
yepely,1,6,2,4,0,0.5
sauce,1,5,3,2,0,1.5
charah,0,6,2,4,0,0.5
paternalistically,1,17,6,11,0,0.545454545454545
sanguifies,1,10,5,5,0,1
trainmen,1,8,3,5,0,0.6
astiverbush,0,11,4,7,0,0.571428571428571
minstrel,1,8,2,6,0,0.333333333333333
emhe'ujh'v,0,10,3,7,2,0.428571428571429
xoztnrlzxffd,0,12,1,11,0,0.0909090909090909
bflower,0,7,2,5,0,0.4
mercurialis,1,11,5,6,0,0.833333333333333
snuffer,1,7,2,5,0,0.4
unwaned,1,7,3,4,0,0.75
sculduddery,1,11,3,8,0,0.375
tariffise,1,9,4,5,0,0.8
chuckfarthing,1,13,3,10,0,0.3
myrtlessner,0,11,2,9,0,0.222222222222222
bedesman,1,8,3,5,0,0.6
cleidarthritis,1,14,5,9,0,0.555555555555556
pleurocerebral,1,14,6,8,0,0.75
nuthous,0,7,3,4,0,0.75
nonbuoyantly,1,12,4,8,0,0.5
wiqbcffgemrlufsmwo,0,18,4,14,0,0.285714285714286
activizes,1,9,4,5,0,0.8
mohammercive,0,12,5,7,0,0.714285714285714
wigaes,0,6,3,3,0,1
treponematoses,1,14,6,8,0,0.75
spavindy,1,8,2,6,0,0.333333333333333
freewritingness,0,15,5,10,0,0.5
hottedness,0,10,3,7,0,0.428571428571429
randomisations,1,14,6,8,0,0.75
dargle,1,6,2,4,0,0.5
wijwpxazjoz,0,11,3,8,0,0.375
hypophyseoprivous,1,17,6,11,0,0.545454545454545
qus,0,3,1,2,0,0.5
stophomovervock,0,15,5,10,0,0.5
slothwaities,0,12,5,7,0,0.714285714285714
nazification,1,12,6,6,0,1
clearcutness,1,12,4,8,0,0.5
joggling,1,8,2,6,0,0.333333333333333
chiasusceptune,0,14,6,8,0,0.75
telitey,0,7,3,4,0,0.75
ariel,1,5,3,2,0,1.5
zosterops,1,9,3,6,0,0.5
babilane,0,8,4,4,0,1
hairece,0,7,4,3,0,1.33333333333333
benoverparangs,0,14,5,9,0,0.555555555555556
counterly,1,9,3,6,0,0.5
gozewasllyt,0,11,3,8,0,0.375
apostrophies,0,12,5,7,0,0.714285714285714
chechnyan,1,9,2,7,0,0.285714285714286
nongibs,0,7,2,5,0,0.4
unchodonakinites,0,16,7,9,0,0.777777777777778
cleanne,0,7,3,4,0,0.75
etwee,1,5,3,2,0,1.5
kees'lee,0,8,4,4,1,1
blottes,0,7,2,5,0,0.4
nondenominational,1,17,8,9,0,0.888888888888889
suarbopterlods,0,14,5,9,0,0.555555555555556
dongle,1,6,2,4,0,0.5
pantinonchiliqueazio,0,20,10,10,0,1
ilkxzihccqjk,0,12,2,10,0,0.2
barbackup,0,9,3,6,0,0.5
brigal,0,6,2,4,0,0.5
satyras,1,7,2,5,0,0.4
meandershepherded,0,17,6,11,0,0.545454545454545
tory,1,4,1,3,0,0.333333333333333
unemployment,1,12,4,8,0,0.5
potis,0,5,2,3,0,0.666666666666667
mmin,0,4,1,3,0,0.333333333333333
conves,0,6,2,4,0,0.5
mrssnrsecjkgvoufcybtolclon,0,26,5,21,0,0.238095238095238
qwzcnlbjf,0,9,0,9,0,0
twoccing,1,8,2,6,0,0.333333333333333
compulsive,1,10,4,6,0,0.666666666666667
jamalacings,0,11,4,7,0,0.571428571428571
mysteriosophy,1,13,4,9,0,0.444444444444444
hyperman,0,8,2,6,0,0.333333333333333
byrlady,1,7,1,6,0,0.166666666666667
unsequite,0,9,5,4,0,1.25
alcumy,1,6,2,4,0,0.5
bottomness,1,10,3,7,0,0.428571428571429
pyroheliometer,1,14,6,8,0,0.75
goeniere,0,8,5,3,0,1.66666666666667
robbyn,1,6,1,5,0,0.2
ayaqaalaq,0,9,5,4,0,1.25
triols,1,6,2,4,0,0.5
pearlitic,1,9,4,5,0,0.8
columnistic,1,11,4,7,0,0.571428571428571
utnapishtim,1,11,4,7,0,0.571428571428571
somaxi,0,6,3,3,0,1
mazwhlwtglh,0,11,1,10,0,0.1
raculer,0,7,3,4,0,0.75
jobestotidamabilaerotenstiprcophemanves,0,39,16,23,0,0.695652173913043
protozoulogical,1,15,7,8,0,0.875
nons,0,4,1,3,0,0.333333333333333
hebestoonnisera,0,15,7,8,0,0.875
siliquarius,0,11,6,5,0,1.2
lutisms,0,7,2,5,0,0.4
seitxbjhuiotyxph'vin',0,21,6,15,2,0.4
buckeye,1,7,3,4,0,0.75
unprondereatta,0,14,6,8,0,0.75
lobedieness,0,11,5,6,0,0.833333333333333
wagoner,1,7,3,4,0,0.75
kaffrarians,1,11,4,7,0,0.571428571428571
mtkscgrljkfardbuj,0,17,2,15,0,0.133333333333333
abelmusk,1,8,3,5,0,0.6
purpuric,1,8,3,5,0,0.6
highlan,0,7,2,5,0,0.4
kbyqllzhxszqd,0,13,0,13,0,0
catalufa,1,8,4,4,0,1
velma,1,5,2,3,0,0.666666666666667
muisting,1,8,3,5,0,0.6
ylieecry,0,8,3,5,0,0.6
schiavoni,1,9,4,5,0,0.8
instrumentalism,1,15,5,10,0,0.5
presages,1,8,3,5,0,0.6
exorcistically,0,14,5,9,0,0.555555555555556
ccaue,0,5,3,2,0,1.5
horizontically,1,14,5,9,0,0.555555555555556
ideogrammed,0,11,5,6,0,0.833333333333333
alkmardnes,0,10,3,7,0,0.428571428571429
evaristus,1,9,4,5,0,0.8
deschutes,1,9,3,6,0,0.5
spleuracana,0,11,5,6,0,0.833333333333333
unnerving,1,9,3,6,0,0.5
tfqzeqqvlwwuzfprhxnpm,0,21,2,19,0,0.105263157894737
kcvbkalnvzwubavmg,0,17,3,14,0,0.214285714285714
gefj,0,4,1,3,0,0.333333333333333
memrpwzbobgqjrocoducgpww,0,24,5,19,0,0.263157894736842
bookkneepagata,0,14,7,7,0,1
adrenalcortical,1,15,6,9,0,0.666666666666667
cecilla,1,7,3,4,0,0.75
kries,1,5,2,3,0,0.666666666666667
wabbcrons,0,9,2,7,0,0.285714285714286
pari,0,4,2,2,0,1
branchiosaurian,1,15,7,8,0,0.875
inscience,1,9,4,5,0,0.8
polycentrism,1,12,3,9,0,0.333333333333333
gemstone,1,8,3,5,0,0.6
deprobar,0,8,3,5,0,0.6
nobilitle,0,9,4,5,0,0.8
uniousnesses,0,12,6,6,0,1
colshipie,0,9,4,5,0,0.8
yqktfzxojwqokzelosibzcbev,0,25,6,19,0,0.315789473684211
kathodal,1,8,3,5,0,0.6
bunic,0,5,2,3,0,0.666666666666667
copenov,0,7,3,4,0,0.75
dissection,1,10,4,6,0,0.666666666666667
catalanist,1,10,4,6,0,0.666666666666667
backaches,1,9,3,6,0,0.5
perpignan,1,9,3,6,0,0.5
musketry,1,8,2,6,0,0.333333333333333
collateralized,1,14,6,8,0,0.75
minnes,0,6,2,4,0,0.5
pyrophoruses,1,12,4,8,0,0.5
nonremuneration,1,15,7,8,0,0.875
unthematically,1,14,5,9,0,0.555555555555556
batodent,0,8,3,5,0,0.6
semimicroanalysis,1,17,7,10,0,0.7
phexpror,0,8,2,6,0,0.333333333333333
accha,0,5,2,3,0,0.666666666666667
atelss,0,6,2,4,0,0.5
winkerous,0,9,4,5,0,0.8
rubicure,0,8,4,4,0,1
lithodomus,1,10,4,6,0,0.666666666666667
frerich,0,7,2,5,0,0.4
midhead,0,7,3,4,0,0.75
sboltorintladrseoway,0,20,7,13,0,0.538461538461538
steppingstones,1,14,4,10,0,0.4
unfingered,1,10,4,6,0,0.666666666666667
voronoff,1,8,3,5,0,0.6
sublieutenants,1,14,6,8,0,0.75
homopsida,0,9,4,5,0,0.8
korntunna,1,9,3,6,0,0.5
nummulation,1,11,5,6,0,0.833333333333333
disform,1,7,2,5,0,0.4
occuttingasband,0,15,5,10,0,0.5
whippet,1,7,2,5,0,0.4
ster,0,4,1,3,0,0.333333333333333
dideswomen,0,10,4,6,0,0.666666666666667
cobryatalactionsteracadicoard,0,29,12,17,0,0.705882352941177
substabled,0,10,3,7,0,0.428571428571429
mascot,1,6,2,4,0,0.5
recovery,1,8,3,5,0,0.6
essentional,0,11,5,6,0,0.833333333333333
gluttonising,1,12,4,8,0,0.5
z'rumbrunijgvgmxetx,0,19,4,15,1,0.266666666666667
iricheratinopongeroponers,0,25,11,14,0,0.785714285714286
recamier,1,8,4,4,0,1
cocisinwad,0,10,4,6,0,0.666666666666667
leglins,1,7,2,5,0,0.4
badhimenics,0,11,4,7,0,0.571428571428571
caponniere,1,10,5,5,0,1
epineanty,0,9,4,5,0,0.8
favourite,1,9,5,4,0,1.25
housewa,0,7,4,3,0,1.33333333333333
nonseriality,1,12,5,7,0,0.714285714285714
beful,0,5,2,3,0,0.666666666666667
antlers,1,7,2,5,0,0.4
misapplication,1,14,6,8,0,0.75
icentlikoletaean,0,16,8,8,0,1
panguilitalle,0,13,6,7,0,0.857142857142857
nlqzlwcn,0,8,0,8,0,0
unsummoned,1,10,4,6,0,0.666666666666667
mandelson,1,9,3,6,0,0.5
underuyters,0,11,4,7,0,0.571428571428571
pearsall,1,8,3,5,0,0.6
occleve,1,7,3,4,0,0.75
carcisation,0,11,5,6,0,0.833333333333333
enterma,0,7,3,4,0,0.75
llozecybesyan,0,13,4,9,0,0.444444444444444
unchristabel,0,12,4,8,0,0.5
undisturbed,1,11,4,7,0,0.571428571428571
birse,1,5,2,3,0,0.666666666666667
berycian,0,8,3,5,0,0.6
isodynamic,1,10,4,6,0,0.666666666666667
gurolinick,1,10,4,6,0,0.666666666666667
soaves,1,6,3,3,0,1
trichophyllous,1,14,4,10,0,0.4
otocranic,1,9,4,5,0,0.8
perr,1,4,1,3,0,0.333333333333333
outplays,1,8,3,5,0,0.6
biozonises,0,10,5,5,0,1
heela,0,5,3,2,0,1.5
aulpinecinoragrentrmoliogsacoparnur,0,35,15,20,0,0.75
conilurus,1,9,4,5,0,0.8
aerophane,1,9,5,4,0,1.25
unvoluminousness,1,16,7,9,0,0.777777777777778
unhired,1,7,3,4,0,0.75
bathroomed,1,10,4,6,0,0.666666666666667
stracetambridousness,0,20,7,13,0,0.538461538461538
ae,0,2,2,0,0,1
ensheafs,0,8,3,5,0,0.6
hlsrn'pwadovwbrstdazyalws,0,25,4,21,1,0.19047619047619
prekindergarten,1,15,5,10,0,0.5
aeria,1,5,4,1,0,4
polyneurous,0,11,5,6,0,0.833333333333333
albunea,1,7,4,3,0,1.33333333333333
puggarees,1,9,4,5,0,0.8
bowliness,0,9,3,6,0,0.5
kfdzgvw'h,0,9,0,9,1,0
s'wactmthdvbxtxtb'vproyuaxhhz,0,29,4,25,2,0.16
tienjudere,0,10,5,5,0,1
hydroborofluoric,1,16,6,10,0,0.6
gatrotaliasestantonil,0,21,9,12,0,0.75
schizoidism,1,11,4,7,0,0.571428571428571
prevenance,1,10,4,6,0,0.666666666666667
solanderfulness,0,15,5,10,0,0.5
gopik,1,5,2,3,0,0.666666666666667
fralle,0,6,2,4,0,0.5
platichthyes,0,12,3,9,0,0.333333333333333
nonfels,0,7,2,5,0,0.4
interstitial,1,12,5,7,0,0.714285714285714
biasness,1,8,3,5,0,0.6
tobaccoism,1,10,4,6,0,0.666666666666667
hederaceously,1,13,6,7,0,0.857142857142857
pluviometry,1,11,4,7,0,0.571428571428571
orbicuspensiveness,0,18,7,11,0,0.636363636363636
neopologistical,0,15,7,8,0,0.875
qxtndtqpsvykqsgs,0,16,0,16,0,0
ptilocrinus,1,11,4,7,0,0.571428571428571
lackwittedly,1,12,3,9,0,0.333333333333333
downforcedly,0,12,3,9,0,0.333333333333333
sanfourd,1,8,3,5,0,0.6
tonomical,0,9,4,5,0,0.8
snaga,0,5,2,3,0,0.666666666666667
comparer,1,8,3,5,0,0.6
dunster,1,7,2,5,0,0.4
overfactiously,1,14,6,8,0,0.75
birrell,1,7,2,5,0,0.4
oleogeny,0,8,4,4,0,1
wxiipgxegtobfsipz',0,18,5,13,1,0.384615384615385
pop,1,3,1,2,0,0.5
p'uiy'y'cbnejju,0,15,4,11,3,0.363636363636364
'rlsnb,0,6,0,6,1,0
ungentlewomanlier,0,17,7,10,0,0.7
rdodlmhwm,0,9,1,8,0,0.125
stonewalls,1,10,3,7,0,0.428571428571429
subspecialization,1,17,8,9,0,0.888888888888889
markdowns,1,9,2,7,0,0.285714285714286
teers,0,5,2,3,0,0.666666666666667
collat,1,6,2,4,0,0.5
rebirth,1,7,2,5,0,0.4
sexts,1,5,1,4,0,0.25
jgnlccfjfielvplh'ogmxnz,0,23,3,20,1,0.15
toxicism,0,8,3,5,0,0.6
epid,0,4,2,2,0,1
grufe,1,5,2,3,0,0.666666666666667
anigrapher,0,10,4,6,0,0.666666666666667
bard,1,4,1,3,0,0.333333333333333
lamaist,1,7,3,4,0,0.75
teriante,0,8,4,4,0,1
wagweno,1,7,3,4,0,0.75
increately,1,10,4,6,0,0.666666666666667
graphyrocarabi,0,14,5,9,0,0.555555555555556
anisostichum,0,12,5,7,0,0.714285714285714
rialinthimphbowepecerinenages,0,29,12,17,0,0.705882352941177
nifiangucoucumitonaleliorea,0,27,15,12,0,1.25
god,1,3,1,2,0,0.5
nonyl,1,5,1,4,0,0.25
cualms,0,6,2,4,0,0.5
unvert,0,6,2,4,0,0.5
strumming,1,9,2,7,0,0.285714285714286
ardishicarype,0,13,5,8,0,0.625
ynzocxrgqzxvjluun,0,17,3,14,0,0.214285714285714
pezia,0,5,3,2,0,1.5
unpetulantly,1,12,4,8,0,0.5
bjourness,0,9,3,6,0,0.5
raritan,1,7,3,4,0,0.75
nonrecoil,1,9,4,5,0,0.8
internalised,1,12,5,7,0,0.714285714285714
aestuary,1,8,4,4,0,1
raticap,0,7,3,4,0,0.75
ultann,1,6,2,4,0,0.5
riblechwoornollenel,0,19,7,12,0,0.583333333333333
intellectualistically,1,21,8,13,0,0.615384615384615
superstate,1,10,4,6,0,0.666666666666667
uredina,0,7,4,3,0,1.33333333333333
efonundestare,0,13,6,7,0,0.857142857142857
splinty,1,7,1,6,0,0.166666666666667
rmonelinauferoms,0,16,7,9,0,0.777777777777778
brookster,0,9,3,6,0,0.5
ketembillate,0,12,5,7,0,0.714285714285714
eruditional,1,11,6,5,0,1.2
immodest,1,8,3,5,0,0.6
saam,1,4,2,2,0,1
peaching,1,8,3,5,0,0.6
wxajofbibaawmdptxfwuqgury,0,25,7,18,0,0.388888888888889
schurman,1,8,2,6,0,0.333333333333333
palese,0,6,3,3,0,1
gexkssgctrtkajuhmgerkphy,0,24,4,20,0,0.2
hysterol,0,8,2,6,0,0.333333333333333
oboobia,0,7,5,2,0,2.5
resusceptivitian,0,16,7,9,0,0.777777777777778
buttonholes,1,11,4,7,0,0.571428571428571
eprolwa,0,7,3,4,0,0.75
recleared,0,9,4,5,0,0.8
phylacobiosis,1,13,5,8,0,0.625
toadstones,1,10,4,6,0,0.666666666666667
uglift,0,6,2,4,0,0.5
alphabetiser,1,12,5,7,0,0.714285714285714
densian,0,7,3,4,0,0.75
postdebutantes,1,14,5,9,0,0.555555555555556
zkopldhkbczlmzkjcahlnbnrxgba,0,28,3,25,0,0.12
ariane,1,6,4,2,0,2
thristomahandyner,0,17,5,12,0,0.416666666666667
ethnolinguistic,1,15,6,9,0,0.666666666666667
unpikranscidae,0,14,6,8,0,0.75
lateralized,1,11,5,6,0,0.833333333333333
ursal,1,5,2,3,0,0.666666666666667
carphiophiops,1,13,5,8,0,0.625
aggaggling,0,10,3,7,0,0.428571428571429
calke,0,5,2,3,0,0.666666666666667
aigialosaurus,1,13,8,5,0,1.6
spumone,1,7,3,4,0,0.75
nibble,1,6,2,4,0,0.5
cn'fhbnkgqotcryogbh,0,19,2,17,1,0.117647058823529
neaptide,1,8,4,4,0,1
corticotropin,1,13,5,8,0,0.625
demanyanos,0,10,4,6,0,0.666666666666667
tanzanitas,0,10,4,6,0,0.666666666666667
hjtgubkwscdpz'e'iy,0,18,3,15,2,0.2
zootechnics,1,11,4,7,0,0.571428571428571
drudgeworks,1,11,3,8,0,0.375
histoglossa,0,11,4,7,0,0.571428571428571
hechte,0,6,2,4,0,0.5
kirbie,1,6,3,3,0,1
varletaille,1,11,5,6,0,0.833333333333333
quadragenary,0,12,5,7,0,0.714285714285714
humbleness,1,10,3,7,0,0.428571428571429
fpzrwtrbiizaxcdw,0,16,3,13,0,0.230769230769231
cyma,1,4,1,3,0,0.333333333333333
cytoniarcemation,0,16,7,9,0,0.777777777777778
dostricons,0,10,3,7,0,0.428571428571429
reflectorise,1,12,5,7,0,0.714285714285714
ggninicatigieruivewis,0,21,10,11,0,0.909090909090909
worl,1,4,1,3,0,0.333333333333333
umangite,1,8,4,4,0,1
branctiva,0,9,3,6,0,0.5
subceptions,1,11,4,7,0,0.571428571428571
barnabe,1,7,3,4,0,0.75
eelyspyactrivaragrtumatu,0,24,9,15,0,0.6
lzo'kbdol'zbamuhjcc,0,19,4,15,2,0.266666666666667
kahunanangel,0,12,5,7,0,0.714285714285714
rieseeximieneelt,0,16,9,7,0,1.28571428571429
tympanuchus,1,11,3,8,0,0.375
zjqeimiiqxhfoneu,0,16,7,9,0,0.777777777777778
vsxhridlsj'ykl'myo,0,18,2,16,2,0.125
zelotypie,1,9,4,5,0,0.8
holohedry,1,9,3,6,0,0.5
nlmmcgbzbjzlmxpjxiw'wyhpxid,0,27,2,25,1,0.08
comb,1,4,1,3,0,0.333333333333333
spinozisms,1,10,3,7,0,0.428571428571429
coughings,1,9,3,6,0,0.5
donero,0,6,3,3,0,1
mviuiyaamymxqzuscuwkuhs,0,23,8,15,0,0.533333333333333
paygottunslachroraterenaroloncolonsa,0,36,14,22,0,0.636363636363636
wirelessness,1,12,4,8,0,0.5
preindemnifying,1,15,5,10,0,0.5
contactor,1,9,3,6,0,0.5
qqbklhgnwayr,0,12,1,11,0,0.0909090909090909
bhqmhlgpnigzirphhxdzecth,0,24,3,21,0,0.142857142857143
pedicellaria,1,12,6,6,0,1
'ohussefpfmqxq'xri,0,18,4,14,2,0.285714285714286
mptpwbkmassrnxlsvjvcur',0,23,2,21,1,0.0952380952380952
pauninditeg,0,11,5,6,0,0.833333333333333
scrimatobian,0,12,5,7,0,0.714285714285714
foregrounded,1,12,5,7,0,0.714285714285714
backlands,1,9,2,7,0,0.285714285714286
gyqskbdb'hjmgolux'cjgzkbjnzd,0,28,2,26,2,0.0769230769230769
nikolos,1,7,3,4,0,0.75
disintegrable,1,13,5,8,0,0.625
heterokinesis,1,13,6,7,0,0.857142857142857
virilier,0,8,4,4,0,1
bleoteetiselonatsm,0,18,8,10,0,0.8
cophieston,0,10,4,6,0,0.666666666666667
zoophilia,1,9,5,4,0,1.25
land,1,4,1,3,0,0.333333333333333
overpreters,0,11,4,7,0,0.571428571428571
industrys,1,9,2,7,0,0.285714285714286
stepladders,1,11,3,8,0,0.375
gammonaea,0,9,5,4,0,1.25
paraphonic,1,10,4,6,0,0.666666666666667
basidigital,1,11,5,6,0,0.833333333333333
discriminativeness,1,18,7,11,0,0.636363636363636
underoid,0,8,4,4,0,1
ascitan,1,7,3,4,0,0.75
crant,0,5,1,4,0,0.25
kivikivi,1,8,4,4,0,1
cundity,0,7,2,5,0,0.4
eurysthenes,1,11,4,7,0,0.571428571428571
condalia,1,8,4,4,0,1
noordbreakishexahydracrylate,0,28,10,18,0,0.555555555555556
angiotribe,1,10,5,5,0,1
nakomgilisala,1,13,6,7,0,0.857142857142857
violator,1,8,4,4,0,1
metallary,1,9,3,6,0,0.5
spunkinesses,1,12,4,8,0,0.5
dkddet,0,6,1,5,0,0.2
scrapparellishers,0,17,5,12,0,0.416666666666667
lacarne,1,7,3,4,0,0.75
ourve,0,5,3,2,0,1.5
extemportions,0,13,5,8,0,0.625
yangtze,1,7,2,5,0,0.4
superunfit,1,10,4,6,0,0.666666666666667
jdljacxubf,0,10,2,8,0,0.25
lookists,1,8,3,5,0,0.6
matriarchical,1,13,5,8,0,0.625
nonaccretion,1,12,5,7,0,0.714285714285714
wiretapper,1,10,4,6,0,0.666666666666667
mechelles,0,9,3,6,0,0.5
toganteria,0,10,5,5,0,1
elutinate,0,9,5,4,0,1.25
phyllite,1,8,2,6,0,0.333333333333333
ichtworkeld,0,11,3,8,0,0.375
supplier,1,8,3,5,0,0.6
fother,1,6,2,4,0,0.5
vaselined,1,9,4,5,0,0.8
subhypotheses,1,13,4,9,0,0.444444444444444
coerttowomas,0,12,5,7,0,0.714285714285714
killdeer,1,8,3,5,0,0.6
bergh,1,5,1,4,0,0.25
cursorientally,0,14,5,9,0,0.555555555555556
aforesaid,1,9,5,4,0,1.25
flurry,1,6,1,5,0,0.2
priciact,0,8,3,5,0,0.6
tweunrjdpocqab''xktekk,0,22,5,17,2,0.294117647058824
hasthteoximacre,0,15,6,9,0,0.666666666666667
linamarin,1,9,4,5,0,0.8
slaying,1,7,2,5,0,0.4
conservatist,1,12,4,8,0,0.5
iujhrs'amznjdfxbsjoptmwsqksy,0,28,4,24,1,0.166666666666667
mmgdmjnszdogxzq,0,15,1,14,0,0.0714285714285714
paragliding,1,11,4,7,0,0.571428571428571
spinnariidae,0,12,6,6,0,1
crampons,1,8,2,6,0,0.333333333333333
hok,0,3,1,2,0,0.5
d'qhodu'uzns,0,12,3,9,2,0.333333333333333
thundrasianism,0,14,5,9,0,0.555555555555556
tribathful,0,10,3,7,0,0.428571428571429
creent,0,6,2,4,0,0.5
pyrolamas,0,9,3,6,0,0.5
rousseauite,1,11,7,4,0,1.75
nihal,1,5,2,3,0,0.666666666666667
cogotinobimity,0,14,6,8,0,0.75
t'xpcudxvbhfavkzhga,0,19,3,16,1,0.1875
jaquesian,1,9,5,4,0,1.25
mir,1,3,1,2,0,0.5
noblepiumanoningcorstoromak,0,27,11,16,0,0.6875
lously,0,6,2,4,0,0.5
wormwoods,1,9,3,6,0,0.5
unfathomablenesses,1,18,7,11,0,0.636363636363636
odifte,0,6,3,3,0,1
heterokinesis,1,13,6,7,0,0.857142857142857
imprisoner,1,10,4,6,0,0.666666666666667
crotypographer,0,14,4,10,0,0.4
januisz,1,7,3,4,0,0.75
nondescriber,0,12,4,8,0,0.5
freer,1,5,2,3,0,0.666666666666667
fnaz'xom'doqvjkqeszndbrz,0,24,4,20,2,0.2
myzodendraceous,1,15,6,9,0,0.666666666666667
brothers,1,8,2,6,0,0.333333333333333
ganakilot,0,9,4,5,0,0.8
bitinssumpefferitacrmiomalltnessedsarfiectss,0,44,15,29,0,0.517241379310345
stippled,1,8,2,6,0,0.333333333333333
radiophotos,1,11,5,6,0,0.833333333333333
katicawopintes,0,14,6,8,0,0.75
personising,1,11,4,7,0,0.571428571428571
rhesus,1,6,2,4,0,0.5
unbillable,1,10,4,6,0,0.666666666666667
l'fdytmxhip,0,11,1,10,1,0.1
chiploancered,0,13,5,8,0,0.625
aphlago,0,7,3,4,0,0.75
unmaneged,1,9,4,5,0,0.8
jooklam,0,7,3,4,0,0.75
purpurchivedal,0,14,5,9,0,0.555555555555556
moptona,0,7,3,4,0,0.75
unaccumulated,1,13,6,7,0,0.857142857142857
nondisciplined,1,14,5,9,0,0.555555555555556
onaka,1,5,3,2,0,1.5
wearability,1,11,5,6,0,0.833333333333333
precedestration,0,15,6,9,0,0.666666666666667
luftmensch,1,10,2,8,0,0.25
ootompeclarprooshagentily,0,25,10,15,0,0.666666666666667
freedoot,1,8,4,4,0,1
tomography,1,10,3,7,0,0.428571428571429
sonatine,1,8,4,4,0,1
ostentator,0,10,4,6,0,0.666666666666667
phascogale,1,10,4,6,0,0.666666666666667
gcudotm,0,7,2,5,0,0.4
sporocarpium,1,12,5,7,0,0.714285714285714
rbronge,0,7,2,5,0,0.4
indefensibly,1,12,4,8,0,0.5
munros,1,6,2,4,0,0.5
fomentative,0,11,5,6,0,0.833333333333333
si'vu'h,0,7,2,5,2,0.4
looseness,1,9,4,5,0,0.8
propertype,0,10,3,7,0,0.428571428571429
inviolateness,1,13,6,7,0,0.857142857142857
restral,0,7,2,5,0,0.4
preadamite,1,10,5,5,0,1
turtlers,1,8,2,6,0,0.333333333333333
doggle,1,6,2,4,0,0.5
ptiatettes,0,10,4,6,0,0.666666666666667
strousness,0,10,3,7,0,0.428571428571429
greenba,0,7,3,4,0,0.75
raties,0,6,3,3,0,1
chorivanemms,0,12,4,8,0,0.5
overmaschloes,0,13,5,8,0,0.625
deshabilles,1,11,4,7,0,0.571428571428571
imponderance,0,12,5,7,0,0.714285714285714
optigraph,1,9,3,6,0,0.5
salariat,1,8,4,4,0,1
majess,0,6,2,4,0,0.5
capiadermiscutria,0,17,8,9,0,0.888888888888889
irispaterc,0,10,4,6,0,0.666666666666667
subdiaphosphers,0,15,5,10,0,0.5
fushun,1,6,2,4,0,0.5
theriolates,0,11,5,6,0,0.833333333333333
plectopter,1,10,3,7,0,0.428571428571429
dilatorinesses,1,14,6,8,0,0.75
oetnmrqkhzgsbqimgydguhfyrgez,0,28,5,23,0,0.217391304347826
maceae,0,6,4,2,0,2
annens,0,6,2,4,0,0.5
interpeduncular,1,15,6,9,0,0.666666666666667
kilorad,1,7,3,4,0,0.75
urnmaker,1,8,3,5,0,0.6
beastings,1,9,3,6,0,0.5
pterophonic,0,11,4,7,0,0.571428571428571
gypaethrin,0,10,3,7,0,0.428571428571429
neoconchopneusis,0,16,7,9,0,0.777777777777778
tiploid,0,7,3,4,0,0.75
frathingorgeviod,0,16,6,10,0,0.6
naliandomstitraniusnakkorrithrale,0,33,13,20,0,0.65
lighter,1,7,2,5,0,0.4
tetrachical,1,11,4,7,0,0.571428571428571
gonitise,0,8,4,4,0,1
replenish,1,9,3,6,0,0.5
lobionapanistunkahsh,0,20,8,12,0,0.666666666666667
thrombosi,0,9,3,6,0,0.5
udurmetiazoniopleslalanequld,0,28,13,15,0,0.866666666666667
inteumonal,0,10,5,5,0,1
gynandromorph,1,13,3,10,0,0.3
prockilishention,0,16,6,10,0,0.6
stotribulian,0,12,5,7,0,0.714285714285714
seligman,1,8,3,5,0,0.6
intrication,1,11,5,6,0,0.833333333333333
diffusion,1,9,4,5,0,0.8
mespilus,1,8,3,5,0,0.6
northington,1,11,3,8,0,0.375
victoir,1,7,3,4,0,0.75
mbbxomgb'wzcfaduknltuxjffn,0,26,4,22,1,0.181818181818182
kansous,0,7,3,4,0,0.75
anovocathmiacetone,0,18,9,9,0,1
figurabilities,1,14,7,7,0,1
ste,0,3,1,2,0,0.5
gambrel,1,7,2,5,0,0.4
webhead,1,7,3,4,0,0.75
alasignatna,0,11,5,6,0,0.833333333333333
armode,0,6,3,3,0,1
scophossadiscanisseaugighthfling,0,32,11,21,0,0.523809523809524
candid,1,6,2,4,0,0.5
complexification,1,16,7,9,0,0.777777777777778
cayla,1,5,2,3,0,0.666666666666667
phylactorienting,0,16,5,11,0,0.454545454545455
hophyeppermus,0,13,4,9,0,0.444444444444444
patedev,0,7,3,4,0,0.75
bedless,1,7,2,5,0,0.4
ecu,1,3,2,1,0,2
cotingidae,1,10,5,5,0,1
rombosenchieration,0,18,8,10,0,0.8
contrascrotal,0,13,4,9,0,0.444444444444444
disserted,1,9,3,6,0,0.5
contague,0,8,4,4,0,1
murielle,1,8,4,4,0,1
tritebpenddrongerne,0,19,6,13,0,0.461538461538462
lopsidednesses,1,14,5,9,0,0.555555555555556
guruzze,0,7,3,4,0,0.75
drinkermans,0,11,3,8,0,0.375
poy,1,3,1,2,0,0.5
hazelhurst,1,10,3,7,0,0.428571428571429
waistbelts,1,10,3,7,0,0.428571428571429
unsubsell,0,9,3,6,0,0.5
youthless,1,9,3,6,0,0.5
malapert,1,8,3,5,0,0.6
vrpevhoxy,0,9,2,7,0,0.285714285714286
wbvtenesstioce,0,14,5,9,0,0.555555555555556
unyokes,1,7,3,4,0,0.75
bullbrier,1,9,3,6,0,0.5
gllxea,0,6,2,4,0,0.5
algologies,1,10,5,5,0,1
protomorteromenthorescenceser,0,29,11,18,0,0.611111111111111
trotted,1,7,2,5,0,0.4
urethrophyma,1,12,4,8,0,0.5
cleche,1,6,2,4,0,0.5
sillyhood,1,9,3,6,0,0.5
repollute,1,9,4,5,0,0.8
eoos,0,4,3,1,0,3
enjppa,0,6,2,4,0,0.5
figynontationisolvers,0,21,8,13,0,0.615384615384615
micropalaeontologist,1,20,9,11,0,0.818181818181818
amooves,1,7,4,3,0,1.33333333333333
lioaphouealatiris,0,17,10,7,0,1.42857142857143
peingesine,0,10,5,5,0,1
nontradition,1,12,5,7,0,0.714285714285714
cricoids,1,8,3,5,0,0.6
fiaunt,1,6,3,3,0,1
botral,0,6,2,4,0,0.5
titurnist,0,9,3,6,0,0.5
extrepharatorioranaeuss,0,23,11,12,0,0.916666666666667
lepolynnine,0,11,4,7,0,0.571428571428571
sso,1,3,1,2,0,0.5
meda,1,4,2,2,0,1
microparticulable,0,17,7,10,0,0.7
reinstructs,1,11,3,8,0,0.375
externship,1,10,3,7,0,0.428571428571429
langrenus,1,9,3,6,0,0.5
hemolymph,1,9,2,7,0,0.285714285714286
displeasureable,1,15,7,8,0,0.875
penaea,1,6,4,2,0,2
farcers,1,7,2,5,0,0.4
reamus,0,6,3,3,0,1
betreations,0,11,5,6,0,0.833333333333333
freewriting,1,11,4,7,0,0.571428571428571
stephanometers,0,14,5,9,0,0.555555555555556
monstat,0,7,2,5,0,0.4
spectrode,0,9,3,6,0,0.5
fonig,0,5,2,3,0,0.666666666666667
adpromissor,1,11,4,7,0,0.571428571428571
didact,1,6,2,4,0,0.5
peratop,0,7,3,4,0,0.75
indiademed,1,10,5,5,0,1
gasteromycetes,1,14,5,9,0,0.555555555555556
sedbsttyomod,0,12,3,9,0,0.333333333333333
pebr,0,4,1,3,0,0.333333333333333
wedgie,1,6,3,3,0,1
unkedin,0,7,3,4,0,0.75
accos,0,5,2,3,0,0.666666666666667
zxchcwzxbu'jsts'yu,0,18,2,16,2,0.125
iguania,1,7,5,2,0,2.5
annecorinne,1,11,5,6,0,0.833333333333333
cdichotly,0,9,2,7,0,0.285714285714286
wiros,1,5,2,3,0,0.666666666666667
bsw,1,3,0,3,0,0
ringworth,0,9,2,7,0,0.285714285714286
fieldie,1,7,4,3,0,1.33333333333333
sludgier,1,8,3,5,0,0.6
preeconomical,1,13,6,7,0,0.857142857142857
palaeomagnetism,1,15,7,8,0,0.875
pierrot,1,7,3,4,0,0.75
materialities,1,13,7,6,0,1.16666666666667
conboisaltlarerisz,0,18,7,11,0,0.636363636363636
akked,0,5,2,3,0,0.666666666666667
dulcibelle,1,10,4,6,0,0.666666666666667
nondefinably,1,12,4,8,0,0.5
snes,0,4,1,3,0,0.333333333333333
equa,0,4,3,1,0,3
cyathiformers,0,13,4,9,0,0.444444444444444
runtgenizing,1,12,4,8,0,0.5
psilose,0,7,3,4,0,0.75
chely,0,5,1,4,0,0.25
lgrdgnrbgtn'zzqef'pgfvq'rys,0,27,1,26,3,0.0384615384615385
reruedatrialalfierselditt,0,25,11,14,0,0.785714285714286
quatisms,0,8,3,5,0,0.6
headbox,1,7,3,4,0,0.75
synfuel,1,7,2,5,0,0.4
jay,0,3,1,2,0,0.5
nsis,0,4,1,3,0,0.333333333333333
fredek,1,6,2,4,0,0.5
optoelectrogenitures,0,20,9,11,0,0.818181818181818
chemospasia,0,11,5,6,0,0.833333333333333
tbnfgmafxzlpfwoha,0,17,3,14,0,0.214285714285714
pentadic,1,8,3,5,0,0.6
shabroon,1,8,3,5,0,0.6
flimonsfrapolo,0,14,5,9,0,0.555555555555556
ctluatabasdabppr,0,16,5,11,0,0.454545454545455
lno'gkhxsaqilha,0,15,4,11,1,0.363636363636364
q'fxrylfwue'bpf've,0,18,3,15,3,0.2
cinchoate,0,9,4,5,0,0.8
oblongritic,0,11,4,7,0,0.571428571428571
cousin,1,6,3,3,0,1
liamandat,0,9,4,5,0,0.8
beaconlessnesses,0,16,6,10,0,0.6
repining,1,8,3,5,0,0.6
unswappable,1,11,4,7,0,0.571428571428571
glutination,1,11,5,6,0,0.833333333333333
cophalcomicynd,0,14,4,10,0,0.4
notitic,0,7,3,4,0,0.75
resinification,1,14,7,7,0,1
cytosis,0,7,2,5,0,0.4
countrailitz,0,12,5,7,0,0.714285714285714
coohee,1,6,4,2,0,2
fcbxwatcyrazvhziiyveanpttvysb,0,29,6,23,0,0.260869565217391
huddlingly,1,10,2,8,0,0.25
himeros,1,7,3,4,0,0.75
taran,1,5,2,3,0,0.666666666666667
undandled,1,9,3,6,0,0.5
spomst,0,6,1,5,0,0.2
francophobia,1,12,5,7,0,0.714285714285714
micapopal,0,9,4,5,0,0.8
giroflore,1,9,4,5,0,0.8
foolier,0,7,4,3,0,1.33333333333333
menshevik,1,9,3,6,0,0.5
tequila,1,7,4,3,0,1.33333333333333
coexist,1,7,3,4,0,0.75
freaky,1,6,2,4,0,0.5
floutingstocks,1,14,4,10,0,0.4
phidippides,1,11,4,7,0,0.571428571428571
bzkfefmfl,0,9,1,8,0,0.125
'fpktrpbtbnwsdiuvan'grnjbuk,0,27,4,23,2,0.173913043478261
u'ahlczvkgkfhlhcarroycd,0,23,4,19,1,0.210526315789474
buoshofjogarocivfzjfk'v'an,0,26,8,18,2,0.444444444444444
ipad,1,4,2,2,0,1
terrestrialise,1,14,6,8,0,0.75
korc,1,4,1,3,0,0.333333333333333
stintings,1,9,2,7,0,0.285714285714286
wzheuaqcwb,0,10,3,7,0,0.428571428571429
woowu,0,5,3,2,0,1.5
lightning,1,9,2,7,0,0.285714285714286
pdwawaaufzse,0,12,5,7,0,0.714285714285714
prunasinousness,0,15,6,9,0,0.666666666666667
epistemolog,1,11,5,6,0,0.833333333333333
blegeole,0,8,4,4,0,1
mccarthyite,1,11,3,8,0,0.375
postorder,1,9,3,6,0,0.5
inspheration,1,12,5,7,0,0.714285714285714
strata,1,6,2,4,0,0.5
overyoung,1,9,4,5,0,0.8
allelogram,0,10,4,6,0,0.666666666666667
kumni,1,5,2,3,0,0.666666666666667
bbon,0,4,1,3,0,0.333333333333333
postscutellum,1,13,4,9,0,0.444444444444444
palises,0,7,3,4,0,0.75
machmiadenous,0,13,6,7,0,0.857142857142857
fortriditic,0,11,4,7,0,0.571428571428571
varnemoness,0,11,4,7,0,0.571428571428571
rjvmb'ktltfskf'ovyaeabjseaaz,0,28,7,21,2,0.333333333333333
gxiyyikqmssdlxde'iwltsqflb,0,26,4,22,1,0.181818181818182
rubvolia,0,8,4,4,0,1
irresolvabilities,1,17,8,9,0,0.888888888888889
linecasting,1,11,4,7,0,0.571428571428571
wcycwrzx'uz,0,11,1,10,1,0.1
twistily,1,8,2,6,0,0.333333333333333
wifelier,1,8,4,4,0,1
chlorhexidine,1,13,5,8,0,0.625
cyclometer,1,10,3,7,0,0.428571428571429
precelebrator,0,13,5,8,0,0.625
paralogism,1,10,4,6,0,0.666666666666667
repowderless,0,12,4,8,0,0.5
diurne,1,6,3,3,0,1
ambassies,1,9,4,5,0,0.8
thunderstrikes,1,14,4,10,0,0.4
rennotienesquategation,0,22,11,11,0,1
pangatuntergat,0,14,5,9,0,0.555555555555556
unmodernness,0,12,4,8,0,0.5
usphovilsponomingrpueamironernerely,0,35,14,21,0,0.666666666666667
dimercaprol,1,11,4,7,0,0.571428571428571
diyhqursxgoyx'tbybw'nk,0,22,3,19,2,0.157894736842105
inonodgianthork,0,15,6,9,0,0.666666666666667
seminai,0,7,4,3,0,1.33333333333333
exact,1,5,2,3,0,0.666666666666667
clarabella,1,10,4,6,0,0.666666666666667
balzacian,1,9,4,5,0,0.8
decalitre,1,9,4,5,0,0.8
antepagments,1,12,4,8,0,0.5
airstyling,0,10,3,7,0,0.428571428571429
disfaction,0,10,4,6,0,0.666666666666667
gid,1,3,1,2,0,0.5
punnier,1,7,3,4,0,0.75
adytoid,0,7,3,4,0,0.75
qzmifllhmi'yydoiokrrwcclf,0,25,5,20,1,0.25
schistocytes,1,12,3,9,0,0.333333333333333
hespiridea,0,10,5,5,0,1
sparrowy,1,8,2,6,0,0.333333333333333
hamulose,1,8,4,4,0,1
hackneyman,1,10,3,7,0,0.428571428571429
buttinski,1,9,3,6,0,0.5
threeper,0,8,3,5,0,0.6
polyisobutyrophenolia,0,21,9,12,0,0.75
visor,1,5,2,3,0,0.666666666666667
numbevochabva,0,13,5,8,0,0.625
miegeckancodlan,0,15,6,9,0,0.666666666666667
strenuousness,1,13,5,8,0,0.625
thrana,0,6,2,4,0,0.5
aculattus,0,9,4,5,0,0.8
pelharmouse,0,11,5,6,0,0.833333333333333
galbrecht,0,9,2,7,0,0.285714285714286
kahlotuslandy,0,13,4,9,0,0.444444444444444
hassamen,0,8,3,5,0,0.6
gaulit,0,6,3,3,0,1
gly,0,3,0,3,0,0
trichad,0,7,2,5,0,0.4
housesat,1,8,4,4,0,1
jiiq,0,4,2,2,0,1
dfslkizzguag'rqa,0,16,4,12,1,0.333333333333333
maurist,0,7,3,4,0,0.75
peregrinates,1,12,5,7,0,0.714285714285714
confutator,1,10,4,6,0,0.666666666666667
bokhis,0,6,2,4,0,0.5
photochemistry,1,14,4,10,0,0.4
dinuba,1,6,3,3,0,1
prospiterechip,0,14,5,9,0,0.555555555555556
mocon,0,5,2,3,0,0.666666666666667
yelt,1,4,1,3,0,0.333333333333333
suchos,1,6,2,4,0,0.5
xizdxixcvbvmefftfaa,0,19,5,14,0,0.357142857142857
confections,1,11,4,7,0,0.571428571428571
wocels,0,6,2,4,0,0.5
dennie,1,6,3,3,0,1
timbrels,1,8,2,6,0,0.333333333333333
teems,1,5,2,3,0,0.666666666666667
convector,1,9,3,6,0,0.5
paramedic,1,9,4,5,0,0.8
notan,1,5,2,3,0,0.666666666666667
speller,1,7,2,5,0,0.4
restorina,0,9,4,5,0,0.8
cifig,0,5,2,3,0,0.666666666666667
agung,1,5,2,3,0,0.666666666666667
priml,0,5,1,4,0,0.25
jactance,1,8,3,5,0,0.6
precollapsing,1,13,4,9,0,0.444444444444444
mischiefer,0,10,4,6,0,0.666666666666667
simulance,1,9,4,5,0,0.8
guated,0,6,3,3,0,1
schia,0,5,2,3,0,0.666666666666667
ineludibly,1,10,4,6,0,0.666666666666667
estabbotch,0,10,3,7,0,0.428571428571429
extender,1,8,3,5,0,0.6
pejerrey,1,8,3,5,0,0.6
rfobxbpixoh'mudngpyuxrk,0,23,5,18,1,0.277777777777778
hydrosoponnody,0,14,4,10,0,0.4
qabalah,1,7,3,4,0,0.75
chen,1,4,1,3,0,0.333333333333333
newsprint,1,9,2,7,0,0.285714285714286
syecldtrrltsgwtxydy,0,19,1,18,0,0.0555555555555556
supercommentary,1,15,5,10,0,0.5
tasonal,0,7,3,4,0,0.75
yogurt,1,6,2,4,0,0.5
anaxibia,1,8,5,3,0,1.66666666666667
haulms,1,6,2,4,0,0.5
assfaremomeneta,0,15,7,8,0,0.875
infracorallike,0,14,6,8,0,0.75
imblem,0,6,2,4,0,0.5
muhanuttaurefrochiseloel,0,24,11,13,0,0.846153846153846
parentage,1,9,4,5,0,0.8
mesesiner,0,9,4,5,0,0.8
ecycousinism,0,12,5,7,0,0.714285714285714
dssnzqqw,0,8,0,8,0,0
supercivilised,1,14,6,8,0,0.75
dieselisation,1,13,7,6,0,1.16666666666667
woricalk,0,8,3,5,0,0.6
nauch,1,5,2,3,0,0.666666666666667
comitra,0,7,3,4,0,0.75
bernardo,1,8,3,5,0,0.6
orysoakitendes,0,14,6,8,0,0.75
overaccentuate,1,14,7,7,0,1
basketwork,1,10,3,7,0,0.428571428571429
orthyonisodont,0,14,5,9,0,0.555555555555556
manshift,1,8,2,6,0,0.333333333333333
bioly,0,5,2,3,0,0.666666666666667
hemimercurrent,0,14,5,9,0,0.555555555555556
elmendorf,1,9,3,6,0,0.5
micropyle,1,9,3,6,0,0.5
attendements,1,12,4,8,0,0.5
counterchainability,0,19,8,11,0,0.727272727272727
enfrancing,0,10,3,7,0,0.428571428571429
anelesmacapllint,0,16,6,10,0,0.6
rdiduialitrt,0,12,5,7,0,0.714285714285714
adustiosis,1,10,5,5,0,1
cwjbiybqmaag'ang,0,16,4,12,1,0.333333333333333
elints,1,6,2,4,0,0.5
usucaptable,1,11,5,6,0,0.833333333333333
euglenineae,1,11,7,4,0,1.75
maulgres,1,8,3,5,0,0.6
apologetic,1,10,5,5,0,1
shellie,1,7,3,4,0,0.75
eaysfwujokqdkq'nrgv,0,19,4,15,1,0.266666666666667
realpolitiks,1,12,5,7,0,0.714285714285714
affilla,0,7,3,4,0,0.75
sinhailien,1,10,5,5,0,1
uncontemned,1,11,4,7,0,0.571428571428571
gentlewomanish,1,14,5,9,0,0.555555555555556
kame,1,4,2,2,0,1
surveyals,1,9,3,6,0,0.5
accompanying,1,12,4,8,0,0.5
unstracheammillaccacte,0,22,8,14,0,0.571428571428571
dinge,0,5,2,3,0,0.666666666666667
handicrafters,1,13,4,9,0,0.444444444444444
prookling,0,9,3,6,0,0.5
swanpan,1,7,2,5,0,0.4
overlightly,1,11,3,8,0,0.375
overlaud,1,8,4,4,0,1
apoint,0,6,3,3,0,1
entorg,0,6,2,4,0,0.5
gleis,1,5,2,3,0,0.666666666666667
jjejyclgieibo'fb,0,16,5,11,1,0.454545454545455
thrutch,1,7,1,6,0,0.166666666666667
culex,1,5,2,3,0,0.666666666666667
phtherologist,0,13,4,9,0,0.444444444444444
intransliteratings,0,18,6,12,0,0.5
napakiak,1,8,4,4,0,1
howsomdever,1,11,4,7,0,0.571428571428571
calder,1,6,2,4,0,0.5
chaldaic,1,8,3,5,0,0.6
juranfesmupphexts,0,17,5,12,0,0.416666666666667
psychokidakeisha,0,16,6,10,0,0.6
arahochums,0,10,4,6,0,0.666666666666667
sphargised,0,10,3,7,0,0.428571428571429
chantey,1,7,2,5,0,0.4
cardiophobe,1,11,5,6,0,0.833333333333333
baghdad,1,7,2,5,0,0.4
destroyingly,1,12,3,9,0,0.333333333333333
emphlysis,1,9,2,7,0,0.285714285714286
cochecton,1,9,3,6,0,0.5
eskite,0,6,3,3,0,1
peregrinator,1,12,5,7,0,0.714285714285714
badlg,0,5,1,4,0,0.25
skep,1,4,1,3,0,0.333333333333333
uurmlfbbxvyxa,0,13,3,10,0,0.3
quadry,0,6,2,4,0,0.5
kembs,1,5,1,4,0,0.25
affrightfield,0,13,4,9,0,0.444444444444444
homicrofilmslidemarchebiosis,0,28,11,17,0,0.647058823529412
sarivelleexille,0,15,7,8,0,0.875
xmalzdnulxz,0,11,2,9,0,0.222222222222222
forittleeinelers,0,16,7,9,0,0.777777777777778
dogton,0,6,2,4,0,0.5
chrysopid,1,9,2,7,0,0.285714285714286
gless,0,5,1,4,0,0.25
misunderstander,1,15,5,10,0,0.5
symmetrians,1,11,3,8,0,0.375
myxobacterism,0,13,4,9,0,0.444444444444444
unt,0,3,1,2,0,0.5
weele,0,5,3,2,0,1.5
luctyxcyx'p,0,11,1,10,1,0.1
pillmonger,1,10,3,7,0,0.428571428571429
neutical,0,8,4,4,0,1
interpol,1,8,3,5,0,0.6
ear,1,3,2,1,0,2
amacensignifulgudinated,0,23,10,13,0,0.769230769230769
hypercellularity,1,16,5,11,0,0.454545454545455
concentrates,1,12,4,8,0,0.5
postlaunch,1,10,3,7,0,0.428571428571429
hematosis,0,9,4,5,0,0.8
veechroneem,0,11,5,6,0,0.833333333333333
pseudohumanistic,1,16,7,9,0,0.777777777777778
seediness,1,9,4,5,0,0.8
toppings,1,8,2,6,0,0.333333333333333
epithetical,1,11,5,6,0,0.833333333333333
yutzes,1,6,2,4,0,0.5
binctigis,0,9,3,6,0,0.5
claspt,1,6,1,5,0,0.2
acup,0,4,2,2,0,1
cholesters,0,10,3,7,0,0.428571428571429
kittled,1,7,2,5,0,0.4
uncustomariness,1,15,6,9,0,0.666666666666667
gliare,1,6,3,3,0,1
whitewing,1,9,3,6,0,0.5
hiel,0,4,2,2,0,1
infantiredated,0,14,6,8,0,0.75
essera,1,6,3,3,0,1
demilly,0,7,2,5,0,0.4
parthena,1,8,3,5,0,0.6
morphgan,1,8,2,6,0,0.333333333333333
eczematosis,1,11,5,6,0,0.833333333333333
nonegrohood,0,11,5,6,0,0.833333333333333
bantidalolumalans,0,17,7,10,0,0.7
markdowns,1,9,2,7,0,0.285714285714286
ickersong,0,9,3,6,0,0.5
trelu,1,5,2,3,0,0.666666666666667
enures,1,6,3,3,0,1
straucht,1,8,2,6,0,0.333333333333333
barreleye,1,9,4,5,0,0.8
unobligating,1,12,5,7,0,0.714285714285714
terephthalate,1,13,5,8,0,0.625
authenotcy,0,10,4,6,0,0.666666666666667
elberon,1,7,3,4,0,0.75
proctoplegia,1,12,5,7,0,0.714285714285714
laqhfgwhcruj',0,13,2,11,1,0.181818181818182
rylgn'ihipccxj,0,14,2,12,1,0.166666666666667
arsonations,0,11,5,6,0,0.833333333333333
qleyhxyhrgcwvwbaxaw'm',0,22,3,19,2,0.157894736842105
ticketias,0,9,4,5,0,0.8
equilibranchantasy,0,18,7,11,0,0.636363636363636
ficteorisprement,0,16,6,10,0,0.6
cheredetenagreramorimias,0,24,11,13,0,0.846153846153846
iknxrz'd,0,8,1,7,1,0.142857142857143
recco,1,5,2,3,0,0.666666666666667
cytiflentatdo'nes,0,17,5,12,1,0.416666666666667
glossion,0,8,3,5,0,0.6
forehinting,1,11,4,7,0,0.571428571428571
meliphagidae,1,12,6,6,0,1
deppodozies,0,11,5,6,0,0.833333333333333
molang,0,6,2,4,0,0.5
gastroscopies,1,13,5,8,0,0.625
topcastle,1,9,3,6,0,0.5
chadbourne,1,10,4,6,0,0.666666666666667
monadic,1,7,3,4,0,0.75
thighter,0,8,2,6,0,0.333333333333333
caoda,0,5,3,2,0,1.5
titian,1,6,3,3,0,1
mybaism,0,7,2,5,0,0.4
aulard,1,6,3,3,0,1
sluttent,0,8,2,6,0,0.333333333333333
granum,1,6,2,4,0,0.5
dysodils,1,8,2,6,0,0.333333333333333
subspecialism,0,13,5,8,0,0.625
nongintinderadexensa,0,20,8,12,0,0.666666666666667
elegise,1,7,4,3,0,1.33333333333333
emblemology,0,11,4,7,0,0.571428571428571
ferriageproof,0,13,6,7,0,0.857142857142857
despisingly,1,11,3,8,0,0.375
poisonbush,1,10,4,6,0,0.666666666666667
stelar,1,6,2,4,0,0.5
overdress,1,9,3,6,0,0.5
hlfpeowwnto,0,11,3,8,0,0.375
bll,0,3,0,3,0,0
billbergia,1,10,4,6,0,0.666666666666667
rtinfios,0,8,3,5,0,0.6
tequila,1,7,4,3,0,1.33333333333333
overcon,0,7,3,4,0,0.75
'j'fqdqfymjs,0,12,0,12,2,0
ludd,1,4,1,3,0,0.333333333333333
callisteia,1,10,5,5,0,1
onychauxis,1,10,4,6,0,0.666666666666667
mughal,1,6,2,4,0,0.5
overshadowingly,1,15,5,10,0,0.5
catalogists,1,11,4,7,0,0.571428571428571
sproprily,0,9,2,7,0,0.285714285714286
sordinavigation,0,15,7,8,0,0.875
afgmfdzhzzyfgkfrycxv,0,20,1,19,0,0.0526315789473684
silkolines,1,10,4,6,0,0.666666666666667
azynyjzkw,0,9,1,8,0,0.125
sopeplabusleaveres,0,18,8,10,0,0.8
druct,0,5,1,4,0,0.25
quantico,1,8,4,4,0,1
interbalance,1,12,5,7,0,0.714285714285714
glory,1,5,1,4,0,0.25
robersonville,1,13,5,8,0,0.625
thermoclines,1,12,4,8,0,0.5
pisordaerusnes,0,14,6,8,0,0.75
sphendone,1,9,3,6,0,0.5
unicorneal,1,10,5,5,0,1
mormorando,1,10,4,6,0,0.666666666666667
mclemaker,0,9,3,6,0,0.5
vacherin,1,8,3,5,0,0.6
urningism,1,9,3,6,0,0.5
chingma,1,7,2,5,0,0.4
mauantis,0,8,4,4,0,1
schwalbea,1,9,3,6,0,0.5
cably,0,5,1,4,0,0.25
leatemiscroncenes,0,17,7,10,0,0.7
millabascarp,0,12,4,8,0,0.5
cackled,1,7,2,5,0,0.4
quilkin,1,7,3,4,0,0.75
drice,1,5,2,3,0,0.666666666666667
haberduviness,0,13,5,8,0,0.625
punched,1,7,2,5,0,0.4
anticonuses,0,11,5,6,0,0.833333333333333
overprosses,0,11,4,7,0,0.571428571428571
nonprefects,0,11,3,8,0,0.375
willowware,1,10,4,6,0,0.666666666666667
egftui,0,6,3,3,0,1
brantail,1,8,3,5,0,0.6
ieras,0,5,3,2,0,1.5
paeanize,0,8,5,3,0,1.66666666666667
cardoming,0,9,3,6,0,0.5
curllsville,1,11,3,8,0,0.375
varechs,1,7,2,5,0,0.4
whnoaxaasglrqa,0,14,5,9,0,0.555555555555556
unjactiose,0,10,5,5,0,1
causeuse,1,8,5,3,0,1.66666666666667
hteruws,0,7,2,5,0,0.4
unimpassioned,1,13,6,7,0,0.857142857142857
unfathomableness,1,16,6,10,0,0.6
significancy,1,12,4,8,0,0.5
uncatch,0,7,2,5,0,0.4
fermi,1,5,2,3,0,0.666666666666667
shrow,0,5,1,4,0,0.25
bonmeleeme,0,10,5,5,0,1
volvent,1,7,2,5,0,0.4
rosebud,1,7,3,4,0,0.75
genooanetus,0,11,6,5,0,1.2
cylindrosporium,1,15,5,10,0,0.5
altwhmack'tdxtnvyxcmhx,0,22,2,20,1,0.1
wirehairs,1,9,4,5,0,0.8
icnz'cznhouhwbslgc,0,18,3,15,1,0.2
isopales,0,8,4,4,0,1
prie,1,4,2,2,0,1
bolimeine,0,9,5,4,0,1.25
wobbly,1,6,1,5,0,0.2
chippable,1,9,3,6,0,0.5
disquietude,1,11,6,5,0,1.2
safribs,0,7,2,5,0,0.4
angolans,1,8,3,5,0,0.6
allynacenung,0,12,4,8,0,0.5
unselecting,1,11,4,7,0,0.571428571428571
ciciochedarilly,0,15,6,9,0,0.666666666666667
reconny,0,7,2,5,0,0.4
embergible,0,10,4,6,0,0.666666666666667
nonartis,0,8,3,5,0,0.6
marchesas,1,9,3,6,0,0.5
xdpnlwbzxrhzqu,0,14,1,13,0,0.0769230769230769
wnnd,0,4,0,4,0,0
rcykv,0,5,0,5,0,0
clupeidols,0,10,4,6,0,0.666666666666667
amylolyses,1,10,3,7,0,0.428571428571429
weadrucorfloridi,0,16,7,9,0,0.777777777777778
namochon,0,8,3,5,0,0.6
'dbvfpzxxuukjpzrnmvyovtxd,0,25,3,22,1,0.136363636363636
qujatota,0,8,4,4,0,1
laroomuncocus,0,13,6,7,0,0.857142857142857
ferromagnetist,0,14,5,9,0,0.555555555555556
obscurer,1,8,3,5,0,0.6
gly,0,3,0,3,0,0
tachyphyly,0,10,1,9,0,0.111111111111111
hpen,0,4,1,3,0,0.333333333333333
pasquiler,1,9,4,5,0,0.8
panded,0,6,2,4,0,0.5
clacionian,0,10,5,5,0,1
perfectas,1,9,3,6,0,0.5
myroamayely,0,11,4,7,0,0.571428571428571
stayable,1,8,3,5,0,0.6
hyalomanial,0,11,5,6,0,0.833333333333333
shoshoni,1,8,3,5,0,0.6
alfalfa,1,7,3,4,0,0.75
seqwl,1,5,1,4,0,0.25
atricobl,0,8,3,5,0,0.6
qprpidmzf'gf,0,12,1,11,1,0.0909090909090909
rondelet,1,8,3,5,0,0.6
waceowans,0,9,4,5,0,0.8
ternatisected,0,13,5,8,0,0.625
aegospotami,1,11,6,5,0,1.2
delandefenstroughteocryotic,0,27,10,17,0,0.588235294117647
subducocardestrams,0,18,6,12,0,0.5
escobadura,1,10,5,5,0,1
optorincorr,0,11,4,7,0,0.571428571428571
gub,1,3,1,2,0,0.5
archabless,0,10,3,7,0,0.428571428571429
professionalise,1,15,7,8,0,0.875
unwiss,0,6,2,4,0,0.5
izcdhqjhdfajrxmzrf,0,18,2,16,0,0.125
thrapple,1,8,2,6,0,0.333333333333333
unbraked,1,8,3,5,0,0.6
periclase,1,9,4,5,0,0.8
dacaxysti,0,9,3,6,0,0.5
irv,1,3,1,2,0,0.5
overdrench,1,10,3,7,0,0.428571428571429
beetiltterieerts,0,16,7,9,0,0.777777777777778
rematch,1,7,2,5,0,0.4
grand,1,5,1,4,0,0.25
uning,0,5,2,3,0,0.666666666666667
cobnut,1,6,2,4,0,0.5
unlightened,1,11,4,7,0,0.571428571428571
requiter,1,8,4,4,0,1
reintrenchments,0,15,4,11,0,0.363636363636364
zoophyta,1,8,3,5,0,0.6
torpefied,1,9,4,5,0,0.8
pentalienne,0,11,5,6,0,0.833333333333333
miscompute,1,10,4,6,0,0.666666666666667
rise,1,4,2,2,0,1
unscaldship,0,11,3,8,0,0.375
chical,0,6,2,4,0,0.5
disestablishmentarians,1,22,8,14,0,0.571428571428571
begillagesisen,0,14,6,8,0,0.75
amatembu,1,8,4,4,0,1
devastations,1,12,5,7,0,0.714285714285714
substantiveness,1,15,5,10,0,0.5
nitwitter,0,9,3,6,0,0.5
lumbaginously,0,13,5,8,0,0.625
passinianism,0,12,5,7,0,0.714285714285714
hphuza',0,7,2,5,1,0.4
gr,0,2,0,2,0,0
semiabstractions,1,16,6,10,0,0.6
unwomanise,1,10,5,5,0,1
tilber,0,6,2,4,0,0.5
vibrativism,0,11,4,7,0,0.571428571428571
emotivities,1,11,6,5,0,1.2
cephalocathartic,1,16,6,10,0,0.6
hoem,1,4,2,2,0,1
gnsmspwsphd,0,11,0,11,0,0
supervene,1,9,4,5,0,0.8
blokarzion,0,10,4,6,0,0.666666666666667
lcty,0,4,0,4,0,0
uvuxgjtfraybqej,0,15,4,11,0,0.363636363636364
stethoscopy,1,11,3,8,0,0.375
opticity,0,8,3,5,0,0.6
imitatrix,1,9,4,5,0,0.8
free,1,4,2,2,0,1
stipa,1,5,2,3,0,0.666666666666667
frixopres,0,9,3,6,0,0.5
sterning,1,8,2,6,0,0.333333333333333
chapourn,1,8,3,5,0,0.6
ingulf,1,6,2,4,0,0.5
photolith,0,9,3,6,0,0.5
antimaterialistic,1,17,8,9,0,0.888888888888889
didelphiae,0,10,5,5,0,1
imposer,1,7,3,4,0,0.75
bagouron,0,8,4,4,0,1
turnbroach,1,10,3,7,0,0.428571428571429
kresic,1,6,2,4,0,0.5
toleupars,0,9,4,5,0,0.8
watisilarffaldhned,0,18,6,12,0,0.5
tasha,1,5,2,3,0,0.666666666666667
arge,0,4,2,2,0,1
lhi,0,3,1,2,0,0.5
ginated,0,7,3,4,0,0.75
spottiness,1,10,3,7,0,0.428571428571429
chestily,1,8,2,6,0,0.333333333333333
delph,1,5,1,4,0,0.25
dagvdyojpzwvni'mnnfncmocou,0,26,6,20,1,0.3
fycepheteeds,0,12,4,8,0,0.5
veness,0,6,2,4,0,0.5
redan,1,5,2,3,0,0.666666666666667
davisboro,1,9,4,5,0,0.8
renunciations,1,13,6,7,0,0.857142857142857
gentlefolks,1,11,3,8,0,0.375
nondexcadided,0,13,5,8,0,0.625
caskelia,0,8,4,4,0,1
ede,1,3,2,1,0,2
arcology,1,8,3,5,0,0.6
harpy,1,5,1,4,0,0.25
milliphot,1,9,3,6,0,0.5
aftertrenched,0,13,4,9,0,0.444444444444444
sulu,1,4,2,2,0,1
pericause,0,9,5,4,0,1.25
novitiated,0,10,5,5,0,1
miner,1,5,2,3,0,0.666666666666667
alexander,1,9,4,5,0,0.8
knccakigvusgtptcnsgeuskuawcvlq,0,30,7,23,0,0.304347826086957
lklas,0,5,1,4,0,0.25
wzt,0,3,0,3,0,0
mislikins,0,9,3,6,0,0.5
graylance,0,9,3,6,0,0.5
aridity,1,7,3,4,0,0.75
haciendados,1,11,5,6,0,0.833333333333333
charmingly,1,10,2,8,0,0.25
dramative,0,9,4,5,0,0.8
cylkuphzlgacpbpeagc,0,19,4,15,0,0.266666666666667
syrphically,0,11,2,9,0,0.222222222222222
gessner,1,7,2,5,0,0.4
retgopapn'mfejzzja'ohsnolyrffp,0,30,7,23,2,0.304347826086957
allers,0,6,2,4,0,0.5
infrastigmatal,1,14,5,9,0,0.555555555555556
hydrogess,0,9,2,7,0,0.285714285714286
phereclus,1,9,3,6,0,0.5
flasayficrughthis,0,17,5,12,0,0.416666666666667
dopestered,0,10,4,6,0,0.666666666666667
purveyor,1,8,3,5,0,0.6
quaregists,0,10,4,6,0,0.666666666666667
ostrogothian,1,12,5,7,0,0.714285714285714
specularisable,0,14,6,8,0,0.75
overspends,1,10,3,7,0,0.428571428571429
trilafon,1,8,3,5,0,0.6
deli,1,4,2,2,0,1
rsis,0,4,1,3,0,0.333333333333333
unpendentiously,0,15,6,9,0,0.666666666666667
bioavailableness,0,16,8,8,0,1
mosaist,1,7,3,4,0,0.75
star,1,4,1,3,0,0.333333333333333
cestracion,1,10,4,6,0,0.666666666666667
tyzycmsu'jucxmtnkn,0,18,2,16,1,0.125
adjgizgrpnzytngmomduletx,0,24,5,19,0,0.263157894736842
shotmarker,0,10,3,7,0,0.428571428571429
tripitaka,1,9,4,5,0,0.8
tzendal,1,7,2,5,0,0.4
undiagram,0,9,4,5,0,0.8
infoota,0,7,4,3,0,1.33333333333333
persor,0,6,2,4,0,0.5
handicap,1,8,3,5,0,0.6
oecoparasitism,1,14,7,7,0,1
tqrci'',0,7,1,6,2,0.166666666666667
erections,1,9,4,5,0,0.8
boatma,0,6,3,3,0,1
ues,0,3,2,1,0,2
pharmacopolet,0,13,5,8,0,0.625
toolis,1,6,3,3,0,1
aerobacterials,0,14,7,7,0,1
irresolutions,1,13,6,7,0,0.857142857142857
unzephyrlike,1,12,4,8,0,0.5
partisera,0,9,4,5,0,0.8
wldpnawcftmbr,0,13,1,12,0,0.0833333333333333
spevek,1,6,2,4,0,0.5
jokmumat,0,8,3,5,0,0.6
isodimorphous,1,13,6,7,0,0.857142857142857
mannes,1,6,2,4,0,0.5
deute,0,5,3,2,0,1.5
rigate,0,6,3,3,0,1
ouredenchorthridae,0,18,8,10,0,0.8
genioglossaceous,0,16,8,8,0,1
avion,1,5,3,2,0,1.5
spectrographer,1,14,4,10,0,0.4
austrine,1,8,4,4,0,1
jowlings,0,8,2,6,0,0.333333333333333
sampler,1,7,2,5,0,0.4
herpotricha,0,11,4,7,0,0.571428571428571
cthty,0,5,0,5,0,0
culdoscopy,1,10,3,7,0,0.428571428571429
bodrtafoms,0,10,3,7,0,0.428571428571429
toxicol,1,7,3,4,0,0.75
gloominess,1,10,4,6,0,0.666666666666667
acuber,0,6,3,3,0,1
ghtriked,0,8,2,6,0,0.333333333333333
'qeqqzjzhdehgzamu'h,0,19,4,15,2,0.266666666666667
turbellarian,1,12,5,7,0,0.714285714285714
outentairistite,0,15,8,7,0,1.14285714285714
rjyms'ncevmgtla,0,15,2,13,1,0.153846153846154
stisirtiloonianghozabomasteckitagys,0,35,14,21,0,0.666666666666667
spitsum,0,7,2,5,0,0.4
typhomastmastinac,0,17,5,12,0,0.416666666666667
maurili,1,7,4,3,0,1.33333333333333
eurocentrum,0,11,5,6,0,0.833333333333333
njnjzlmh'n,0,10,0,10,1,0
kurtis,1,6,2,4,0,0.5
bilise,0,6,3,3,0,1
ejaculated,1,10,5,5,0,1
aucatermakitiellares,0,20,10,10,0,1
capitaphrasellie,0,16,7,9,0,0.777777777777778
slopstone,1,9,3,6,0,0.5
moines,1,6,3,3,0,1
wordsworthianism,1,16,5,11,0,0.454545454545455
whidah,1,6,2,4,0,0.5
nwpzmawdckyznnt'kqu''foiqtrcvo,0,30,5,25,3,0.2
buinolya,0,8,4,4,0,1
quadriest,0,9,4,5,0,0.8
stulings,0,8,2,6,0,0.333333333333333
walthousefronts,0,15,5,10,0,0.5
hylon,0,5,1,4,0,0.25
amberdiettails,0,14,6,8,0,0.75
overexcites,1,11,5,6,0,0.833333333333333
craalanapine,0,12,6,6,0,1
adzharians,1,10,4,6,0,0.666666666666667
dermoclitise,0,12,5,7,0,0.714285714285714
thelytonic,1,10,3,7,0,0.428571428571429
rosome,0,6,3,3,0,1
coint,0,5,2,3,0,0.666666666666667
zedaligeratse,0,13,6,7,0,0.857142857142857
ricki,1,5,2,3,0,0.666666666666667
guckiest,1,8,3,5,0,0.6
dstimm,0,6,1,5,0,0.2
neute,0,5,3,2,0,1.5
lehmann,1,7,2,5,0,0.4
perean,1,6,3,3,0,1
paranormalisation,0,17,8,9,0,0.888888888888889
tocalote,1,8,4,4,0,1
victorianism,1,12,5,7,0,0.714285714285714
bamitch,0,7,2,5,0,0.4
mommy,1,5,1,4,0,0.25
hemileia,1,8,5,3,0,1.66666666666667
ansmite,0,7,3,4,0,0.75
boutormetdomiricoph,0,19,8,11,0,0.727272727272727
parasexuality,1,13,6,7,0,0.857142857142857
glavers,0,7,2,5,0,0.4
flagint,0,7,2,5,0,0.4
untranslucida,0,13,5,8,0,0.625
entwines,1,8,3,5,0,0.6
catgut,1,6,2,4,0,0.5
listie,1,6,3,3,0,1
ivacepidikerevingelboey,0,23,11,12,0,0.916666666666667
hercogamous,1,11,5,6,0,0.833333333333333
milliceudotkinneadozelogymistedratical,0,38,16,22,0,0.727272727272727
siressness,0,10,3,7,0,0.428571428571429
cyrogalites,0,11,4,7,0,0.571428571428571
transvaluated,1,13,5,8,0,0.625
ep'kkljlubpvfwrrtqakdrd,0,23,3,20,1,0.15
bostrychoid,1,11,3,8,0,0.375
benight,1,7,2,5,0,0.4
pubers,0,6,2,4,0,0.5
elision,1,7,4,3,0,1.33333333333333
unmortgagee,0,11,5,6,0,0.833333333333333
rappercosmer,0,12,4,8,0,0.5
louverwork,1,10,4,6,0,0.666666666666667
piecemakers,0,11,5,6,0,0.833333333333333
ecrtro,0,6,2,4,0,0.5
kolos,1,5,2,3,0,0.666666666666667
cyclising,1,9,2,7,0,0.285714285714286
efis,0,4,2,2,0,1
ymjpgugqir'mbpzzef,0,18,3,15,1,0.2
gynwutwwybyi,0,12,2,10,0,0.2
itonia,1,6,4,2,0,2
totylemenablens,0,15,5,10,0,0.5
copiaded,0,8,4,4,0,1
timantitiestiacoped,0,19,9,10,0,0.9
tibiotarsus,1,11,5,6,0,0.833333333333333
veness,0,6,2,4,0,0.5
persianised,1,11,5,6,0,0.833333333333333
corene,1,6,3,3,0,1
cryosphericist,0,14,4,10,0,0.4
vend,1,4,1,3,0,0.333333333333333
herediplator,0,12,5,7,0,0.714285714285714
honduran,1,8,3,5,0,0.6
lallans,1,7,2,5,0,0.4
purblindner,0,11,3,8,0,0.375
saveloy,1,7,3,4,0,0.75
creston,1,7,2,5,0,0.4
convexed,1,8,3,5,0,0.6
ret,0,3,1,2,0,0.5
democrash,0,9,3,6,0,0.5
hexers,1,6,2,4,0,0.5
hyalospongia,1,12,5,7,0,0.714285714285714
hkvgduyunfyvo,0,13,3,10,0,0.3
hemophobias,0,11,5,6,0,0.833333333333333
anglicanism,1,11,4,7,0,0.571428571428571
exocoelectedly,0,14,6,8,0,0.75
dainemian,0,9,5,4,0,1.25
taproom,1,7,3,4,0,0.75
cheadle,1,7,3,4,0,0.75
kymnel,1,6,1,5,0,0.2
oxjxoeykytatnomwsxsfofbe'jnrqo,0,30,8,22,1,0.363636363636364
inventurousnesses,0,17,7,10,0,0.7
klondykes,1,9,2,7,0,0.285714285714286
kindheart,1,9,3,6,0,0.5
pleiophyllite,0,13,5,8,0,0.625
contracteriological,0,19,8,11,0,0.727272727272727
laproprin,0,9,3,6,0,0.5
licqusmend,0,10,3,7,0,0.428571428571429
unmercifulnesses,1,16,6,10,0,0.6
narcissing,0,10,3,7,0,0.428571428571429
kinetoscope,1,11,5,6,0,0.833333333333333
unrhymist,0,9,2,7,0,0.285714285714286
paer,0,4,2,2,0,1
unembraced,1,10,4,6,0,0.666666666666667
quee,0,4,3,1,0,3
jacobs,1,6,2,4,0,0.5
verange,0,7,3,4,0,0.75
disobligingnesses,1,17,6,11,0,0.545454545454545
lqqht,0,5,0,5,0,0
lindeberg,1,9,3,6,0,0.5
emmys,1,5,1,4,0,0.25
struthiform,1,11,3,8,0,0.375
phampaings,0,10,3,7,0,0.428571428571429
msn,1,3,0,3,0,0
muckman,1,7,2,5,0,0.4
sigsmond,1,8,2,6,0,0.333333333333333
nibxsci,0,7,2,5,0,0.4
squotharomatsucket,0,18,7,11,0,0.636363636363636
hayakawa,1,8,4,4,0,1
margarosanite,1,13,6,7,0,0.857142857142857
dairymen,1,8,3,5,0,0.6
malaptera,0,9,4,5,0,0.8
coagulabilities,1,15,8,7,0,1.14285714285714
exxw,0,4,1,3,0,0.333333333333333
nonmatrimonially,1,16,6,10,0,0.6
mathilde,1,8,3,5,0,0.6
uromycladium,1,12,5,7,0,0.714285714285714
hookworm,1,8,3,5,0,0.6
stomy,0,5,1,4,0,0.25
exertionless,1,12,5,7,0,0.714285714285714
cuse,0,4,2,2,0,1
exuvia,1,6,4,2,0,2
carpophyl,1,9,2,7,0,0.285714285714286
hillorthednes,0,13,4,9,0,0.444444444444444
fundament,1,9,3,6,0,0.5
viscounsellable,0,15,6,9,0,0.666666666666667
xenode,0,6,3,3,0,1
razorbillowweed,0,15,6,9,0,0.666666666666667
ist,1,3,1,2,0,0.5
archlets,1,8,2,6,0,0.333333333333333
fideicommissioner,1,17,8,9,0,0.888888888888889
counsee,0,7,4,3,0,1.33333333333333
polers,1,6,2,4,0,0.5
hpes,0,4,1,3,0,0.333333333333333
diphosphoric,1,12,4,8,0,0.5
forelliano,0,10,5,5,0,1
pretreats,1,9,3,6,0,0.5
naphlatie,0,9,4,5,0,0.8
raspatory,1,9,3,6,0,0.5
kxvvfizgvlowkxchjpxxrqg,0,23,2,21,0,0.0952380952380952
pillheals,0,9,3,6,0,0.5
anglophilism,0,12,4,8,0,0.5
mcgraw,1,6,1,5,0,0.2
endoptimonarrozzardom,0,21,8,13,0,0.615384615384615
predictor,1,9,3,6,0,0.5
savagely,1,8,3,5,0,0.6
customshouses,1,13,5,8,0,0.625
nonnationalism,1,14,6,8,0,0.75
rudenespintionitcra,0,19,8,11,0,0.727272727272727
clayback,0,8,2,6,0,0.333333333333333
thicterujaconeteve,0,18,8,10,0,0.8
asestricarthalbukhomtrus,0,24,8,16,0,0.5
bassoons,1,8,3,5,0,0.6
struction,1,9,3,6,0,0.5
shinza,1,6,2,4,0,0.5
medlines,0,8,3,5,0,0.6
pyrulas,0,7,2,5,0,0.4
coigapin,0,8,4,4,0,1
enhearted,0,9,4,5,0,0.8
tuwpxnvddwwc''fbng,0,18,1,17,2,0.0588235294117647
despose,1,7,3,4,0,0.75
jostlingspiel,0,13,4,9,0,0.444444444444444
tatorcethiwo,0,12,5,7,0,0.714285714285714
zephyranthes,1,12,3,9,0,0.333333333333333
torino,1,6,3,3,0,1
excity,0,6,2,4,0,0.5
boehmenite,1,10,5,5,0,1
dessepia,0,8,4,4,0,1
ker,1,3,1,2,0,0.5
curtainty,0,9,3,6,0,0.5
unvaguely,1,9,4,5,0,0.8
ichneumonoid,1,12,6,6,0,1
mycotic,1,7,2,5,0,0.4
transferregimenthocer,0,21,7,14,0,0.5
hepatotoxin,1,11,5,6,0,0.833333333333333
acric,0,5,2,3,0,0.666666666666667
rrnmhnc,0,7,0,7,0,0
oldiscism,0,9,3,6,0,0.5
melonmonger,1,11,4,7,0,0.571428571428571
thhnffyakunu'vdkelp'a,0,21,5,16,2,0.3125
maugressibilitiation,0,20,10,10,0,1
anastasius,1,10,5,5,0,1
novestrogarehothyla,0,19,7,12,0,0.583333333333333
ecurantaltionarreadielanermarchoochan,0,37,17,20,0,0.85
unblindie,0,9,4,5,0,0.8
monreal,1,7,3,4,0,0.75
anthiathia,1,10,5,5,0,1
subbeen,0,7,3,4,0,0.75
ranicateinforties,0,17,8,9,0,0.888888888888889
hylotheistic,1,12,4,8,0,0.5
hydrocirsocele,1,14,5,9,0,0.555555555555556
twkc,0,4,0,4,0,0
polies,1,6,3,3,0,1
mispickels,1,10,3,7,0,0.428571428571429
coprocessor,1,11,4,7,0,0.571428571428571
''weljxlymyl,0,12,1,11,2,0.0909090909090909
decomp,0,6,2,4,0,0.5
wibqvyqdmgjmakdpvvlmopka,0,24,4,20,0,0.2
semid,0,5,2,3,0,0.666666666666667
obscurative,1,11,5,6,0,0.833333333333333
kasolite,1,8,4,4,0,1
dinornithologic,0,15,6,9,0,0.666666666666667
bloodmobile,1,11,5,6,0,0.833333333333333
reinstitutors,0,13,5,8,0,0.625
hiral,0,5,2,3,0,0.666666666666667
fissidactyl,1,11,3,8,0,0.375
opiveinalerclololed,0,19,9,10,0,0.9
fordays,1,7,2,5,0,0.4
ventage,1,7,3,4,0,0.75
panjandrum,1,10,3,7,0,0.428571428571429
synagogic,0,9,3,6,0,0.5
colosalverbioncel,0,17,7,10,0,0.7
unpreparing,1,11,4,7,0,0.571428571428571
lacteal,1,7,3,4,0,0.75
calliperer,1,10,4,6,0,0.666666666666667
enigmatically,1,13,5,8,0,0.625
mlismitsolistoweeversed,0,23,9,14,0,0.642857142857143
passwords,1,9,2,7,0,0.285714285714286
onset,1,5,2,3,0,0.666666666666667
guaranaees,1,10,6,4,0,1.5
rectal,1,6,2,4,0,0.5
rosser,1,6,2,4,0,0.5
avowe,1,5,3,2,0,1.5
penniless,1,9,3,6,0,0.5
unjointerrez,0,12,5,7,0,0.714285714285714
tcvd,0,4,0,4,0,0
boogeniaceae,0,12,8,4,0,2
ancre,1,5,2,3,0,0.666666666666667
sonnette,0,8,3,5,0,0.6
tarzanishburn,0,13,4,9,0,0.444444444444444
simplication,0,12,5,7,0,0.714285714285714
dobela,0,6,3,3,0,1
astigmoscope,1,12,5,7,0,0.714285714285714
confesser,1,9,3,6,0,0.5
amphigenous,1,11,5,6,0,0.833333333333333
deportments,1,11,3,8,0,0.375
misjudger,1,9,3,6,0,0.5
cks,0,3,0,3,0,0
tomecollikedy,0,13,5,8,0,0.625
shaitan,1,7,3,4,0,0.75
saicial,0,7,4,3,0,1.33333333333333
winternations,0,13,5,8,0,0.625
avondale,1,8,4,4,0,1
reistiest,1,9,4,5,0,0.8
bouvies,0,7,4,3,0,1.33333333333333
russianist,1,10,4,6,0,0.666666666666667
pofleep,0,7,3,4,0,0.75
tipstaffs,1,9,2,7,0,0.285714285714286
tenovecabes,0,11,5,6,0,0.833333333333333
tetramorphism,1,13,4,9,0,0.444444444444444
coldbloodedness,1,15,5,10,0,0.5
kitengre,0,8,3,5,0,0.6
kwv'berqcq'gqjozfle'oqtcz,0,25,4,21,3,0.19047619047619
whipcordy,1,9,2,7,0,0.285714285714286
vousins,0,7,3,4,0,0.75
zzintitode,0,10,4,6,0,0.666666666666667
acroprin,0,8,3,5,0,0.6
meercato,0,8,4,4,0,1
pterian,1,7,3,4,0,0.75
undecarboardwoman,0,17,7,10,0,0.7
homeotherapy,1,12,5,7,0,0.714285714285714
inga,1,4,2,2,0,1
landtrachaudresby,0,17,5,12,0,0.416666666666667
hkkewatlpigx'rtuxh,0,18,4,14,1,0.285714285714286
anythingarian,1,13,5,8,0,0.625
north,1,5,1,4,0,0.25
ineiraness,0,10,5,5,0,1
compendick,0,10,3,7,0,0.428571428571429
acaridize,0,9,5,4,0,1.25
unkidnaped,1,10,4,6,0,0.666666666666667
ranomers,1,8,3,5,0,0.6
streetsboro,1,11,4,7,0,0.571428571428571
melitarboophaus,0,15,7,8,0,0.875
mesocephalon,1,12,5,7,0,0.714285714285714
weaseling,0,9,4,5,0,0.8
sacchuses,0,9,3,6,0,0.5
triostasy,0,9,3,6,0,0.5
avowal,1,6,3,3,0,1
buckrams,1,8,2,6,0,0.333333333333333
kotyttia,0,8,3,5,0,0.6
govoe,0,5,3,2,0,1.5
pentahedrous,1,12,5,7,0,0.714285714285714
lamellas,1,8,3,5,0,0.6
gigfenessalvers,0,15,5,10,0,0.5
goaly,0,5,2,3,0,0.666666666666667
tates,1,5,2,3,0,0.666666666666667
corke,0,5,2,3,0,0.666666666666667
shift,1,5,1,4,0,0.25
unhoops,1,7,3,4,0,0.75
befrill,1,7,2,5,0,0.4
harlemite,1,9,4,5,0,0.8
yeasty,1,6,2,4,0,0.5
huesca,1,6,3,3,0,1
mundungus,1,9,3,6,0,0.5
radiotelemeter,1,14,7,7,0,1
puckerel,1,8,3,5,0,0.6
eclog,0,5,2,3,0,0.666666666666667
eagted,0,6,3,3,0,1
mullane,1,7,3,4,0,0.75
himyaria,0,8,4,4,0,1
efdnvekmbavshwermocdcgs,0,23,5,18,0,0.277777777777778
apothes,0,7,3,4,0,0.75
obsignedly,0,10,3,7,0,0.428571428571429
bisyllabic,0,10,3,7,0,0.428571428571429
windrose,1,8,3,5,0,0.6
unforeknow,0,10,4,6,0,0.666666666666667
magnetically,1,12,4,8,0,0.5
mcfd,1,4,0,4,0,0
whirley,1,7,2,5,0,0.4
hopiessozo,0,10,5,5,0,1
asosannaska,0,11,5,6,0,0.833333333333333
unappableness,0,13,5,8,0,0.625
houbara,1,7,4,3,0,1.33333333333333
dkoeadnlvvunygkswbxwo,0,21,5,16,0,0.3125
terialytternel,0,14,5,9,0,0.555555555555556
llojekwsuf,0,10,3,7,0,0.428571428571429
kelebe,1,6,3,3,0,1
borobusphavereed,0,16,7,9,0,0.777777777777778
barret,1,6,2,4,0,0.5
solgohachia,1,11,5,6,0,0.833333333333333
variole,1,7,4,3,0,1.33333333333333
hhbpwmco,0,8,1,7,0,0.142857142857143
tirejectual,0,11,5,6,0,0.833333333333333
obtruncators,0,12,4,8,0,0.5
hemihypotonia,1,13,6,7,0,0.857142857142857
lexis,1,5,2,3,0,0.666666666666667
harod,1,5,2,3,0,0.666666666666667
bathegettingprisms,0,18,5,13,0,0.384615384615385
ottly,0,5,1,4,0,0.25
pitings,0,7,2,5,0,0.4
ceagstichy,0,10,3,7,0,0.428571428571429
sekeep,0,6,3,3,0,1
biennales,1,9,4,5,0,0.8
blotless,1,8,2,6,0,0.333333333333333
harium,0,6,3,3,0,1
unsexy,1,6,2,4,0,0.5
irous,1,5,3,2,0,1.5
ehpmyzldsgkmvsq'bflkkdhbbow,0,27,2,25,1,0.08
jsrbduk,0,7,1,6,0,0.166666666666667
jhdgxbrtxy,0,10,0,10,0,0
yhdnpkoj,0,8,1,7,0,0.142857142857143
fullbodied,1,10,4,6,0,0.666666666666667
coratin,0,7,3,4,0,0.75
voidness,1,8,3,5,0,0.6
nitionic,0,8,4,4,0,1
chelonid,1,8,3,5,0,0.6
fanker,0,6,2,4,0,0.5
inessine,0,8,4,4,0,1
spelunceasing,0,13,5,8,0,0.625
appendang,0,9,3,6,0,0.5
denhoff,1,7,2,5,0,0.4
carrelled,0,9,3,6,0,0.5
mvooqwwjiwgsb',0,14,3,11,1,0.272727272727273
onconfedership,0,14,5,9,0,0.555555555555556
yearly,1,6,2,4,0,0.5
jibouti,1,7,4,3,0,1.33333333333333
cersuleckins,0,12,4,8,0,0.5
gipsyfy,1,7,1,6,0,0.166666666666667
qk,0,2,0,2,0,0
nonmalarial,1,11,5,6,0,0.833333333333333
chring,0,6,1,5,0,0.2
ings,0,4,1,3,0,0.333333333333333
unlinesque,0,10,5,5,0,1
defacto,1,7,3,4,0,0.75
qugerapeabennoanis,0,18,9,9,0,1
schoolgirly,1,11,3,8,0,0.375
lachellem,0,9,3,6,0,0.5
gymnurine,1,9,3,6,0,0.5
bans,0,4,1,3,0,0.333333333333333
deposita,1,8,4,4,0,1
polywag,0,7,2,5,0,0.4
mentorship,1,10,3,7,0,0.428571428571429
cactuslike,1,10,4,6,0,0.666666666666667
'lxdhpwwzw,0,10,0,10,1,0
haakon,1,6,3,3,0,1
feeblish,1,8,3,5,0,0.6
monogrammatic,1,13,5,8,0,0.625
nervous,1,7,3,4,0,0.75
preeves,1,7,3,4,0,0.75
etwee,1,5,3,2,0,1.5
gainsayers,1,10,4,6,0,0.666666666666667
unenfoldnesses,0,14,5,9,0,0.555555555555556
patronatat,0,10,4,6,0,0.666666666666667
ualosuas,0,8,5,3,0,1.66666666666667
cull,1,4,1,3,0,0.333333333333333
bedrizzlingly,0,13,3,10,0,0.3
uncultlike,0,10,4,6,0,0.666666666666667
acrament,0,8,3,5,0,0.6
acceptabilities,1,15,7,8,0,0.875
cherish,1,7,2,5,0,0.4
resulted,1,8,3,5,0,0.6
proid,0,5,2,3,0,0.666666666666667
rhab,0,4,1,3,0,0.333333333333333
'mtdfh,0,6,0,6,1,0
soundtrack,1,10,3,7,0,0.428571428571429
chlorimetric,1,12,4,8,0,0.5
polid,0,5,2,3,0,0.666666666666667
counklystomility,0,16,5,11,0,0.454545454545455
'zydkwzpvkszlvccaxoylst,0,23,2,21,1,0.0952380952380952
spintexts,1,9,2,7,0,0.285714285714286
octarch,1,7,2,5,0,0.4
bosefe,0,6,3,3,0,1
poplarville,1,11,4,7,0,0.571428571428571
dithedulolelsiniomaqualy,0,24,11,13,0,0.846153846153846
proxenjugwes,0,12,4,8,0,0.5
roland,1,6,2,4,0,0.5
cagasviounniperptahatinilungloxis,0,33,14,19,0,0.736842105263158
neuropathidae,0,13,7,6,0,1.16666666666667
macradenous,1,11,5,6,0,0.833333333333333
inaccessibly,1,12,4,8,0,0.5
underspecified,1,14,6,8,0,0.75
amandibulare,0,12,6,6,0,1
unilluminatum,0,13,6,7,0,0.857142857142857
contentations,1,13,5,8,0,0.625
unmechanisational,0,17,8,9,0,0.888888888888889
procuration,1,11,5,6,0,0.833333333333333
unaltec,0,7,3,4,0,0.75
thedric,1,7,2,5,0,0.4
aburst,1,6,2,4,0,0.5
therly,0,6,1,5,0,0.2
adunistinhagelous,0,17,8,9,0,0.888888888888889
appointing,1,10,4,6,0,0.666666666666667
hauling,1,7,3,4,0,0.75
eyeopener,1,9,5,4,0,1.25
jxgxffrhqrquhjtwehxd',0,21,2,19,1,0.105263157894737
exchansitis,0,11,4,7,0,0.571428571428571
braquet,0,7,3,4,0,0.75
numerousness,1,12,5,7,0,0.714285714285714
harmonides,1,10,4,6,0,0.666666666666667
velicate,1,8,4,4,0,1
vmr,1,3,0,3,0,0
gatekeeper,1,10,5,5,0,1
qzvfrexlwwsdsmkcd'p,0,19,1,18,1,0.0555555555555556
unsheathering,0,13,5,8,0,0.625
unswam,0,6,2,4,0,0.5
outbending,1,10,4,6,0,0.666666666666667
hagiophyre,0,10,4,6,0,0.666666666666667
pissheathies,0,12,5,7,0,0.714285714285714
seatwork,1,8,3,5,0,0.6
traditionalist,1,14,6,8,0,0.75
baisefully,0,10,4,6,0,0.666666666666667
glynis,1,6,1,5,0,0.2
repurposivism,0,13,5,8,0,0.625
lazarette,1,9,4,5,0,0.8
cantrile,0,8,3,5,0,0.6
fis,0,3,1,2,0,0.5
pedicula,0,8,4,4,0,1
archmugwump,1,11,3,8,0,0.375
jzvw'rxzquyff'xdlzwc',0,21,1,20,3,0.05
mayanist,1,8,3,5,0,0.6
hurtful,0,7,2,5,0,0.4
ugaritic,1,8,4,4,0,1
tection,0,7,3,4,0,0.75
xanthes,0,7,2,5,0,0.4
bnzh,0,4,0,4,0,0
fishhooks,1,9,3,6,0,0.5
aserterocong,0,12,5,7,0,0.714285714285714
tenfutwsbi,0,10,3,7,0,0.428571428571429
certainest,1,10,4,6,0,0.666666666666667
reptomented,0,11,4,7,0,0.571428571428571
burghmoot,1,9,3,6,0,0.5
puirtith,1,8,3,5,0,0.6
telejournalist,1,14,6,8,0,0.75
anglomania,1,10,5,5,0,1
mattedly,1,8,2,6,0,0.333333333333333
dissecting,1,10,3,7,0,0.428571428571429
wauks,1,5,2,3,0,0.666666666666667
glycerol,1,8,2,6,0,0.333333333333333
thextojkzfvfnikowigizicrmh'kog,0,30,8,22,1,0.363636363636364
thantox,0,7,2,5,0,0.4
owidrfsianite,0,13,6,7,0,0.857142857142857
yiuhkucgqbeoqbh,0,15,5,10,0,0.5
collacty,0,8,2,6,0,0.333333333333333
antidictions,0,12,5,7,0,0.714285714285714
lacustral,1,9,3,6,0,0.5
semipash,0,8,3,5,0,0.6
shemu,1,5,2,3,0,0.666666666666667
prodrugs,1,8,2,6,0,0.333333333333333
tricyclic,1,9,2,7,0,0.285714285714286
deboner,1,7,3,4,0,0.75
cambridgeshire,1,14,5,9,0,0.555555555555556
exorgassing,0,11,4,7,0,0.571428571428571
warmonogenfrandron,0,18,6,12,0,0.5
overstorm,0,9,3,6,0,0.5
kotzebue,1,8,4,4,0,1
hooray,1,6,3,3,0,1
homies,1,6,3,3,0,1
tamented,0,8,3,5,0,0.6
ddnjom'mvxi',0,12,2,10,2,0.2
underbevelling,0,14,5,9,0,0.555555555555556
evando,0,6,3,3,0,1
phborivanovirc,0,14,5,9,0,0.555555555555556
unred,1,5,2,3,0,0.666666666666667
dikar,0,5,2,3,0,0.666666666666667
prowess,1,7,2,5,0,0.4
busters,1,7,2,5,0,0.4
ballou,1,6,3,3,0,1
crumblies,1,9,3,6,0,0.5
xray,1,4,1,3,0,0.333333333333333
tubalcain,1,9,4,5,0,0.8
luccal,0,6,2,4,0,0.5
kerbside,1,8,3,5,0,0.6
gobispospona,0,12,5,7,0,0.714285714285714
frisinters,0,10,3,7,0,0.428571428571429
clorine,0,7,3,4,0,0.75
privatdozent,1,12,4,8,0,0.5
flitter,1,7,2,5,0,0.4
parcellus,0,9,3,6,0,0.5
msotrin,0,7,2,5,0,0.4
promissvry,1,10,2,8,0,0.25
siliacquinest,0,13,6,7,0,0.857142857142857
bbovis,0,6,2,4,0,0.5
cufficationards,0,15,6,9,0,0.666666666666667
ne,0,2,1,1,0,1
cyanin,1,6,2,4,0,0.5
gloeosporium,1,12,6,6,0,1
nonexpugnescence,0,16,6,10,0,0.6
nondisposed,1,11,4,7,0,0.571428571428571
errakow,0,7,3,4,0,0.75
stroppy,1,7,1,6,0,0.166666666666667
helotism,1,8,3,5,0,0.6
clatineakyl,0,11,4,7,0,0.571428571428571
dh'hbkeqcsufbqeo,0,16,4,12,1,0.333333333333333
prelogic,1,8,3,5,0,0.6
bugbee,1,6,3,3,0,1
vcybdygwlxwc,0,12,0,12,0,0
thacker,1,7,2,5,0,0.4
pironomucogrmitleerphkins,0,25,9,16,0,0.5625
lyohrhs,0,7,1,6,0,0.166666666666667
gappering,0,9,3,6,0,0.5
cerpugalladeions,0,16,7,9,0,0.777777777777778
gavateris,0,9,4,5,0,0.8
oards,0,5,2,3,0,0.666666666666667
extraclassable,0,14,5,9,0,0.555555555555556
indishman,0,9,3,6,0,0.5
unquestion,0,10,5,5,0,1
synchysis,1,9,1,8,0,0.125
amerveil,1,8,4,4,0,1
thepw'agqbm'gbsqtjfwif,0,22,3,19,2,0.157894736842105
prgbbdhfazftauop',0,17,4,13,1,0.307692307692308
duits,1,5,2,3,0,0.666666666666667
eviteraphagnon,0,14,6,8,0,0.75
homoblastic,1,11,4,7,0,0.571428571428571
landfolk,1,8,2,6,0,0.333333333333333
bestubbornness,0,14,4,10,0,0.4
curser,1,6,2,4,0,0.5
roulebraistic,0,13,6,7,0,0.857142857142857
bolshevisms,1,11,3,8,0,0.375
olnizvkorho,0,11,4,7,0,0.571428571428571
rwfeverhindwscxhpfxix,0,21,4,17,0,0.235294117647059
aquemiaced,0,10,6,4,0,1.5
diactin,1,7,3,4,0,0.75
preventionable,0,14,6,8,0,0.75
circumjovial,1,12,5,7,0,0.714285714285714
redivides,1,9,4,5,0,0.8
swingletrees,1,12,4,8,0,0.5
misdealing,1,10,4,6,0,0.666666666666667
darklier,1,8,3,5,0,0.6
avgazillaenadverlestate,0,23,10,13,0,0.769230769230769
cptdapnmejp,0,11,2,9,0,0.222222222222222
bimillennial,1,12,5,7,0,0.714285714285714
gobiesox,1,8,4,4,0,1
anise,1,5,3,2,0,1.5
bvisp,0,5,1,4,0,0.25
detestation,1,11,5,6,0,0.833333333333333
shophalottes,0,12,4,8,0,0.5
damia,1,5,3,2,0,1.5
hrfdig,0,6,1,5,0,0.2
colatoring,0,10,4,6,0,0.666666666666667
dapocaomiaphryicutinoiadone,0,27,14,13,0,1.07692307692308
pelermstamenfiverinrandecscerel,0,31,11,20,0,0.55
roarer,1,6,3,3,0,1
perkinson,0,9,3,6,0,0.5
ratiocinative,1,13,7,6,0,1.16666666666667
exscutellate,1,12,5,7,0,0.714285714285714
vavykpnpwctfcw,0,14,1,13,0,0.0769230769230769
empleaches,1,10,4,6,0,0.666666666666667
illworks,0,8,2,6,0,0.333333333333333
uskdar,1,6,2,4,0,0.5
lostangles,0,10,3,7,0,0.428571428571429
rediversion,1,11,5,6,0,0.833333333333333
wfuzxubmtviisi'uaxhcgniofcqva,0,29,10,19,1,0.526315789473684
sensigenous,1,11,5,6,0,0.833333333333333
photohistance,0,13,5,8,0,0.625
v'clhcnaeagsajkzrduqc,0,21,5,16,1,0.3125
shallowpate,1,11,4,7,0,0.571428571428571
sovereignize,1,12,6,6,0,1
polygraphed,1,11,3,8,0,0.375
gilud,1,5,2,3,0,0.666666666666667
yhflcedwvyminsvpcdcwculv,0,24,3,21,0,0.142857142857143
superduper,1,10,4,6,0,0.666666666666667
tawnya,1,6,2,4,0,0.5
bluestone,1,9,4,5,0,0.8
indentures,1,10,4,6,0,0.666666666666667
laryssa,1,7,2,5,0,0.4
miswrought,1,10,3,7,0,0.428571428571429
i'mmtmrqrbxixcbk,0,16,2,14,1,0.142857142857143
phal,0,4,1,3,0,0.333333333333333
kreinne,0,7,3,4,0,0.75
chumship,1,8,2,6,0,0.333333333333333
eucyl,0,5,2,3,0,0.666666666666667
oniby,0,5,2,3,0,0.666666666666667
bolsterwork,1,11,3,8,0,0.375
overdependent,1,13,5,8,0,0.625
hyperaccurately,1,15,5,10,0,0.5
bosbzhzzktawnpqpesa,0,19,4,15,0,0.266666666666667
xericised,0,9,4,5,0,0.8
domestication,1,13,6,7,0,0.857142857142857
tjywilnacltqbaldbzwxtmopx,0,25,4,21,0,0.19047619047619
zinged,1,6,2,4,0,0.5
meacomvarouneraralperitst,0,25,11,14,0,0.785714285714286
wnqpitbdwhy,0,11,1,10,0,0.1
chomsky,1,7,1,6,0,0.166666666666667
patd,1,4,1,3,0,0.333333333333333
intercommunicably,0,17,6,11,0,0.545454545454545
grinner,1,7,2,5,0,0.4
contesiegin,0,11,5,6,0,0.833333333333333
quaesitum,1,9,5,4,0,1.25
corridor,1,8,3,5,0,0.6
action,1,6,3,3,0,1
gomeral,1,7,3,4,0,0.75
bometriornsicoghereluide,0,24,11,13,0,0.846153846153846
raphiang,0,8,3,5,0,0.6
zoosporangiophore,1,17,8,9,0,0.888888888888889
bandalousness,0,13,5,8,0,0.625
catamaran,1,9,4,5,0,0.8
randentart,0,10,3,7,0,0.428571428571429
wichoops,0,8,3,5,0,0.6
recessionary,1,12,5,7,0,0.714285714285714
redeless,1,8,3,5,0,0.6
pinterestable,0,13,5,8,0,0.625
deco,1,4,2,2,0,1
harian,0,6,3,3,0,1
gnarled,1,7,2,5,0,0.4
canaried,1,8,4,4,0,1
platycercus,1,11,3,8,0,0.375
lapopettropamiaplila,0,20,9,11,0,0.818181818181818
ehlnoi,0,6,3,3,0,1
prooflessly,1,11,3,8,0,0.375
pflugerville,1,12,4,8,0,0.5
corruging,0,9,3,6,0,0.5
dionysia,1,8,4,4,0,1
petary,1,6,2,4,0,0.5
milksoppishness,1,15,4,11,0,0.363636363636364
mzqjazwajwis'ofs,0,16,4,12,1,0.333333333333333
pareses,1,7,3,4,0,0.75
pondas,0,6,2,4,0,0.5
atkin,0,5,2,3,0,0.666666666666667
cohepshipply,0,12,3,9,0,0.333333333333333
ovillus,1,7,3,4,0,0.75
blowdown,1,8,2,6,0,0.333333333333333
limewatered,0,11,5,6,0,0.833333333333333
olefin,1,6,3,3,0,1
limbryngeliableness,0,19,6,13,0,0.461538461538462
budgeted,1,8,3,5,0,0.6
feinterpassiope,0,15,7,8,0,0.875
octoate,1,7,4,3,0,1.33333333333333
stromboli,1,9,3,6,0,0.5
sassanian,1,9,4,5,0,0.8
collists,0,8,2,6,0,0.333333333333333
wfrlymueremgylcocmcqafuuvluprc,0,30,8,22,0,0.363636363636364
faizabad,1,8,4,4,0,1
seir,1,4,2,2,0,1
manian,0,6,3,3,0,1
bharkowntron,0,12,3,9,0,0.333333333333333
adamsville,1,10,4,6,0,0.666666666666667
prosynthesial,0,13,4,9,0,0.444444444444444
livelines,0,9,4,5,0,0.8
dwarfy,1,6,1,5,0,0.2
cantonisations,1,14,6,8,0,0.75
ter,0,3,1,2,0,0.5
vaponder,0,8,3,5,0,0.6
lus,0,3,1,2,0,0.5
storminesses,1,12,4,8,0,0.5
submarket,1,9,3,6,0,0.5
reworashess,0,11,4,7,0,0.571428571428571
schizognathism,1,14,4,10,0,0.4
subclavicle,0,11,4,7,0,0.571428571428571
poranteron,0,10,4,6,0,0.666666666666667
dilatantnessembriform,0,21,7,14,0,0.5
dps,1,3,0,3,0,0
eucopepoda,1,10,6,4,0,1.5
jxfdutlmspnjx,0,13,1,12,0,0.0833333333333333
deified,1,7,4,3,0,1.33333333333333
riflery,1,7,2,5,0,0.4
snacking,1,8,2,6,0,0.333333333333333
snuff,1,5,1,4,0,0.25
pointillist,1,11,4,7,0,0.571428571428571
sinaupinuatiniagai,0,18,11,7,0,1.57142857142857
arteritist,0,10,4,6,0,0.666666666666667
proirrigations,0,14,6,8,0,0.75
nudum,1,5,2,3,0,0.666666666666667
zpojzlzmrry,0,11,1,10,0,0.1
iwl'bhrquvskncipt,0,17,3,14,1,0.214285714285714
plastidular,1,11,4,7,0,0.571428571428571
eutaxy,1,6,3,3,0,1
stylers,1,7,1,6,0,0.166666666666667
stroddles,1,9,2,7,0,0.285714285714286
muslin,1,6,2,4,0,0.5
hordarian,1,9,4,5,0,0.8
bioblastic,1,10,4,6,0,0.666666666666667
coeliotomy,1,10,5,5,0,1
novelheads,0,10,4,6,0,0.666666666666667
nobilitated,1,11,5,6,0,0.833333333333333
counterprove,1,12,5,7,0,0.714285714285714
nums,0,4,1,3,0,0.333333333333333
puddles,1,7,2,5,0,0.4
gklh,0,4,0,4,0,0
colyer,1,6,2,4,0,0.5
perovsk,0,7,2,5,0,0.4
hast,0,4,1,3,0,0.333333333333333
tessidifitrisesdelted,0,21,8,13,0,0.615384615384615
georgettes,1,10,4,6,0,0.666666666666667
sparsioplast,1,12,4,8,0,0.5
waveless,1,8,3,5,0,0.6
recondisobar,0,12,5,7,0,0.714285714285714
satteringum,0,11,4,7,0,0.571428571428571
zjpkdvcnypbupmwwvy,0,18,1,17,0,0.0588235294117647
needles,1,7,3,4,0,0.75
incantando,0,10,4,6,0,0.666666666666667
porayxuledenclurchasere,0,23,9,14,0,0.642857142857143
unperilously,1,12,5,7,0,0.714285714285714
nekrasov,1,8,3,5,0,0.6
neverthelater,1,13,5,8,0,0.625
codirectionisms,0,15,6,9,0,0.666666666666667
ketuvim,1,7,3,4,0,0.75
imbricellar,0,11,4,7,0,0.571428571428571
kraaitl'lqv'bhmmu,0,17,4,13,2,0.307692307692308
coreeritipid,0,12,6,6,0,1
narratory,1,9,3,6,0,0.5
nontaxation,0,11,5,6,0,0.833333333333333
surveyings,1,10,3,7,0,0.428571428571429
bostwickelium,0,13,5,8,0,0.625
hubshi,1,6,2,4,0,0.5
scon,0,4,1,3,0,0.333333333333333
immunohedron,0,12,5,7,0,0.714285714285714
cosine,1,6,3,3,0,1
fyvktltmklrvfjkdfuv,0,19,1,18,0,0.0555555555555556
rowdily,1,7,2,5,0,0.4
implantersville,0,15,5,10,0,0.5
odintonqusahave,0,15,7,8,0,0.875
antonymous,1,10,4,6,0,0.666666666666667
trancelebrats,0,13,4,9,0,0.444444444444444
dehuths,0,7,2,5,0,0.4
ssus,0,4,1,3,0,0.333333333333333
postmoderance,0,13,5,8,0,0.625
waresboro,1,9,4,5,0,0.8
halalling,1,9,3,6,0,0.5
landahl,1,7,2,5,0,0.4
imed,0,4,2,2,0,1
calaba,1,6,3,3,0,1
skomeshyhhivevenextaghoounce,0,28,11,17,0,0.647058823529412
superfluousness,1,15,6,9,0,0.666666666666667
deraconclentris,0,15,5,10,0,0.5
rheumatologist,1,14,6,8,0,0.75
cyromorphioalism,0,16,6,10,0,0.6
bghjw,0,5,0,5,0,0
saintliterances,0,15,6,9,0,0.666666666666667
cataclasticisms,0,15,5,10,0,0.5
unjoinable,1,10,5,5,0,1
anvinaroblelunee,0,16,8,8,0,1
cruzannexisternal,0,17,6,11,0,0.545454545454545
weldin,0,6,2,4,0,0.5
colonette,1,9,4,5,0,0.8
bthu'jceziobl,0,13,4,9,1,0.444444444444444
coffelain,0,9,4,5,0,0.8
quarterdeckers,1,14,5,9,0,0.555555555555556
peddlery,1,8,2,6,0,0.333333333333333
bacteroi,0,8,4,4,0,1
bouet,1,5,3,2,0,1.5
entificality,0,12,5,7,0,0.714285714285714
mendequiong,0,11,5,6,0,0.833333333333333
gutsizes,0,8,3,5,0,0.6
xpzs'lmee,0,9,2,7,1,0.285714285714286
leveridge,1,9,4,5,0,0.8
chukcheeshed,0,12,4,8,0,0.5
androscopehood,0,14,6,8,0,0.75
lubec,1,5,2,3,0,0.666666666666667
autonomy,1,8,4,4,0,1
fimbaean,0,8,4,4,0,1
interling,0,9,3,6,0,0.5
soruscicular,0,12,5,7,0,0.714285714285714
roberval,1,8,3,5,0,0.6
phyte,0,5,1,4,0,0.25
redevelopers,1,12,5,7,0,0.714285714285714
beggardom,1,9,3,6,0,0.5
veringbonessent,0,15,5,10,0,0.5
poorlier,1,8,4,4,0,1
ematint,0,7,3,4,0,0.75
saunt,0,5,2,3,0,0.666666666666667
mongeau,1,7,4,3,0,1.33333333333333
rxd,0,3,0,3,0,0
twintosis,0,9,3,6,0,0.5
reenlisted,1,10,4,6,0,0.666666666666667
reparradless,0,12,4,8,0,0.5
hugeousnesses,1,13,6,7,0,0.857142857142857
ully,0,4,1,3,0,0.333333333333333
refractors,1,10,3,7,0,0.428571428571429
unrichartoolite,0,15,7,8,0,0.875
parisianisation,1,15,8,7,0,1.14285714285714
shortney,0,8,2,6,0,0.333333333333333
jpmpxsctngjnsfvui,0,17,2,15,0,0.133333333333333
sciatherically,1,14,5,9,0,0.555555555555556
buenave,0,7,4,3,0,1.33333333333333
ctrtichepurden,0,14,4,10,0,0.4
flirting,1,8,2,6,0,0.333333333333333
forthoscopic,0,12,4,8,0,0.5
unwaggably,1,10,3,7,0,0.428571428571429
resourcefulness,1,15,6,9,0,0.666666666666667
sopapillas,1,10,4,6,0,0.666666666666667
jaments,0,7,2,5,0,0.4
replacement,1,11,4,7,0,0.571428571428571
repletenesses,1,13,5,8,0,0.625
nonsuppressively,1,16,5,11,0,0.454545454545455
secondees,1,9,4,5,0,0.8
d'oynczhhzavmr,0,14,2,12,1,0.166666666666667
unmomentously,1,13,5,8,0,0.625
packed,1,6,2,4,0,0.5
obsessiveness,1,13,5,8,0,0.625
perfectural,0,11,4,7,0,0.571428571428571
anisol,1,6,3,3,0,1
narwhales,1,9,3,6,0,0.5
immissions,1,10,4,6,0,0.666666666666667
curassow,1,8,3,5,0,0.6
gyps,1,4,0,4,0,0
aceous,0,6,4,2,0,2
presuffer,1,9,3,6,0,0.5
paitricy,0,8,3,5,0,0.6
unmenontiftillerrehemetessed,0,28,11,17,0,0.647058823529412
unsundivistorinax,0,17,7,10,0,0.7
garciasville,1,12,5,7,0,0.714285714285714
smockingbird,0,12,3,9,0,0.333333333333333
topcoaster,0,10,4,6,0,0.666666666666667
quillon,1,7,3,4,0,0.75
evif'eppyue'awhuuzhhzo,0,22,9,13,2,0.692307692307692
devonic,1,7,3,4,0,0.75
ryswick,1,7,1,6,0,0.166666666666667
multis,0,6,2,4,0,0.5
alehoof,1,7,4,3,0,1.33333333333333
shlytes,0,7,1,6,0,0.166666666666667
geriveysvilysuddess,0,19,6,13,0,0.461538461538462
appendicalgia,1,13,6,7,0,0.857142857142857
alleycats,1,9,3,6,0,0.5
winkinvol,0,9,3,6,0,0.5
interlockianism,0,15,6,9,0,0.666666666666667
angelodynas,0,11,4,7,0,0.571428571428571
wsqunterenosho,0,14,5,9,0,0.555555555555556
tintoapecrinos,0,14,6,8,0,0.75
amniomancy,1,10,4,6,0,0.666666666666667
sprinchoke,0,10,3,7,0,0.428571428571429
iytqzpuk'ct'czkyyqkcdzscvvh,0,27,2,25,2,0.08
deflexicosborthic,0,17,6,11,0,0.545454545454545
achloxeness,0,11,4,7,0,0.571428571428571
joutaphyrgazoiseurizinglutiotistenna,0,36,16,20,0,0.8
exar,0,4,2,2,0,1
volplanines,0,11,4,7,0,0.571428571428571
protectivisection,0,17,7,10,0,0.7
irreparatory,0,12,5,7,0,0.714285714285714
condor,1,6,2,4,0,0.5
myelinisations,1,14,6,8,0,0.75
kshiodivid,0,10,4,6,0,0.666666666666667
splenanage,0,10,4,6,0,0.666666666666667
citynesses,1,10,3,7,0,0.428571428571429
carruthers,1,10,3,7,0,0.428571428571429
phalans,0,7,2,5,0,0.4
kucmewjqu'vnjrbu,0,16,4,12,1,0.333333333333333
factoidal,1,9,4,5,0,0.8
consultantships,1,15,4,11,0,0.363636363636364
polder,1,6,2,4,0,0.5
bolosieriekinan,0,15,8,7,0,1.14285714285714
medressing,0,10,3,7,0,0.428571428571429
attainabilities,1,15,8,7,0,1.14285714285714
hydrobilirubin,1,14,5,9,0,0.555555555555556
speakings,1,9,3,6,0,0.5
minist,0,6,2,4,0,0.5
rhousia,0,7,4,3,0,1.33333333333333
hebrists,0,8,2,6,0,0.333333333333333
odal,1,4,2,2,0,1
icakenpacin,0,11,5,6,0,0.833333333333333
stencies,0,8,3,5,0,0.6
psychosymptuosaurinyles,0,23,7,16,0,0.4375
aylin,0,5,2,3,0,0.666666666666667
reascension,1,11,5,6,0,0.833333333333333
monobtu,0,7,3,4,0,0.75
seleucidean,1,11,6,5,0,1.2
witza,0,5,2,3,0,0.666666666666667
cruzados,1,8,3,5,0,0.6
mxmnyadfowwe'hx,0,15,3,12,1,0.25
vgcgvllxj,0,9,0,9,0,0
ixb'xvqxhior,0,12,3,9,1,0.333333333333333
melinis,1,7,3,4,0,0.75
canmaker,1,8,3,5,0,0.6
nitromethanes,1,13,5,8,0,0.625
kincobs,1,7,2,5,0,0.4
rackles,0,7,2,5,0,0.4
yelm'zcyfdx,0,11,1,10,1,0.1
multiprotodecomparedness,0,24,9,15,0,0.6
genticlimbiners,0,15,5,10,0,0.5
moraceous,1,9,5,4,0,1.25
veromous,0,8,4,4,0,1
antecell,1,8,3,5,0,0.6
picted,0,6,2,4,0,0.5
b'toj,0,5,1,4,1,0.25
phe,0,3,1,2,0,0.5
cheesemaking,1,12,5,7,0,0.714285714285714
extraordinaire,1,14,7,7,0,1
acoadvolari,0,11,6,5,0,1.2
antidomestic,1,12,5,7,0,0.714285714285714
jarrell,1,7,2,5,0,0.4
trisyllabical,1,13,4,9,0,0.444444444444444
transnationality,0,16,6,10,0,0.6
begicoperopplateri,0,18,8,10,0,0.8
laparocolpohysterophytes,0,24,8,16,0,0.5
noncompulsion,0,13,5,8,0,0.625
predriving,1,10,3,7,0,0.428571428571429
ifmud'jjikfv,0,12,3,9,1,0.333333333333333
photogenic,1,10,4,6,0,0.666666666666667
snowdonia,1,9,4,5,0,0.8
electrodialitic,1,15,7,8,0,0.875
hynnukagnifor,0,13,4,9,0,0.444444444444444
moltiostin,0,10,4,6,0,0.666666666666667
eucatropine,1,11,6,5,0,1.2
alits,0,5,2,3,0,0.666666666666667
autoprothesis,1,13,6,7,0,0.857142857142857
nelleumed,0,9,4,5,0,0.8
dixies,1,6,3,3,0,1
pandra,0,6,2,4,0,0.5
ianswast,0,8,3,5,0,0.6
nelson,1,6,2,4,0,0.5
live,1,4,2,2,0,1
broupbqlduthcr,0,14,3,11,0,0.272727272727273
hujsak,1,6,2,4,0,0.5
guacho,1,6,3,3,0,1
lectate,0,7,3,4,0,0.75
guidonian,1,9,5,4,0,1.25
hawkey,1,6,2,4,0,0.5
lidatict,0,8,3,5,0,0.6
mszjpidqswnxsc,0,14,1,13,0,0.0769230769230769
grouteco,0,8,4,4,0,1
lavalike,1,8,4,4,0,1
viscovities,0,11,5,6,0,0.833333333333333
mearstone,1,9,4,5,0,0.8
yorkers,1,7,2,5,0,0.4
scroungings,1,11,3,8,0,0.375
nematocera,1,10,5,5,0,1
gutierrez,1,9,4,5,0,0.8
huska,0,5,2,3,0,0.666666666666667
stumpline,0,9,3,6,0,0.5
ziszf,0,5,1,4,0,0.25
myeloplax,1,9,3,6,0,0.5
eforphypocethagharmamitistriatoman,0,34,13,21,0,0.619047619047619
leukoses,1,8,4,4,0,1
caboclo,1,7,3,4,0,0.75
ka,1,2,1,1,0,1
asida,0,5,3,2,0,1.5
skimobile,1,9,4,5,0,0.8
utaenieyravionogys,0,18,9,9,0,1
saponaceousness,1,15,7,8,0,0.875
euryphage,1,9,4,5,0,0.8
plans,1,5,1,4,0,0.25
malgonomies,0,11,5,6,0,0.833333333333333
greastwort,0,10,3,7,0,0.428571428571429
deliverabilities,1,16,8,8,0,1
blizz,1,5,1,4,0,0.25
fib,1,3,1,2,0,0.5
tarrhogically,0,13,4,9,0,0.444444444444444
ffelstthy,0,9,1,8,0,0.125
smelterman,1,10,3,7,0,0.428571428571429
urentiaticatin,0,14,7,7,0,1
postrace,1,8,3,5,0,0.6
fortunes,1,8,3,5,0,0.6
egomilium,0,9,5,4,0,1.25
lipunialy,0,9,4,5,0,0.8
cladophylls,1,11,2,9,0,0.222222222222222
salimetric,1,10,4,6,0,0.666666666666667
schanse,1,7,2,5,0,0.4
spireoro,0,8,4,4,0,1
lous,0,4,2,2,0,1
lampus,0,6,2,4,0,0.5
antiparagraphed,0,15,6,9,0,0.666666666666667
hindoo,1,6,3,3,0,1
eyeshadow,1,9,4,5,0,0.8
theicia,0,7,4,3,0,1.33333333333333
prosh,0,5,1,4,0,0.25
coffed,1,6,2,4,0,0.5
superfunctional,1,15,6,9,0,0.666666666666667
dvssjjlnpmhnzdkee'jz,0,20,2,18,1,0.111111111111111
martingly,0,9,2,7,0,0.285714285714286
chickerer,0,9,3,6,0,0.5
unornamentally,1,14,5,9,0,0.555555555555556
quleussms,0,9,3,6,0,0.5
indyer,0,6,2,4,0,0.5
interrog,1,8,3,5,0,0.6
embarrate,0,9,4,5,0,0.8
antipsychonomic,0,15,5,10,0,0.5
qophs,1,5,1,4,0,0.25
vgildishorkibriencorber,0,23,8,15,0,0.533333333333333
lidie,1,5,3,2,0,1.5
taungthu,1,8,3,5,0,0.6
commier,0,7,3,4,0,0.75
helvellic,1,9,3,6,0,0.5
hotomushchings,0,14,4,10,0,0.4
sloka,0,5,2,3,0,0.666666666666667
co'eqllbfgmtv'oyhhhhpxyi,0,24,4,20,2,0.2
arthria,0,7,3,4,0,0.75
iur,0,3,2,1,0,2
lugube,0,6,3,3,0,1
infalled,0,8,3,5,0,0.6
sceatt,1,6,2,4,0,0.5
oira,1,4,3,1,0,3
htrshzwjvpweblmmxuwqcv,0,22,2,20,0,0.1
paitrick,1,8,3,5,0,0.6
corniplier,0,10,4,6,0,0.666666666666667
princelike,1,10,4,6,0,0.666666666666667
latea,1,5,3,2,0,1.5
anging,0,6,2,4,0,0.5
monotoned,1,9,4,5,0,0.8
hiadmspenidiemquenphis,0,22,9,13,0,0.692307692307692
calliopsis,1,10,4,6,0,0.666666666666667
rosion,0,6,3,3,0,1
hickmankingness,0,15,4,11,0,0.363636363636364
missonerrate,0,12,5,7,0,0.714285714285714
hypsister,0,9,2,7,0,0.285714285714286
paregoric,1,9,4,5,0,0.8
loon,0,4,2,2,0,1
isidore,1,7,4,3,0,1.33333333333333
skyjacked,1,9,2,7,0,0.285714285714286
cys,0,3,0,3,0,0
ferriage,1,8,4,4,0,1
uchee,1,5,3,2,0,1.5
cnacterefordmins,0,16,5,11,0,0.454545454545455
povertagerackitale,0,18,8,10,0,0.8
sandpapers,1,10,3,7,0,0.428571428571429
undershapen,1,11,4,7,0,0.571428571428571
thermanist,0,10,3,7,0,0.428571428571429
advisorily,1,10,4,6,0,0.666666666666667
undersetting,1,12,4,8,0,0.5
chondrofetal,1,12,4,8,0,0.5
wondeladue,0,10,5,5,0,1
superphysicalness,1,17,5,12,0,0.416666666666667
nonradiographic,0,15,6,9,0,0.666666666666667
superadaptation,0,15,7,8,0,0.875
riveliphing,0,11,4,7,0,0.571428571428571
diapecalytenalorito,0,19,9,10,0,0.9
onwa,0,4,2,2,0,1
tomoleonwovily,0,14,6,8,0,0.75
bifughthalcote,0,14,5,9,0,0.555555555555556
bergh,1,5,1,4,0,0.25
myoclonal,0,9,3,6,0,0.5
pwxhlabwtkbkbjbkpqdf,0,20,1,19,0,0.0526315789473684
snoopers,1,8,3,5,0,0.6
toeshoe,1,7,4,3,0,1.33333333333333
spinnakers,1,10,3,7,0,0.428571428571429
overlubricating,1,15,6,9,0,0.666666666666667
cadomaerqus,0,11,5,6,0,0.833333333333333
galogis,0,7,3,4,0,0.75
naturalize,0,10,5,5,0,1
trichel,0,7,2,5,0,0.4
zingiberaceae,1,13,7,6,0,1.16666666666667
multimes,0,8,3,5,0,0.6
wickup,1,6,2,4,0,0.5
tarsalia,1,8,4,4,0,1
dewpoints,1,9,3,6,0,0.5
brooncer,0,8,3,5,0,0.6
azygobranchiata,1,15,6,9,0,0.666666666666667
emous,0,5,3,2,0,1.5
monotus,0,7,3,4,0,0.75
adducible,1,9,4,5,0,0.8
hypothetising,1,13,4,9,0,0.444444444444444
adoniad,1,7,4,3,0,1.33333333333333
naive,1,5,3,2,0,1.5
yojuana,0,7,4,3,0,1.33333333333333
northupite,1,10,4,6,0,0.666666666666667
assail,0,6,3,3,0,1
yxdxjqxljnlrbtonrdbfko,0,22,2,20,0,0.1
effervescing,1,12,4,8,0,0.5
asce,0,4,2,2,0,1
ericolin,1,8,4,4,0,1
opposingly,1,10,3,7,0,0.428571428571429
karyosoma,1,9,4,5,0,0.8
tao,1,3,2,1,0,2
postincarnation,1,15,6,9,0,0.666666666666667
w''lvzsjupulwjlmkf,0,18,2,16,2,0.125
pitahayas,1,9,4,5,0,0.8
forfeitable,1,11,5,6,0,0.833333333333333
inhort,0,6,2,4,0,0.5
barnhard,1,8,2,6,0,0.333333333333333
istalsocronsisnaressm,0,21,7,14,0,0.5
blackington,1,11,3,8,0,0.375
cambrian,1,8,3,5,0,0.6
kaigrtlzgsjlwelmpeazujghavox,0,28,8,20,0,0.4
nuldettuconstenscuny,0,20,6,14,0,0.428571428571429
alminitrollo,0,12,5,7,0,0.714285714285714
deattributed,1,12,5,7,0,0.714285714285714
labiovelarises,0,14,7,7,0,1
hopkinsonite,0,12,5,7,0,0.714285714285714
prodramatic,1,11,4,7,0,0.571428571428571
bejkzeuzklro,0,12,4,8,0,0.5
phalaeostratus,0,14,6,8,0,0.75
ujljzbimhvzahiupudbxcajmow,0,26,8,18,0,0.444444444444444
epigynum,1,8,3,5,0,0.6
tentings,1,8,2,6,0,0.333333333333333
davir,0,5,2,3,0,0.666666666666667
castanian,1,9,4,5,0,0.8
voltina,0,7,3,4,0,0.75
mudtrack,1,8,2,6,0,0.333333333333333
tlzev,0,5,1,4,0,0.25
tarmacolous,0,11,5,6,0,0.833333333333333
onomatopoieses,1,14,8,6,0,1.33333333333333
wifeship,1,8,3,5,0,0.6
eurymede,1,8,4,4,0,1
precommit,1,9,3,6,0,0.5
ilen,0,4,2,2,0,1
nonliquefiability,0,17,8,9,0,0.888888888888889
multifactorial,1,14,6,8,0,0.75
molinary,1,8,3,5,0,0.6
nerolyphornne,0,13,4,9,0,0.444444444444444
inturbidated,1,12,5,7,0,0.714285714285714
demotivism,0,10,4,6,0,0.666666666666667
galeerineous,0,12,7,5,0,1.4
superadministrator,1,18,7,11,0,0.636363636363636
conting,0,7,2,5,0,0.4
rajshahi,1,8,3,5,0,0.6
acenaphthylaminoethylimnetical,0,30,11,19,0,0.578947368421053
teler,0,5,2,3,0,0.666666666666667
planispherical,1,14,5,9,0,0.555555555555556
autopilot,1,9,5,4,0,1.25
obloquina,0,9,5,4,0,1.25
potamophilous,1,13,6,7,0,0.857142857142857
haidendesnjuleslicisicatal,0,26,11,15,0,0.733333333333333
hophinocapabhons,0,16,6,10,0,0.6
macanture,0,9,4,5,0,0.8
dessication,1,11,5,6,0,0.833333333333333
abonnement,1,10,4,6,0,0.666666666666667
xcaxrgtjfixyx,0,13,2,11,0,0.181818181818182
candolle,1,8,3,5,0,0.6
panhedgins,0,10,3,7,0,0.428571428571429
mistouche,0,9,4,5,0,0.8
cumberland,1,10,3,7,0,0.428571428571429
staginally,0,10,3,7,0,0.428571428571429
misaddrest,1,10,3,7,0,0.428571428571429
archarnecontive,0,15,6,9,0,0.666666666666667
anterofixation,1,14,7,7,0,1
capernoite,0,10,5,5,0,1
moodys,1,6,2,4,0,0.5
operagoings,1,11,5,6,0,0.833333333333333
devonite,1,8,4,4,0,1
shin,0,4,1,3,0,0.333333333333333
coas,0,4,2,2,0,1
sappiest,1,8,3,5,0,0.6
baryngolity,0,11,3,8,0,0.375
lamellibranchiata,1,17,7,10,0,0.7
nifedipine,1,10,5,5,0,1
macraucheniidae,1,15,8,7,0,1.14285714285714
glassine,1,8,3,5,0,0.6
photos,0,6,2,4,0,0.5
secroimmelies,0,13,6,7,0,0.857142857142857
cyanogenic,1,10,4,6,0,0.666666666666667
piezometer,1,10,5,5,0,1
awjmkljtfodbsvwplklha'fsc,0,25,3,22,1,0.136363636363636
untimentally,0,12,4,8,0,0.5
zkn'lmyshcxxyntaa,0,17,2,15,1,0.133333333333333
bement,1,6,2,4,0,0.5
paaraphimosis,1,13,6,7,0,0.857142857142857
slaught,0,7,2,5,0,0.4
deithounbebflarigly,0,19,7,12,0,0.583333333333333
fenite,1,6,3,3,0,1
atest,0,5,2,3,0,0.666666666666667
vandie,0,6,3,3,0,1
prople,0,6,2,4,0,0.5
qlqtjvlhtjasfjwbd'wcj,0,21,1,20,1,0.05
occupancies,1,11,5,6,0,0.833333333333333
viander,1,7,3,4,0,0.75
vibrayheadla,0,12,5,7,0,0.714285714285714
notic,0,5,2,3,0,0.666666666666667
garryover,0,9,3,6,0,0.5
brodecons,0,9,3,6,0,0.5
crouches,1,8,3,5,0,0.6
scucuadronous,0,13,6,7,0,0.857142857142857
omphalic,1,8,3,5,0,0.6
essnaftiones,0,12,5,7,0,0.714285714285714
anona,1,5,3,2,0,1.5
ncet,0,4,1,3,0,0.333333333333333
keeperships,1,11,4,7,0,0.571428571428571
homoean,1,7,4,3,0,1.33333333333333
leaching,1,8,3,5,0,0.6
carnotto,0,8,3,5,0,0.6
grabiant,0,8,3,5,0,0.6
sser,0,4,1,3,0,0.333333333333333
madigan,1,7,3,4,0,0.75
unsnugness,1,10,3,7,0,0.428571428571429
ungitatnes,0,10,4,6,0,0.666666666666667
lolium,1,6,3,3,0,1
krn'moxk,0,8,1,7,1,0.142857142857143
steloonwite,0,11,5,6,0,0.833333333333333
maya,1,4,2,2,0,1
staining,1,8,3,5,0,0.6
cordialness,1,11,4,7,0,0.571428571428571
malvin,1,6,2,4,0,0.5
aquellatopogoned,0,16,8,8,0,1
epiky,1,5,2,3,0,0.666666666666667
jssecrhxkpneljfaadjlqyphryaur,0,29,6,23,0,0.260869565217391
strophyld,0,9,1,8,0,0.125
dau,1,3,2,1,0,2
feringowle,0,10,4,6,0,0.666666666666667
berms,1,5,1,4,0,0.25
corporativist,1,13,5,8,0,0.625
tracontisms,0,11,3,8,0,0.375
acadoer,0,7,4,3,0,1.33333333333333
ufarantion,0,10,5,5,0,1
nebrous,0,7,3,4,0,0.75
oui,1,3,3,0,0,1
postform,1,8,2,6,0,0.333333333333333
semindemusioness,0,16,7,9,0,0.777777777777778
autolatries,1,11,6,5,0,1.2
proabolite,0,10,5,5,0,1
innatian,0,8,4,4,0,1
exceptor,1,8,3,5,0,0.6
amphibology,1,11,4,7,0,0.571428571428571
bgrxndqxfxbimpdw'vuulhdmjbs,0,27,3,24,1,0.125
polychrestical,1,14,4,10,0,0.4
hydrosulphide,1,13,4,9,0,0.444444444444444
onbfzgxbjpoxv,0,13,2,11,0,0.181818181818182
salvationist,1,12,5,7,0,0.714285714285714
doritarianissimos,0,17,8,9,0,0.888888888888889
tmdrqwjupienltbxcqw,0,19,3,16,0,0.1875
sevhrgcqqsmakhqzkstebstr,0,24,3,21,0,0.142857142857143
crockford,1,9,2,7,0,0.285714285714286
'd,0,2,0,2,1,0
munroe,1,6,3,3,0,1
muscaring,0,9,3,6,0,0.5
sinfighte,0,9,3,6,0,0.5
chromicise,1,10,4,6,0,0.666666666666667
infeoffs,1,8,3,5,0,0.6
ovorhomboidal,1,13,6,7,0,0.857142857142857
vivistylest,0,11,3,8,0,0.375
insvilla,0,8,3,5,0,0.6
corrodible,1,10,4,6,0,0.666666666666667
gastroenterology,1,16,6,10,0,0.6
allan,1,5,2,3,0,0.666666666666667
lulie,1,5,3,2,0,1.5
lytton,1,6,1,5,0,0.2
vimiiu,0,6,4,2,0,2
atelognathia,1,12,6,6,0,1
fring,0,5,1,4,0,0.25
citrulline,1,10,4,6,0,0.666666666666667
reconciliator,1,13,6,7,0,0.857142857142857
gracular,0,8,3,5,0,0.6
lzxoocduxqzzefz',0,16,4,12,1,0.333333333333333
ssaromivalesecovinyad,0,21,9,12,0,0.75
admerveils,0,10,4,6,0,0.666666666666667
ygwvokrgntkffaxzgekrqf,0,22,3,19,0,0.157894736842105
sordellina,1,10,4,6,0,0.666666666666667
bacelesuliltrzatansketthonede,0,29,11,18,0,0.611111111111111
mpis,0,4,1,3,0,0.333333333333333
skreepeddle,0,11,4,7,0,0.571428571428571
palaestrical,1,12,5,7,0,0.714285714285714
olethea,1,7,4,3,0,1.33333333333333
lfsqrcjibcrpkuievxinzf,0,22,5,17,0,0.294117647058824
unchrisomloosing,0,16,6,10,0,0.6
bendis,0,6,2,4,0,0.5
anncygiccoisala,0,15,6,9,0,0.666666666666667
glycombina,0,10,3,7,0,0.428571428571429
asolobic,0,8,4,4,0,1
hormogoneales,1,13,6,7,0,0.857142857142857
anteriorly,1,10,4,6,0,0.666666666666667
coxwainings,0,11,4,7,0,0.571428571428571
petitionarily,1,13,6,7,0,0.857142857142857
shammas,1,7,2,5,0,0.4
photoproteid,0,12,5,7,0,0.714285714285714
occasionalness,1,14,6,8,0,0.75
saucerized,1,10,5,5,0,1
superspeculation,1,16,7,9,0,0.777777777777778
source,1,6,3,3,0,1
zigeuner,1,8,4,4,0,1
counteres,0,9,4,5,0,0.8
schweitzer,1,10,3,7,0,0.428571428571429
asepticises,1,11,5,6,0,0.833333333333333
premolossingerlings,0,19,6,13,0,0.461538461538462
pagehood,1,8,4,4,0,1
ojdfovzavpswqjgeima,0,19,6,13,0,0.461538461538462
pacorro,1,7,3,4,0,0.75
dracaenaceae,1,12,7,5,0,1.4
curictinsenessednes,0,19,7,12,0,0.583333333333333
polyribonuclease,0,16,7,9,0,0.777777777777778
proly,0,5,1,4,0,0.25
litui,1,5,3,2,0,1.5
connoisseur,1,11,5,6,0,0.833333333333333
tubuliporidae,1,13,7,6,0,1.16666666666667
compassy,0,8,2,6,0,0.333333333333333
evangelised,1,11,5,6,0,0.833333333333333
shadrach,1,8,2,6,0,0.333333333333333
callomes,0,8,3,5,0,0.6
brateribracade,0,14,6,8,0,0.75
nasandjajar,0,11,4,7,0,0.571428571428571
fqlovrzs,0,8,1,7,0,0.142857142857143
napier,1,6,3,3,0,1
krhrnux'ughv,0,12,2,10,1,0.2
revoted,1,7,3,4,0,0.75
flukinesses,1,11,4,7,0,0.571428571428571
phemorgrollials,0,15,5,10,0,0.5
woonoctepecockfink,0,18,7,11,0,0.636363636363636
bereavementing,0,14,6,8,0,0.75
laureless,0,9,4,5,0,0.8
dxdqmqyamcqkslipxcix,0,20,3,17,0,0.176470588235294
poursuitts,1,10,4,6,0,0.666666666666667
bayload,0,7,3,4,0,0.75
ovolactovegetarian,1,18,9,9,0,1
conospotrionoshalogelynjarratia,0,31,13,18,0,0.722222222222222
vaguity,1,7,3,4,0,0.75
alodian,1,7,4,3,0,1.33333333333333
causticisation,1,14,7,7,0,1
electronidae,0,12,6,6,0,1
cohabitabilities,0,16,8,8,0,1
minimalities,1,12,6,6,0,1
kareendorsale,0,13,6,7,0,0.857142857142857
saraceous,0,9,5,4,0,1.25
narigareellermolezar,0,20,9,11,0,0.818181818181818
kamila,1,6,3,3,0,1
ces,0,3,1,2,0,0.5
lipper,1,6,2,4,0,0.5
isometegistimos,0,15,7,8,0,0.875
imbiber,1,7,3,4,0,0.75
sustain,1,7,3,4,0,0.75
tufalike,1,8,4,4,0,1
diobolons,1,9,4,5,0,0.8
fureadetid,0,10,5,5,0,1
stylohyoid,1,10,3,7,0,0.428571428571429
acritan,0,7,3,4,0,0.75
fragmentates,1,12,4,8,0,0.5
theatrophones,1,13,5,8,0,0.625
nintendinitus,1,13,5,8,0,0.625
gitaga,0,6,3,3,0,1
corterlinure,0,12,5,7,0,0.714285714285714
marbling,1,8,2,6,0,0.333333333333333
deulemas,0,8,4,4,0,1
pentaiodid,0,10,5,5,0,1
subcastilessness,0,16,5,11,0,0.454545454545455
wearced,0,7,3,4,0,0.75
ophiuridae,1,10,6,4,0,1.5
limnoria,1,8,4,4,0,1
nonades,0,7,3,4,0,0.75
meteoropathologic,1,17,8,9,0,0.888888888888889
llagia,0,6,3,3,0,1
fi',0,3,1,2,1,0.5
retrospective,1,13,5,8,0,0.625
pudgiest,1,8,3,5,0,0.6
swivicedly,0,10,3,7,0,0.428571428571429
grope,1,5,2,3,0,0.666666666666667
falun,1,5,2,3,0,0.666666666666667
trippler,1,8,2,6,0,0.333333333333333
noncloisterers,0,14,5,9,0,0.555555555555556
hydrophobe,1,10,3,7,0,0.428571428571429
misnamine,0,9,4,5,0,0.8
'uyejoq,0,7,3,4,1,0.75
kmsfyhysna,0,10,1,9,0,0.111111111111111
fscuhjmc,0,8,1,7,0,0.142857142857143
fance,0,5,2,3,0,0.666666666666667
concertification,0,16,7,9,0,0.777777777777778
exosemonger,0,11,5,6,0,0.833333333333333
nwwjosdpazyetq,0,14,3,11,0,0.272727272727273
elopers,1,7,3,4,0,0.75
megaphone,1,9,4,5,0,0.8
ax'ibmhywgoxc,0,13,3,10,1,0.3
bousness,0,8,3,5,0,0.6
eurottoura,0,10,6,4,0,1.5
udella,1,6,3,3,0,1
suborbitary,1,11,4,7,0,0.571428571428571
realcher,0,8,3,5,0,0.6
xrofbwngjdswjjzmzy,0,18,1,17,0,0.0588235294117647
desmodus,1,8,3,5,0,0.6
oaxonambrolinsted,0,17,7,10,0,0.7
lavallating,0,11,4,7,0,0.571428571428571
gadsburg,0,8,2,6,0,0.333333333333333
slakable,1,8,3,5,0,0.6
panino,1,6,3,3,0,1
interlike,0,9,4,5,0,0.8
phic,0,4,1,3,0,0.333333333333333
hig,0,3,1,2,0,0.5
orihyperbola,1,12,5,7,0,0.714285714285714
irremedited,0,11,5,6,0,0.833333333333333
tulsa,1,5,2,3,0,0.666666666666667
nose,1,4,2,2,0,1
snesdner,0,8,2,6,0,0.333333333333333
presavagery,1,11,4,7,0,0.571428571428571
abbottstown,1,11,3,8,0,0.375
creviced,1,8,3,5,0,0.6
seeress,1,7,3,4,0,0.75
sardina,1,7,3,4,0,0.75
ulishicog,0,9,4,5,0,0.8
paphism,0,7,2,5,0,0.4
renoticed,1,9,4,5,0,0.8
kalapooia,1,9,6,3,0,2
rox,1,3,1,2,0,0.5
ampmakian,0,9,4,5,0,0.8
copatriarchy,0,12,4,8,0,0.5
glatarcherandiatefuslae,0,23,10,13,0,0.769230769230769
rainteeness,0,11,5,6,0,0.833333333333333
hodoscope,1,9,4,5,0,0.8
colonist,1,8,3,5,0,0.6
varna,1,5,2,3,0,0.666666666666667
decolourant,1,11,5,6,0,0.833333333333333
mosagiatal,0,10,5,5,0,1
lenwicking,0,10,3,7,0,0.428571428571429
esrhyiwe,0,8,3,5,0,0.6
uncomerinclistic,0,16,6,10,0,0.6
dable,0,5,2,3,0,0.666666666666667
jabberwockies,1,13,5,8,0,0.625
nocustes,0,8,3,5,0,0.6
gemmulations,1,12,5,7,0,0.714285714285714
tawdriness,1,10,3,7,0,0.428571428571429
wgkipoeyjtc,0,11,3,8,0,0.375
opportunenesses,1,15,6,9,0,0.666666666666667
lapoparantionvolatersh,0,22,9,13,0,0.692307692307692
fips,1,4,1,3,0,0.333333333333333
unburg,0,6,2,4,0,0.5
roegumptional,0,13,6,7,0,0.857142857142857
oxlands,1,7,2,5,0,0.4
prostheses,1,10,3,7,0,0.428571428571429
coprolite,1,9,4,5,0,0.8
vggxpphzlusfbczrw,0,17,1,16,0,0.0625
woodpile,1,8,4,4,0,1
ramulous,1,8,4,4,0,1
mesometable,0,11,5,6,0,0.833333333333333
titivations,1,11,5,6,0,0.833333333333333
caboanugge,0,10,5,5,0,1
embryopathology,1,15,5,10,0,0.5
orientisation,1,13,7,6,0,1.16666666666667
nebulation,1,10,5,5,0,1
craighle,1,8,3,5,0,0.6
privation,1,9,4,5,0,0.8
kolacca,0,7,3,4,0,0.75
ulioteteeaphiflancalupe,0,23,12,11,0,1.09090909090909
fraughtily,0,10,3,7,0,0.428571428571429
manchuria,1,9,4,5,0,0.8
overhead,1,8,4,4,0,1
mollusively,0,11,4,7,0,0.571428571428571
pearce,1,6,3,3,0,1
immunoglobulin,1,14,6,8,0,0.75
polystyrene,1,11,3,8,0,0.375
dictyosomers,0,12,4,8,0,0.5
agisteste,0,9,4,5,0,0.8
scaldini,1,8,3,5,0,0.6
oberosteus,0,10,5,5,0,1
assessor,1,8,3,5,0,0.6
arrivance,1,9,4,5,0,0.8
papiliosphere,0,13,6,7,0,0.857142857142857
oephrlyfx,0,9,2,7,0,0.285714285714286
photometrists,1,13,4,9,0,0.444444444444444
leptodactylus,1,13,4,9,0,0.444444444444444
esbatement,1,10,4,6,0,0.666666666666667
phototaxes,1,10,4,6,0,0.666666666666667
energesis,1,9,4,5,0,0.8
bacchanalias,1,12,5,7,0,0.714285714285714
ciellism,0,8,3,5,0,0.6
jacobaea,1,8,5,3,0,1.66666666666667
laryngectomee,1,13,5,8,0,0.625
exactnesses,1,11,4,7,0,0.571428571428571
prospection,1,11,4,7,0,0.571428571428571
fsyd'nqxyclcjknm,0,16,0,16,1,0
endocrinidae,0,12,6,6,0,1
pnqmha'muoxwzekrshc,0,19,4,15,1,0.266666666666667
fiess,0,5,2,3,0,0.666666666666667
juahhtxhopau,0,12,5,7,0,0.714285714285714
pernod,1,6,2,4,0,0.5
dusiniurnellinesses,0,19,8,11,0,0.727272727272727
triploidize,0,11,5,6,0,0.833333333333333
piegan,1,6,3,3,0,1
gewurztramineous,0,16,7,9,0,0.777777777777778
coagment,1,8,3,5,0,0.6
currier,1,7,3,4,0,0.75
fossilisk,0,9,3,6,0,0.5
fabulously,1,10,4,6,0,0.666666666666667
alexiphanic,0,11,5,6,0,0.833333333333333
unmultiplicable,1,15,6,9,0,0.666666666666667
gauma,0,5,3,2,0,1.5
ntares,0,6,2,4,0,0.5
taiwanimalcula,0,14,7,7,0,1
permafros,0,9,3,6,0,0.5
arthritic,1,9,3,6,0,0.5
urspractic,0,10,3,7,0,0.428571428571429
yaphies,0,7,3,4,0,0.75
daniella,1,8,4,4,0,1
trosky,1,6,1,5,0,0.2
overprepares,1,12,5,7,0,0.714285714285714
platitudinised,1,14,6,8,0,0.75
nn,0,2,0,2,0,0
mrknpilzhgcrx'bjorcwxfedcmlk,0,28,3,25,1,0.12
desvill,0,7,2,5,0,0.4
recoderliemattisheridgetic,0,26,11,15,0,0.733333333333333
outbreathiest,0,13,6,7,0,0.857142857142857
qvgzkshsqmlozbemkp,0,18,2,16,0,0.125
plficcamicstelel,0,16,5,11,0,0.454545454545455
stateswomen,1,11,4,7,0,0.571428571428571
unincorporatedness,1,18,7,11,0,0.636363636363636
channes,0,7,2,5,0,0.4
gnerinurivibelthouncopognthystas,0,32,11,21,0,0.523809523809524
splanchnotomical,1,16,5,11,0,0.454545454545455
paeh'ddlellpuhyc,0,16,4,12,1,0.333333333333333
atfalati,1,8,4,4,0,1
sauntines,0,9,4,5,0,0.8
sunrego,0,7,3,4,0,0.75
iualsosrgmd,0,11,4,7,0,0.571428571428571
epopoeias,1,9,6,3,0,2
desilverises,1,12,5,7,0,0.714285714285714
atisins,0,7,3,4,0,0.75
redistricting,1,13,4,9,0,0.444444444444444
july,1,4,1,3,0,0.333333333333333
batista,1,7,3,4,0,0.75
tangi,1,5,2,3,0,0.666666666666667
anthropopathically,1,18,6,12,0,0.5
uioraras,0,8,5,3,0,1.66666666666667
nvihzzbdpfpyw,0,13,1,12,0,0.0833333333333333
x'khuzaztl,0,10,2,8,1,0.25
dwvjqclt'ewfkchuqkgdpcmr,0,24,2,22,1,0.0909090909090909
napier,1,6,3,3,0,1
srkp,0,4,0,4,0,0
supervigilance,1,14,6,8,0,0.75
bibliomale,0,10,5,5,0,1
hoeurpertoliteramad,0,19,9,10,0,0.9
gaseousnesses,1,13,6,7,0,0.857142857142857
refong,0,6,2,4,0,0.5
phenylalanine,1,13,5,8,0,0.625
irsyyqmnusjscnhrqeymux,0,22,4,18,0,0.222222222222222
embiidae,1,8,5,3,0,1.66666666666667
kosuaaqeyhxmx,0,13,5,8,0,0.625
solway,1,6,2,4,0,0.5
shoeing,1,7,3,4,0,0.75
pancreatectomies,1,16,7,9,0,0.777777777777778
ardussi,1,7,3,4,0,0.75
occipital,1,9,4,5,0,0.8
cemethedsorioranans,0,19,8,11,0,0.727272727272727
rastrums,1,8,2,6,0,0.333333333333333
hyricilocer,0,11,4,7,0,0.571428571428571
peacheritables,0,14,6,8,0,0.75
ferriolabeg,0,11,5,6,0,0.833333333333333
lyomeri,1,7,3,4,0,0.75
teinoids,0,8,4,4,0,1
bargepole,1,9,4,5,0,0.8
trxkveoktpquhip,0,15,4,11,0,0.363636363636364
clessbulan,0,10,3,7,0,0.428571428571429
''',0,3,0,3,3,0
euclidean,1,9,5,4,0,1.25
magnetohydrodynamics,1,20,6,14,0,0.428571428571429
aortomalaxis,1,12,6,6,0,1
meshuggenahs,1,12,4,8,0,0.5
chloroiodide,1,12,6,6,0,1
peesweeps,1,9,4,5,0,0.8
aerotriodissotrophagidae,0,24,12,12,0,1
coquillage,1,10,5,5,0,1
hnavzuajanhzmaakshzzlerd,0,24,7,17,0,0.411764705882353
boo,1,3,2,1,0,2
sabbatha,0,8,3,5,0,0.6
ledwmdcizk,0,10,2,8,0,0.25
lignified,1,9,4,5,0,0.8
dovenoronpphromohontlyprhyplaracor,0,34,10,24,0,0.416666666666667
ereed,0,5,3,2,0,1.5
hydronautic,0,11,4,7,0,0.571428571428571
tesler,1,6,2,4,0,0.5
jubilatio,1,9,5,4,0,1.25
hydrosera,0,9,3,6,0,0.5
chrya,0,5,1,4,0,0.25
ecalcography,0,12,4,8,0,0.5
enistelly,0,9,3,6,0,0.5
playlengtonia,0,13,5,8,0,0.625
pepsi,1,5,2,3,0,0.666666666666667
digestibilities,1,15,7,8,0,0.875
isoaminiles,1,11,6,5,0,1.2
disillusionised,1,15,7,8,0,0.875
xmfrinqsc,0,9,1,8,0,0.125
includes,1,8,3,5,0,0.6
randie,1,6,3,3,0,1
rearanging,1,10,4,6,0,0.666666666666667
erlohe,0,6,3,3,0,1
unprovocation,0,13,6,7,0,0.857142857142857
wojtyla,1,7,2,5,0,0.4
abu,1,3,2,1,0,2
gewixwgqjvsoj,0,13,3,10,0,0.3
archartist,1,10,3,7,0,0.428571428571429
audy,1,4,2,2,0,1
neronedrifaerog,0,15,7,8,0,0.875
dolerites,0,9,4,5,0,0.8
eghfqfzssmso,0,12,2,10,0,0.2
fluidally,1,9,3,6,0,0.5
privacation,0,11,5,6,0,0.833333333333333
mutrachouthic,0,13,5,8,0,0.625
trussataticatol,0,15,6,9,0,0.666666666666667
helsinki,1,8,3,5,0,0.6
carcased,1,8,3,5,0,0.6
schoolboy,1,9,3,6,0,0.5
nccytiqps,0,9,1,8,0,0.125
otion,0,5,3,2,0,1.5
redig,1,5,2,3,0,0.666666666666667
dispersale,0,10,4,6,0,0.666666666666667
jfugpbtrr'ukzmqxslsfydtz',0,25,2,23,2,0.0869565217391304
avergedor,0,9,4,5,0,0.8
fzzqbnvjkpgdfgcpavrpcxvhptewj,0,29,2,27,0,0.0740740740740741
zoarces,1,7,3,4,0,0.75
langsettle,1,10,3,7,0,0.428571428571429
omdurman,1,8,3,5,0,0.6
mzegbpgfp'zs,0,12,1,11,1,0.0909090909090909
jyscycvvmi,0,10,1,9,0,0.111111111111111
palle,0,5,2,3,0,0.666666666666667
podostemaceous,1,14,7,7,0,1
porticularing,0,13,5,8,0,0.625
ster,0,4,1,3,0,0.333333333333333
discordable,1,11,4,7,0,0.571428571428571
cryoanaesthesia,1,15,7,8,0,0.875
oilcamps,1,8,3,5,0,0.6
shopkeeperta,0,12,5,7,0,0.714285714285714
diae,0,4,3,1,0,3
aeroembolism,1,12,6,6,0,1
iydwkrmsmuhaursuwpcv,0,20,5,15,0,0.333333333333333
blowpate,0,8,3,5,0,0.6
e'iveiawnulirlsakn,0,18,8,10,1,0.8
swaggishnesses,0,14,4,10,0,0.4
ptyas,1,5,1,4,0,0.25
perstringement,1,14,4,10,0,0.4
palindromic,1,11,4,7,0,0.571428571428571
smallens,1,8,2,6,0,0.333333333333333
disinvites,1,10,4,6,0,0.666666666666667
disfleewoodlesophia,0,19,9,10,0,0.9
criollas,1,8,3,5,0,0.6
corporacy,1,9,3,6,0,0.5
knize,0,5,2,3,0,0.666666666666667
ingulfment,1,10,3,7,0,0.428571428571429
xfmreumgfbh,0,11,2,9,0,0.222222222222222
uncess,0,6,2,4,0,0.5
simor,0,5,2,3,0,0.666666666666667
centrosome,1,10,4,6,0,0.666666666666667
triculek,0,8,3,5,0,0.6
remagnetizing,1,13,5,8,0,0.625
embrave,1,7,3,4,0,0.75
creaght,1,7,2,5,0,0.4
reinvolving,1,11,4,7,0,0.571428571428571
microgramma,1,11,4,7,0,0.571428571428571
disconanthae,1,12,5,7,0,0.714285714285714
neilah,1,6,3,3,0,1
uncanvassed,1,11,4,7,0,0.571428571428571
autocoprophagist,0,16,7,9,0,0.777777777777778
irehpbnycsjnfvqkzotdzqykjei,0,27,5,22,0,0.227272727272727
foxichincen,0,11,4,7,0,0.571428571428571
peshastin,1,9,3,6,0,0.5
lqsyhjgrthufpqxe,0,16,2,14,0,0.142857142857143
caledeeideutteriimbreglehodestinnated,0,37,17,20,0,0.85
ogregea,0,7,4,3,0,1.33333333333333
quinins,1,7,3,4,0,0.75
whenituddle,0,11,4,7,0,0.571428571428571
hiessoconpy,0,11,4,7,0,0.571428571428571
jadktnffciv,0,11,2,9,0,0.222222222222222
tebhellate,0,10,4,6,0,0.666666666666667
nkgnpwbbhlo,0,11,1,10,0,0.1
fibber,1,6,2,4,0,0.5
breadstick,1,10,3,7,0,0.428571428571429
burke,1,5,2,3,0,0.666666666666667
ytsmi''hrvu,0,11,2,9,2,0.222222222222222
immaculacy,1,10,4,6,0,0.666666666666667
oosporous,1,9,5,4,0,1.25
normanna,1,8,3,5,0,0.6
curiosity,1,9,4,5,0,0.8
nuttishness,0,11,3,8,0,0.375
alexantheism,0,12,5,7,0,0.714285714285714
oversimplifying,1,15,5,10,0,0.5
fkerobd,0,7,2,5,0,0.4
donzels,1,7,2,5,0,0.4
corporifer,0,10,4,6,0,0.666666666666667
overbit,1,7,3,4,0,0.75
donutridisters,0,14,5,9,0,0.555555555555556
exhum,0,5,2,3,0,0.666666666666667
patrizia,1,8,4,4,0,1
arillodes,1,9,4,5,0,0.8
proidacatemnochrisillattrainzlemiding,0,37,14,23,0,0.608695652173913
undegenerate,1,12,6,6,0,1
shrimpers,1,9,2,7,0,0.285714285714286
cupfulfid,0,9,3,6,0,0.5
mosby,1,5,1,4,0,0.25
penetral,1,8,3,5,0,0.6
ggvwosrbomowzfdvhn,0,18,3,15,0,0.2
zanesville,1,10,4,6,0,0.666666666666667
amaryllis,1,9,3,6,0,0.5
wingate,1,7,3,4,0,0.75
nicadore,0,8,4,4,0,1
revendicated,1,12,5,7,0,0.714285714285714
coppente,0,8,3,5,0,0.6
riflery,1,7,2,5,0,0.4
'myvnaanqykwzsv'jxhgzgmqwrb,0,27,2,25,2,0.08
runtgenographic,1,15,5,10,0,0.5
nondistractingly,1,16,4,12,0,0.333333333333333
obezomatoryza,0,13,6,7,0,0.857142857142857
elytrorhagia,1,12,5,7,0,0.714285714285714
peirability,0,11,5,6,0,0.833333333333333
gowdspinnatipartialed,0,21,8,13,0,0.615384615384615
cudontoxicalematachromes,0,24,10,14,0,0.714285714285714
consonantalize,1,14,6,8,0,0.75
dist,0,4,1,3,0,0.333333333333333
myrarfis,0,8,2,6,0,0.333333333333333
bblylalle,0,9,2,7,0,0.285714285714286
jarousnes,0,9,4,5,0,0.8
spadassin,1,9,3,6,0,0.5
forus,0,5,2,3,0,0.666666666666667
cat'll,0,6,1,5,1,0.2
prospectivism,0,13,4,9,0,0.444444444444444
jiffs,1,5,1,4,0,0.25
jellylikeness,1,13,4,9,0,0.444444444444444
kikawaeo,1,8,5,3,0,1.66666666666667
picturised,1,10,4,6,0,0.666666666666667
briareum,0,8,4,4,0,1
cerrises,1,8,3,5,0,0.6
pepsinia,0,8,4,4,0,1
bristolville,1,12,4,8,0,0.5
limonism,0,8,3,5,0,0.6
sirloiny,1,8,3,5,0,0.6
iozf,0,4,2,2,0,1
rovanilla,0,9,4,5,0,0.8
valises,1,7,3,4,0,0.75
juxtapositive,1,13,6,7,0,0.857142857142857
canisters,1,9,3,6,0,0.5
crocodile,1,9,4,5,0,0.8
hyozo,1,5,2,3,0,0.666666666666667
byrnes,1,6,1,5,0,0.2
unmoralise,1,10,5,5,0,1
kippie,1,6,3,3,0,1
promatrologrammatous,0,20,8,12,0,0.666666666666667
hydrophilistinesses,0,19,6,13,0,0.461538461538462
hirty,0,5,1,4,0,0.25
antility,0,8,3,5,0,0.6
sesamoids,1,9,4,5,0,0.8
peculaternightstolsters,0,23,7,16,0,0.4375
ykxdlgjtchezft,0,14,1,13,0,0.0769230769230769
preaconty,0,9,3,6,0,0.5
repars,0,6,2,4,0,0.5
chromograph,1,11,3,8,0,0.375
comanche,1,8,3,5,0,0.6
bundaberg,1,9,3,6,0,0.5
thor,1,4,1,3,0,0.333333333333333
trigonum,1,8,3,5,0,0.6
roontorin,0,9,4,5,0,0.8
synkinesis,1,10,3,7,0,0.428571428571429
toque,1,5,3,2,0,1.5
psitymnishipin,0,14,4,10,0,0.4
ctuzvokseji',0,12,4,8,1,0.5
technostructures,1,16,5,11,0,0.454545454545455
quillaism,0,9,4,5,0,0.8
disharmoniphone,0,15,6,9,0,0.666666666666667
openheartednesses,1,17,7,10,0,0.7
llovera,1,7,3,4,0,0.75
nabak,1,5,2,3,0,0.666666666666667
uasgqejhdtgkokmvpq'dpa,0,22,5,17,1,0.294117647058824
gbhonfayfmtzpecm,0,16,3,13,0,0.230769230769231
butions,0,7,3,4,0,0.75
theric,0,6,2,4,0,0.5
walcessity,0,10,3,7,0,0.428571428571429
ebenistes,1,9,4,5,0,0.8
ulerid,0,6,3,3,0,1
suva,1,4,2,2,0,1
felichthyses,0,12,3,9,0,0.333333333333333
eugh,1,4,2,2,0,1
sandgrouses,1,11,4,7,0,0.571428571428571
dusty,1,5,1,4,0,0.25
constative,1,10,4,6,0,0.666666666666667
flecher,0,7,2,5,0,0.4
auridal,0,7,4,3,0,1.33333333333333
virgouleuse,1,11,6,5,0,1.2
spumones,1,8,3,5,0,0.6
prass,0,5,1,4,0,0.25
ophidae,0,7,4,3,0,1.33333333333333
muttonwood,1,10,4,6,0,0.666666666666667
maroc,1,5,2,3,0,0.666666666666667
mesigible,0,9,4,5,0,0.8
aypfmk,0,6,1,5,0,0.2
upe,0,3,2,1,0,2
indemia,0,7,4,3,0,1.33333333333333
vertoscopes,1,11,4,7,0,0.571428571428571
mosidderyloxemermodeld,0,22,8,14,0,0.571428571428571
kittan,0,6,2,4,0,0.5
ijussioning,0,11,5,6,0,0.833333333333333
superacute,1,10,5,5,0,1
jfyuyfj'ppewm,0,13,2,11,1,0.181818181818182
langshan,1,8,2,6,0,0.333333333333333
subm,0,4,1,3,0,0.333333333333333
inappreciably,1,13,5,8,0,0.625
ribonucleoline,0,14,7,7,0,1
qsvoa'ciloobmrqsjuvb,0,20,6,14,1,0.428571428571429
virgina,1,7,3,4,0,0.75
krigia,1,6,3,3,0,1
cockbell,1,8,2,6,0,0.333333333333333
oxyluciferae,0,12,6,6,0,1
railingly,1,9,3,6,0,0.5
welladvisedly,0,13,4,9,0,0.444444444444444
unte,0,4,2,2,0,1
tuperoubring,0,12,5,7,0,0.714285714285714
ionizers,1,8,4,4,0,1
stidiumely,0,10,4,6,0,0.666666666666667
leiden,1,6,3,3,0,1
anabaptist,1,10,4,6,0,0.666666666666667
ufsdgjrsyrqplvny,0,16,1,15,0,0.0666666666666667
excambing,1,9,3,6,0,0.5
redeclined,1,10,4,6,0,0.666666666666667
apodemus,1,8,4,4,0,1
houseparent,1,11,5,6,0,0.833333333333333
cheverel,1,8,3,5,0,0.6
mucisic,0,7,3,4,0,0.75
kirantionary,0,12,5,7,0,0.714285714285714
rwivkhhnhjlck,0,13,1,12,0,0.0833333333333333
gabel,1,5,2,3,0,0.666666666666667
sublus,0,6,2,4,0,0.5
overextremis,0,12,5,7,0,0.714285714285714
riskiness,1,9,3,6,0,0.5
aleural,0,7,4,3,0,1.33333333333333
flatton,0,7,2,5,0,0.4
daeaft,0,6,3,3,0,1
galactised,0,10,4,6,0,0.666666666666667
sysatrophary,0,12,3,9,0,0.333333333333333
lateness,1,8,3,5,0,0.6
pxqz'cunptsmmssfyfa,0,19,2,17,1,0.117647058823529
casts,1,5,1,4,0,0.25
unlimbec,0,8,3,5,0,0.6
vinitvey,0,8,3,5,0,0.6
rehook,1,6,3,3,0,1
unfricative,1,11,5,6,0,0.833333333333333
ammists,0,7,2,5,0,0.4
rewrite,1,7,3,4,0,0.75
loras,0,5,2,3,0,0.666666666666667
corrhine,0,8,3,5,0,0.6
deutonymphal,1,12,4,8,0,0.5
qmw'omdyvbc,0,11,1,10,1,0.1
usumdum,0,7,3,4,0,0.75
conflecterachee,0,15,6,9,0,0.666666666666667
basticiseneching,0,16,6,10,0,0.6
excerptibility,0,14,5,9,0,0.555555555555556
treadventur,0,11,4,7,0,0.571428571428571
electangentle,0,13,5,8,0,0.625
incandescency,1,13,4,9,0,0.444444444444444
wbgitnuiahdicqlyjvzxqit,0,23,6,17,0,0.352941176470588
deely,0,5,2,3,0,0.666666666666667
brandice,1,8,3,5,0,0.6
semisirque,1,10,5,5,0,1
linguistries,1,12,5,7,0,0.714285714285714
pole,1,4,2,2,0,1
addax,1,5,2,3,0,0.666666666666667
fameuse,1,7,4,3,0,1.33333333333333
toge,0,4,2,2,0,1
entoprocta,1,10,4,6,0,0.666666666666667
hintevanlabuntysemutts,0,22,7,15,0,0.466666666666667
fachdubcokle,0,12,4,8,0,0.5
anachueta,1,9,5,4,0,1.25
acro,0,4,2,2,0,1
postamputation,1,14,6,8,0,0.75
marijo,1,6,3,3,0,1
nasalised,1,9,4,5,0,0.8
sovietisation,1,13,7,6,0,1.16666666666667
pinata,1,6,3,3,0,1
felsiums,0,8,3,5,0,0.6
rvyoql'hech,0,11,2,9,1,0.222222222222222
prifors,0,7,2,5,0,0.4
farcinoleukemia,0,15,8,7,0,1.14285714285714
medressehs,1,10,3,7,0,0.428571428571429
canephobia,0,10,5,5,0,1
misassembles,1,12,4,8,0,0.5
satai,1,5,3,2,0,1.5
alcalzaring,0,11,4,7,0,0.571428571428571
multilobulated,1,14,6,8,0,0.75
bthrorrorngeralopeesphunbelicrtaltadexputis,0,43,15,28,0,0.535714285714286
freebootie,0,10,6,4,0,1.5
mcladimen,0,9,3,6,0,0.5
nodriantrabamierficituolunie,0,28,14,14,0,1
aflerfuxopareaeag,0,17,9,8,0,1.125
taenidia,1,8,5,3,0,1.66666666666667
detectance,0,10,4,6,0,0.666666666666667
lo,1,2,1,1,0,1
latise,0,6,3,3,0,1
uncements,0,9,3,6,0,0.5
coras,0,5,2,3,0,0.666666666666667
plessimeter,1,11,4,7,0,0.571428571428571
uties,0,5,3,2,0,1.5
authwomatbres,0,13,5,8,0,0.625
auxil,1,5,3,2,0,1.5
petaididdle,0,11,5,6,0,0.833333333333333
nonvulsivity,0,12,4,8,0,0.5
wdodgg,0,6,1,5,0,0.2
terminaliaceae,1,14,8,6,0,1.33333333333333
spectress,0,9,2,7,0,0.285714285714286
lauro,1,5,3,2,0,1.5
doic,0,4,2,2,0,1
pery,0,4,1,3,0,0.333333333333333
melnick,1,7,2,5,0,0.4
treamba,0,7,3,4,0,0.75
esvtodylw,0,9,2,7,0,0.285714285714286
spellular,0,9,3,6,0,0.5
progressionally,1,15,5,10,0,0.5
melanosarcoma,1,13,6,7,0,0.857142857142857
ossein,1,6,3,3,0,1
acike,0,5,3,2,0,1.5
jarabidead,0,10,5,5,0,1
brewis,1,6,2,4,0,0.5
pras,0,4,1,3,0,0.333333333333333
obtention,1,9,4,5,0,0.8
honeybrook,1,10,4,6,0,0.666666666666667
geochemistous,0,13,6,7,0,0.857142857142857
utgrawan,0,8,3,5,0,0.6
eleusis,1,7,4,3,0,1.33333333333333
abricalvassoriluric,0,19,8,11,0,0.727272727272727
hae,0,3,2,1,0,2
song,1,4,1,3,0,0.333333333333333
equuleus,1,8,5,3,0,1.66666666666667
boheas,1,6,3,3,0,1
salapiacelnskfelapa,0,19,8,11,0,0.727272727272727
coinduction,0,11,5,6,0,0.833333333333333
kthfxfzov,0,9,1,8,0,0.125
listerine,1,9,4,5,0,0.8
tjaicirv'prfjbxt'yed,0,20,4,16,2,0.25
nectarinia,1,10,5,5,0,1
lingayata,1,9,4,5,0,0.8
snarler,1,7,2,5,0,0.4
ursulette,1,9,4,5,0,0.8
galactosan,1,10,4,6,0,0.666666666666667
qrsadqofiee,0,11,5,6,0,0.833333333333333
riny,0,4,1,3,0,0.333333333333333
strubbly,1,8,1,7,0,0.142857142857143
megaly,0,6,2,4,0,0.5
debutant,1,8,3,5,0,0.6
cryptomerous,1,12,4,8,0,0.5
vaceniepritratien,0,17,8,9,0,0.888888888888889
kutes,0,5,2,3,0,0.666666666666667
nonnerver,0,9,3,6,0,0.5
noncontagionists,0,16,6,10,0,0.6
lido,1,4,2,2,0,1
akure,1,5,3,2,0,1.5
nonconspiratorial,1,17,7,10,0,0.7
p',0,2,0,2,1,0
tradename,1,9,4,5,0,0.8
section,1,7,3,4,0,0.75
unpannis,0,8,3,5,0,0.6
ztdppemjjwmxhpqkixb,0,19,2,17,0,0.117647058823529
consubstantiated,1,16,6,10,0,0.6
cirratulidae,1,12,6,6,0,1
prekindergarten,1,15,5,10,0,0.5
spher,0,5,1,4,0,0.25
disaccharidases,1,15,6,9,0,0.666666666666667
microchasis,0,11,4,7,0,0.571428571428571
snollygoster,1,12,3,9,0,0.333333333333333
counterculture,1,14,6,8,0,0.75
provincialate,1,13,6,7,0,0.857142857142857
pting,0,5,1,4,0,0.25
propore,0,7,3,4,0,0.75
bicyclical,1,10,3,7,0,0.428571428571429
interiorly,1,10,4,6,0,0.666666666666667
allomorphism,1,12,4,8,0,0.5
cvalist,0,7,2,5,0,0.4
garikitcharabbyism,0,18,6,12,0,0.5
alismsda,0,8,3,5,0,0.6
antinastidoraglike,0,18,8,10,0,0.8
noninterconnecticut,0,19,7,12,0,0.583333333333333
miscensured,1,11,4,7,0,0.571428571428571
bhikku,1,6,2,4,0,0.5
bew,1,3,1,2,0,0.5
poincara,1,8,4,4,0,1
umooulaterodres,0,15,8,7,0,1.14285714285714
kay,1,3,1,2,0,0.5
scalds,1,6,1,5,0,0.2
poppability,1,11,4,7,0,0.571428571428571
warrantabness,0,13,4,9,0,0.444444444444444
vivisectionary,0,14,6,8,0,0.75
cichoriaceae,1,12,7,5,0,1.4
pilaf,1,5,2,3,0,0.666666666666667
peccary,1,7,2,5,0,0.4
kxxqaevtlclmnglhenyrmg,0,22,3,19,0,0.157894736842105
cryophilic,1,10,3,7,0,0.428571428571429
mslxbjlkiorgyr,0,14,2,12,0,0.166666666666667
favourite,1,9,5,4,0,1.25
scavenage,1,9,4,5,0,0.8
uren,0,4,2,2,0,1
nyman,1,5,1,4,0,0.25
rockaleena,0,10,5,5,0,1
niersteiners,1,12,5,7,0,0.714285714285714
pigwzhmre,0,9,2,7,0,0.285714285714286
ahmadabad,1,9,4,5,0,0.8
calculi,1,7,3,4,0,0.75
sandectity,0,10,3,7,0,0.428571428571429
nonbeliever,1,11,5,6,0,0.833333333333333
ynl,0,3,0,3,0,0
palah,0,5,2,3,0,0.666666666666667
hearn,1,5,2,3,0,0.666666666666667
unceable,0,8,4,4,0,1
ackint,0,6,2,4,0,0.5
asheetee,0,8,5,3,0,1.66666666666667
chesticists,0,11,3,8,0,0.375
brescia,1,7,3,4,0,0.75
lesesurres,0,10,4,6,0,0.666666666666667
quare,1,5,3,2,0,1.5
roosterlessness,0,15,5,10,0,0.5
vegetativeness,1,14,6,8,0,0.75
malfeasance,1,11,5,6,0,0.833333333333333
equipaging,1,10,5,5,0,1
forestic,0,8,3,5,0,0.6
romneyas,1,8,3,5,0,0.6
windbreaks,1,10,3,7,0,0.428571428571429
phycography,0,11,2,9,0,0.222222222222222
overmaturely,1,12,5,7,0,0.714285714285714
garrulity,1,9,3,6,0,0.5
hasted,1,6,2,4,0,0.5
kinetographers,0,14,5,9,0,0.555555555555556
reconsecretion,0,14,6,8,0,0.75
autocoherer,1,11,6,5,0,1.2
unboxes,1,7,3,4,0,0.75
nutiess,0,7,3,4,0,0.75
fons,1,4,1,3,0,0.333333333333333
ue,0,2,2,0,0,1
ballsiness,1,10,3,7,0,0.428571428571429
insolenticulated,0,16,7,9,0,0.777777777777778
colde,0,5,2,3,0,0.666666666666667
cereless,1,8,3,5,0,0.6
malocclusioned,0,14,6,8,0,0.75
weftages,1,8,3,5,0,0.6
ue,0,2,2,0,0,1
sinewiness,1,10,4,6,0,0.666666666666667
stic,0,4,1,3,0,0.333333333333333
sashaying,0,9,3,6,0,0.5
observably,1,10,3,7,0,0.428571428571429
dlbjlddrtlqhepmfwukuyfakylzk,0,28,4,24,0,0.166666666666667
oxytone,1,7,3,4,0,0.75
carpocapsa,1,10,4,6,0,0.666666666666667
exantis,0,7,3,4,0,0.75
sfqkjxodtbquemj,0,15,3,12,0,0.25
overapped,0,9,4,5,0,0.8
kallitypes,1,10,3,7,0,0.428571428571429
appuis,1,6,3,3,0,1
reimpovetourmel,0,15,7,8,0,0.875
amityville,1,10,4,6,0,0.666666666666667
shrewstruck,1,11,2,9,0,0.222222222222222
ichnid,0,6,2,4,0,0.5
orphed,0,6,2,4,0,0.5
gunning,1,7,2,5,0,0.4
sulfoselenide,1,13,6,7,0,0.857142857142857
gandeeville,1,11,5,6,0,0.833333333333333
negrote,0,7,3,4,0,0.75
enteritings,0,11,4,7,0,0.571428571428571
resenomation,0,12,6,6,0,1
extraorbitally,1,14,5,9,0,0.555555555555556
francestown,1,11,3,8,0,0.375
ftitrongndn,0,11,2,9,0,0.222222222222222
oracle,1,6,3,3,0,1
preinstances,0,12,4,8,0,0.5
willower,1,8,3,5,0,0.6
presentialities,1,15,7,8,0,0.875
fluorous,0,8,4,4,0,1
microtypeppedillemed,0,20,7,13,0,0.538461538461538
unvoraciously,1,13,6,7,0,0.857142857142857
preocravey,0,10,4,6,0,0.666666666666667
iooyycznkvltukrrg,0,17,4,13,0,0.307692307692308
gncadose,0,8,3,5,0,0.6
kolkozes,1,8,3,5,0,0.6
downbend,1,8,2,6,0,0.333333333333333
ababdeh,1,7,3,4,0,0.75
fotmakings,0,10,3,7,0,0.428571428571429
chilomycterus,1,13,4,9,0,0.444444444444444
cocesecabriledectity,0,20,8,12,0,0.666666666666667
gronchi,1,7,2,5,0,0.4
aceanumette,0,11,6,5,0,1.2
embioptera,1,10,5,5,0,1
octastylos,1,10,3,7,0,0.428571428571429
precontrivedly,0,14,4,10,0,0.4
improvisatores,1,14,6,8,0,0.75
rophocorare,0,11,5,6,0,0.833333333333333
stononaliker,0,12,5,7,0,0.714285714285714
malapropish,1,11,4,7,0,0.571428571428571
chronon,1,7,2,5,0,0.4
dorticosteus,0,12,5,7,0,0.714285714285714
event,1,5,2,3,0,0.666666666666667
addible,1,7,3,4,0,0.75
scripee,1,7,3,4,0,0.75
doorstensinger,0,14,5,9,0,0.555555555555556
affrontment,1,11,3,8,0,0.375
domphysan,0,9,2,7,0,0.285714285714286
sanilan,0,7,3,4,0,0.75
omniparentum,0,12,5,7,0,0.714285714285714
nakyrlcg,0,8,1,7,0,0.142857142857143
nonreader,1,9,4,5,0,0.8
jabbily,0,7,2,5,0,0.4
luaus,1,5,3,2,0,1.5
martyn,1,6,1,5,0,0.2
allethrin,1,9,3,6,0,0.5
microwires,1,10,4,6,0,0.666666666666667
blepharocephaly,0,15,5,10,0,0.5
matriculator,1,12,5,7,0,0.714285714285714
misjudger,1,9,3,6,0,0.5
nitcheing,0,9,3,6,0,0.5
periorchitis,1,12,5,7,0,0.714285714285714
esteter,0,7,3,4,0,0.75
jills,1,5,1,4,0,0.25
prospect,1,8,2,6,0,0.333333333333333
angdistis,1,9,3,6,0,0.5
kenoticist,1,10,4,6,0,0.666666666666667
disbecillenotax,0,15,6,9,0,0.666666666666667
shaksperian,1,11,4,7,0,0.571428571428571
steadisms,0,9,3,6,0,0.5
xss'pmome'dccmnawygonug,0,23,5,18,2,0.277777777777778
clvhgkitudutyej,0,15,4,11,0,0.363636363636364
blastomatism,0,12,4,8,0,0.5
cajuns,1,6,2,4,0,0.5
fibrittellifornity,0,18,6,12,0,0.5
phylloscopus,1,12,3,9,0,0.333333333333333
parallelopipedon,1,16,7,9,0,0.777777777777778
bdsiupetvsxhwcgskqguxttt,0,24,4,20,0,0.2
vigorishes,1,10,4,6,0,0.666666666666667
straddling,1,10,2,8,0,0.25
histologically,1,14,5,9,0,0.555555555555556
inspoting,0,9,3,6,0,0.5
phelladialistically,0,19,7,12,0,0.583333333333333
lacrimation,1,11,5,6,0,0.833333333333333
hwracqskluf,0,11,2,9,0,0.222222222222222
windsor,1,7,2,5,0,0.4
preilluminate,1,13,6,7,0,0.857142857142857
southland,1,9,3,6,0,0.5
unarmogenity,0,12,5,7,0,0.714285714285714
frontbitivages,0,14,5,9,0,0.555555555555556
bukshee,1,7,3,4,0,0.75
ductility,1,9,3,6,0,0.5
desilicified,1,12,6,6,0,1
midg,0,4,1,3,0,0.333333333333333
echis,1,5,2,3,0,0.666666666666667
ifoumularoniniteatulalidonflbentcanente,0,39,18,21,0,0.857142857142857
ghencceali,0,10,4,6,0,0.666666666666667
macrophyllous,1,13,4,9,0,0.444444444444444
minishmen,0,9,3,6,0,0.5
bld,1,3,0,3,0,0
fhhvjwigtloeo,0,13,4,9,0,0.444444444444444
pregenerative,0,13,6,7,0,0.857142857142857
gelexesunn,0,10,4,6,0,0.666666666666667
phenetic,1,8,3,5,0,0.6
inessentiality,1,14,6,8,0,0.75
hackhazilled,0,12,4,8,0,0.5
unrestricts,0,11,3,8,0,0.375
mithriac,1,8,3,5,0,0.6
wenger,1,6,2,4,0,0.5
athal,1,5,2,3,0,0.666666666666667
somq'bkywdyzkujgr,0,17,2,15,1,0.133333333333333
elanoides,1,9,5,4,0,1.25
leate,0,5,3,2,0,1.5
scintil,1,7,2,5,0,0.4
biventerectomies,0,16,7,9,0,0.777777777777778
boozlingerbracewoman,0,20,8,12,0,0.666666666666667
kgdoxduyd,0,9,2,7,0,0.285714285714286
pecting,0,7,2,5,0,0.4
unrested,1,8,3,5,0,0.6
monotremous,1,11,5,6,0,0.833333333333333
scientologist,1,13,5,8,0,0.625
fral,0,4,1,3,0,0.333333333333333
preenginess,0,11,4,7,0,0.571428571428571
panpharmacon,1,12,4,8,0,0.5
shanniaceablenumier,0,19,9,10,0,0.9
mukwonaccus,0,11,4,7,0,0.571428571428571
evvyyard,0,8,2,6,0,0.333333333333333
rekindlings,0,11,3,8,0,0.375
caricous,1,8,4,4,0,1
philodendrologies,0,17,7,10,0,0.7
unitarian,1,9,5,4,0,1.25
vitdwuhkpaooudq,0,15,6,9,0,0.666666666666667
elophobic,0,9,4,5,0,0.8
yhemhoedkgukeqbjec,0,18,6,12,0,0.5
curvicostate,1,12,5,7,0,0.714285714285714
grenfell,1,8,2,6,0,0.333333333333333
mantidae,1,8,4,4,0,1
brownsdale,1,10,3,7,0,0.428571428571429
economiser,1,10,5,5,0,1
pointal,1,7,3,4,0,0.75
phasiron,1,8,3,5,0,0.6
pioche,1,6,3,3,0,1
jahvttzkxyuvadfdht'ommqkrv,0,26,4,22,1,0.181818181818182
spaka,0,5,2,3,0,0.666666666666667
semiextinction,1,14,6,8,0,0.75
telexed,1,7,3,4,0,0.75
wqc,0,3,0,3,0,0
pon,0,3,1,2,0,0.5
spirogyra,1,9,3,6,0,0.5
osmovisinae,0,11,6,5,0,1.2
nsrb,1,4,0,4,0,0
cosignescences,0,14,5,9,0,0.555555555555556
mapiovarepinasca,0,16,8,8,0,1
ngirm,0,5,1,4,0,0.25
sqcccaizfvfetkjvtfpyxubtyvm,0,27,4,23,0,0.173913043478261
longson,0,7,2,5,0,0.4
tevets,1,6,2,4,0,0.5
mose,1,4,2,2,0,1
profy,0,5,1,4,0,0.25
arctiidae,1,9,5,4,0,1.25
antiprelate,1,11,5,6,0,0.833333333333333
cityfied,1,8,3,5,0,0.6
preradiophorus,0,14,6,8,0,0.75
manducable,1,10,4,6,0,0.666666666666667
burseraceous,1,12,6,6,0,1
ropedancer,1,10,4,6,0,0.666666666666667
''dgchcjbnnrgwv'uj',0,19,1,18,4,0.0555555555555556
knhduhrxpkxb,0,12,1,11,0,0.0909090909090909
broochemopolises,0,16,7,9,0,0.777777777777778
emme,0,4,2,2,0,1
tupwone,0,7,3,4,0,0.75
seacrafty,1,9,3,6,0,0.5
althara,0,7,3,4,0,0.75
darks,1,5,1,4,0,0.25
anglicization,1,13,6,7,0,0.857142857142857
tamanaha,1,8,4,4,0,1
tained,0,6,3,3,0,1
stmerwoodinongied,0,17,7,10,0,0.7
swizzles,1,8,2,6,0,0.333333333333333
lviv,1,4,1,3,0,0.333333333333333
opprobriously,1,13,5,8,0,0.625
gjzzbwbcxgxcclgzt',0,18,0,18,1,0
rontiated,0,9,4,5,0,0.8
saunaing,1,8,4,4,0,1
mmblxxscjo,0,10,1,9,0,0.111111111111111
dutchman,1,8,2,6,0,0.333333333333333
inatided,0,8,4,4,0,1
mcculloch,1,9,2,7,0,0.285714285714286
bedtime,1,7,3,4,0,0.75
searchment,1,10,3,7,0,0.428571428571429
ergatomorph,1,11,4,7,0,0.571428571428571
ciliophobies,0,12,6,6,0,1
xynm'wpgoie,0,11,3,8,1,0.375
cephalanthus,1,12,4,8,0,0.5
popty,0,5,1,4,0,0.25
procarboluria,0,13,6,7,0,0.857142857142857
rna,1,3,1,2,0,0.5
servosystematised,0,17,6,11,0,0.545454545454545
warkloom,1,8,3,5,0,0.6
incongruently,1,13,4,9,0,0.444444444444444
nonretraceable,1,14,6,8,0,0.75
prost,1,5,1,4,0,0.25
vivalental,0,10,4,6,0,0.666666666666667
nudusable,0,9,4,5,0,0.8
subfluvial,1,10,4,6,0,0.666666666666667
saurated,0,8,4,4,0,1
diaguita,0,8,5,3,0,1.66666666666667
moeritherianthropically,0,23,9,14,0,0.642857142857143
kanreprankpots,0,14,4,10,0,0.4
lienogastric,1,12,5,7,0,0.714285714285714
lesage,1,6,3,3,0,1
texted,1,6,2,4,0,0.5
g'llswpoujnngaldqtrwtbane,0,25,5,20,1,0.25
priestfish,1,10,3,7,0,0.428571428571429
shoeblack,1,9,3,6,0,0.5
munchen,1,7,2,5,0,0.4
nonenforceability,1,17,7,10,0,0.7
dishneseedtkey,0,14,5,9,0,0.555555555555556
yugoslave,0,9,4,5,0,0.8
traducianism,1,12,5,7,0,0.714285714285714
deliveryman,1,11,4,7,0,0.571428571428571
profligates,1,11,4,7,0,0.571428571428571
wolfy,1,5,1,4,0,0.25
typees,1,6,2,4,0,0.5
bunci,0,5,2,3,0,0.666666666666667
astigmat,1,8,3,5,0,0.6
berthoud,1,8,3,5,0,0.6
porsailer,0,9,4,5,0,0.8
cyclopes,1,8,2,6,0,0.333333333333333
deodoriser,1,10,5,5,0,1
uxoriality,1,10,5,5,0,1
spirally,1,8,2,6,0,0.333333333333333
floatingly,1,10,3,7,0,0.428571428571429
outdalty,0,8,3,5,0,0.6
sozinesses,0,10,4,6,0,0.666666666666667
hasseur,0,7,3,4,0,0.75
timeline,1,8,4,4,0,1
rwbmkuyhd,0,9,1,8,0,0.125
symbos,0,6,1,5,0,0.2
gourdful,1,8,3,5,0,0.6
uniformised,1,11,5,6,0,0.833333333333333
yafa,1,4,2,2,0,1
colopexotomy,1,12,5,7,0,0.714285714285714
puddiness,0,9,3,6,0,0.5
fairyland,1,9,3,6,0,0.5
mollus,0,6,2,4,0,0.5
tolatock,0,8,3,5,0,0.6
unsmirkingly,1,12,3,9,0,0.333333333333333
chaplains,1,9,3,6,0,0.5
anw'wbs,0,7,1,6,1,0.166666666666667
wabrignexes,0,11,4,7,0,0.571428571428571
nafud,1,5,2,3,0,0.666666666666667
bristibility,0,12,4,8,0,0.5
eney,0,4,2,2,0,1
loyolism,1,8,3,5,0,0.6
coffics,0,7,2,5,0,0.4
xgsurwcxhksunvlhdzoaxf,0,22,4,18,0,0.222222222222222
u'bcof'xpgrgjjzkcizmogbdfd,0,26,4,22,2,0.181818181818182
methylenedioxymethamphetamine,1,29,11,18,0,0.611111111111111
strumatic,1,9,3,6,0,0.5
volumenometry,1,13,5,8,0,0.625
disrated,1,8,3,5,0,0.6
johnnie,1,7,3,4,0,0.75
spammies,0,8,3,5,0,0.6
anne,1,4,2,2,0,1
micrometeoritic,1,15,7,8,0,0.875
dillth,0,6,1,5,0,0.2
intervenors,1,11,4,7,0,0.571428571428571
mowis,0,5,2,3,0,0.666666666666667
plumbisolvent,1,13,4,9,0,0.444444444444444
racketiness,1,11,4,7,0,0.571428571428571
omnipotentialist,0,16,7,9,0,0.777777777777778
semirebellion,1,13,6,7,0,0.857142857142857
sufferenk,0,9,3,6,0,0.5
becka,1,5,2,3,0,0.666666666666667
deserveful,0,10,4,6,0,0.666666666666667
dispewynda,0,10,3,7,0,0.428571428571429
reas,0,4,2,2,0,1
odocoileus,1,10,6,4,0,1.5
excitingly,1,10,3,7,0,0.428571428571429
dlzswbknh,0,9,0,9,0,0
meson,1,5,2,3,0,0.666666666666667
brussels,1,8,2,6,0,0.333333333333333
nonobviously,1,12,5,7,0,0.714285714285714
'icig'e'hfwacejz,0,16,5,11,3,0.454545454545455
ventish,0,7,2,5,0,0.4
lity,0,4,1,3,0,0.333333333333333
smic,0,4,1,3,0,0.333333333333333
yfezl'yfroorwi,0,14,4,10,1,0.4
trevett,1,7,2,5,0,0.4
airyte,0,6,3,3,0,1
indisputatious,0,14,7,7,0,1
fagger,1,6,2,4,0,0.5
kalapuyan,1,9,4,5,0,0.8
sphakiot,1,8,3,5,0,0.6
hooppole,1,8,4,4,0,1
pigmentary,1,10,3,7,0,0.428571428571429
mphec,0,5,1,4,0,0.25
bero'e,0,6,3,3,1,1
pinary,0,6,2,4,0,0.5
rourusters,0,10,4,6,0,0.666666666666667
swarphembassimeliniar,0,21,8,13,0,0.615384615384615
pyrtendly,0,9,1,8,0,0.125
jaz'hsax't,0,10,2,8,2,0.25
unberdertonicurranglos,0,22,8,14,0,0.571428571428571
quickhearted,1,12,5,7,0,0.714285714285714
stretta,1,7,2,5,0,0.4
underlighted,0,12,4,8,0,0.5
histiciests,0,11,4,7,0,0.571428571428571
praemaxillas,0,12,5,7,0,0.714285714285714
idealless,1,9,4,5,0,0.8
cx'gu,0,5,1,4,1,0.25
delousers,1,9,4,5,0,0.8
plumularia,1,10,5,5,0,1
unsomatic,1,9,4,5,0,0.8
prefectship,1,11,3,8,0,0.375
pinelands,1,9,3,6,0,0.5
biometrocidae,0,13,7,6,0,1.16666666666667
phrery,0,6,1,5,0,0.2
unthinkably,1,11,3,8,0,0.375
pietisms,1,8,3,5,0,0.6
aphingsphilus,0,13,4,9,0,0.444444444444444
made,1,4,2,2,0,1
seizors,1,7,3,4,0,0.75
alkhasis,0,8,3,5,0,0.6
treculia,1,8,4,4,0,1
pustulations,1,12,5,7,0,0.714285714285714
prelegislated,0,13,5,8,0,0.625
aubela,0,6,4,2,0,2
msiandrtent,0,11,3,8,0,0.375
alpheus,1,7,3,4,0,0.75
dutchman,1,8,2,6,0,0.333333333333333
bugdom,1,6,2,4,0,0.5
pioscastongortcogipem,0,21,8,13,0,0.615384615384615
quoits,1,6,3,3,0,1
fumarases,1,9,4,5,0,0.8
westernight,0,11,3,8,0,0.375
contumaciousness,1,16,7,9,0,0.777777777777778
prototherian,1,12,5,7,0,0.714285714285714
nondesulfur,0,11,4,7,0,0.571428571428571
kney,0,4,1,3,0,0.333333333333333
mexity,0,6,2,4,0,0.5
tatiodavass,0,11,5,6,0,0.833333333333333
fatiscence,1,10,4,6,0,0.666666666666667
lowderivarium,0,13,6,7,0,0.857142857142857
preemie,1,7,4,3,0,1.33333333333333
boycotterers,0,12,4,8,0,0.5
ranshakle,1,9,3,6,0,0.5
lomy,0,4,1,3,0,0.333333333333333
toura,1,5,3,2,0,1.5
doormat,1,7,3,4,0,0.75
odom,1,4,2,2,0,1
saturnalistic,0,13,5,8,0,0.625
mycerinus,1,9,3,6,0,0.5
tarantular,1,10,4,6,0,0.666666666666667
gropexy,0,7,2,5,0,0.4
vsgvgeeotpxp,0,12,3,9,0,0.333333333333333
nov,1,3,1,2,0,0.5
kasparing,0,9,3,6,0,0.5
ornater,1,7,3,4,0,0.75
neberrico,0,9,4,5,0,0.8
aethra,1,6,3,3,0,1
bontuetsthanalid,0,16,6,10,0,0.6
multitiere,0,10,5,5,0,1
deadend,1,7,3,4,0,0.75
haffkins,0,8,2,6,0,0.333333333333333
hypertelic,1,10,3,7,0,0.428571428571429
rhagolysis,0,10,3,7,0,0.428571428571429
raden,0,5,2,3,0,0.666666666666667
protomorphic,1,12,4,8,0,0.5
comintern,1,9,3,6,0,0.5
supertwist,1,10,3,7,0,0.428571428571429
scuttle,1,7,2,5,0,0.4
courtless,1,9,3,6,0,0.5
clarable,0,8,3,5,0,0.6
valiestia,0,9,5,4,0,1.25
phrasemen,1,9,3,6,0,0.5
orife,0,5,3,2,0,1.5
byre,1,4,1,3,0,0.333333333333333
palaeotypical,1,13,6,7,0,0.857142857142857
caliche,1,7,3,4,0,0.75
eneximina,0,9,5,4,0,1.25
anasheck,0,8,3,5,0,0.6
qxybyicfmytkquvlqws,0,19,2,17,0,0.117647058823529
terti,1,5,2,3,0,0.666666666666667
unress,0,6,2,4,0,0.5
capataz,1,7,3,4,0,0.75
asandlis,0,8,3,5,0,0.6
mandra,0,6,2,4,0,0.5
jullatillecrads,0,15,5,10,0,0.5
vitek,1,5,2,3,0,0.666666666666667
sheepeckboukown,0,15,6,9,0,0.666666666666667
mossinesses,1,11,4,7,0,0.571428571428571
purebeco,0,8,4,4,0,1
overinger,0,9,4,5,0,0.8
rumex,1,5,2,3,0,0.666666666666667
hohe,1,4,2,2,0,1
inshelta,0,8,3,5,0,0.6
pasear,1,6,3,3,0,1
amphites,0,8,3,5,0,0.6
flippered,0,9,3,6,0,0.5
anderefidroceatrwian,0,20,9,11,0,0.818181818181818
adon,1,4,2,2,0,1
ghtenes,0,7,2,5,0,0.4
cholys,0,6,1,5,0,0.2
horacio,1,7,4,3,0,1.33333333333333
bakers,1,6,2,4,0,0.5
extracathexis,0,13,5,8,0,0.625
opinionists,1,11,5,6,0,0.833333333333333
chartlessnesses,0,15,4,11,0,0.363636363636364
hiphiidae,0,9,5,4,0,1.25
thiodiglycols,1,13,4,9,0,0.444444444444444
fullar,0,6,2,4,0,0.5
unaccumultise,0,13,6,7,0,0.857142857142857
evangelistic,1,12,5,7,0,0.714285714285714
sharmas,0,7,2,5,0,0.4
lticiblogsonsis,0,15,5,10,0,0.5
cheverias,0,9,4,5,0,0.8
lessen,1,6,2,4,0,0.5
unsmokratinirosteostologenous,0,29,13,16,0,0.8125
choush,1,6,2,4,0,0.5
juverna,1,7,3,4,0,0.75
cerimans,1,8,3,5,0,0.6
outtracillicence,0,16,7,9,0,0.777777777777778
acariday,0,8,4,4,0,1
peq,0,3,1,2,0,0.5
kaffeeklatch,1,12,4,8,0,0.5
ankagermoustondear,0,18,8,10,0,0.8
alfedena,1,8,4,4,0,1
laggings,1,8,2,6,0,0.333333333333333
retrohepatia,0,12,6,6,0,1
tripletail,1,10,4,6,0,0.666666666666667
outlegist,0,9,4,5,0,0.8
calopogon,1,9,4,5,0,0.8
vauquelinite,0,12,7,5,0,1.4
sixteeners,1,10,4,6,0,0.666666666666667
bhayance,0,8,3,5,0,0.6
qesbcxsddi,0,10,2,8,0,0.25
colleague,1,9,5,4,0,1.25
chliably,0,8,2,6,0,0.333333333333333
daintifying,1,11,4,7,0,0.571428571428571
toaterancers,0,12,5,7,0,0.714285714285714
interradiating,1,14,6,8,0,0.75
beaters,1,7,3,4,0,0.75
mimmocky,1,8,2,6,0,0.333333333333333
poudofes,0,8,4,4,0,1
kinderspiel,1,11,4,7,0,0.571428571428571
micrometallidice,0,16,7,9,0,0.777777777777778
cading,0,6,2,4,0,0.5
orthopurposthetic,0,17,6,11,0,0.545454545454545
calcuttan,1,9,3,6,0,0.5
empiricists,1,11,4,7,0,0.571428571428571
tramurate,0,9,4,5,0,0.8
logfuromy,0,9,3,6,0,0.5
negrophobia,1,11,5,6,0,0.833333333333333
blackband,1,9,2,7,0,0.285714285714286
anaphalantiasis,1,15,7,8,0,0.875
advehm,0,6,2,4,0,0.5
indubious,1,9,5,4,0,1.25
brython,1,7,1,6,0,0.166666666666667
mainstructive,0,13,5,8,0,0.625
iberian,1,7,4,3,0,1.33333333333333
shoeia,0,6,4,2,0,2
venantes,1,8,3,5,0,0.6
comy,0,4,1,3,0,0.333333333333333
chargehouse,1,11,5,6,0,0.833333333333333
thessalonki,1,11,4,7,0,0.571428571428571
darwinian,1,9,4,5,0,0.8
geoting,0,7,3,4,0,0.75
mummagbobless,0,13,4,9,0,0.444444444444444
asbury,1,6,2,4,0,0.5
crimitimather,0,13,5,8,0,0.625
merman,1,6,2,4,0,0.5
voiceover,1,9,5,4,0,1.25
ulks,0,4,1,3,0,0.333333333333333
ligniform,1,9,3,6,0,0.5
ablegroangbotonsherp,0,20,7,13,0,0.538461538461538
pelted,1,6,2,4,0,0.5
bassinet,1,8,3,5,0,0.6
euless,1,6,3,3,0,1
rqkbsputn,0,9,1,8,0,0.125
ploidy,1,6,2,4,0,0.5
anabaptistry,1,12,4,8,0,0.5
gfslapslgyt,0,11,1,10,0,0.1
jujubercularly,0,14,5,9,0,0.555555555555556
unvanquishing,1,13,5,8,0,0.625
lepider,0,7,3,4,0,0.75
norbialiation,0,13,7,6,0,1.16666666666667
hysis,0,5,1,4,0,0.25
heliotyping,1,11,4,7,0,0.571428571428571
alexandropol,0,12,5,7,0,0.714285714285714
sthrrinjequsties,0,16,5,11,0,0.454545454545455
bushwelo,0,8,3,5,0,0.6
silverboom,1,10,4,6,0,0.666666666666667
ste,0,3,1,2,0,0.5
cepharis,0,8,3,5,0,0.6
prmanonieteme,0,13,6,7,0,0.857142857142857
microhmmeters,0,13,4,9,0,0.444444444444444
felt,1,4,1,3,0,0.333333333333333
expenaltrawf,0,12,4,8,0,0.5
crossboy,0,8,2,6,0,0.333333333333333
triders,0,7,2,5,0,0.4
bookstores,1,10,4,6,0,0.666666666666667
trilamellate,0,12,5,7,0,0.714285714285714
besincesnepiobs,0,15,6,9,0,0.666666666666667
reuven,1,6,3,3,0,1
ideographically,1,15,6,9,0,0.666666666666667
lancelet,1,8,3,5,0,0.6
mdskorntffvdkpoxsamuoqj,0,23,5,18,0,0.277777777777778
billify,0,7,2,5,0,0.4
j'uoqqfefeoff,0,13,5,8,1,0.625
gooserumped,1,11,5,6,0,0.833333333333333
staktometry,0,11,3,8,0,0.375
whitter,1,7,2,5,0,0.4
khuzistan,1,9,3,6,0,0.5
recompensatory,1,14,5,9,0,0.555555555555556
superelites,1,11,5,6,0,0.833333333333333
gawiqeeioymj,0,12,6,6,0,1
qqpx'eafycicz',0,14,3,11,2,0.272727272727273
eponymize,1,9,4,5,0,0.8
noncongruous,1,12,5,7,0,0.714285714285714
scrota,1,6,2,4,0,0.5
dagedqf,0,7,2,5,0,0.4
sleepiniol,0,10,5,5,0,1
sternboards,1,11,3,8,0,0.375
und,0,3,1,2,0,0.5
ubleesoppelinedah,0,17,8,9,0,0.888888888888889
flamp,0,5,1,4,0,0.25
hyphene,0,7,2,5,0,0.4
pherogleerthossndenatindoophidonsallligrestan,0,45,16,29,0,0.551724137931034
hrfxmofqe,0,9,2,7,0,0.285714285714286
ficamilianeshan,0,15,7,8,0,0.875
sopun,0,5,2,3,0,0.666666666666667
julienning,1,10,4,6,0,0.666666666666667
alfirk,1,6,2,4,0,0.5
iodopsin,1,8,4,4,0,1
interagreeing,1,13,6,7,0,0.857142857142857
febricant,1,9,3,6,0,0.5
slype,1,5,1,4,0,0.25
columbites,1,10,4,6,0,0.666666666666667
echoers,1,7,3,4,0,0.75
romorphenbitively,0,17,6,11,0,0.545454545454545
ntin,0,4,1,3,0,0.333333333333333
catjangs,1,8,2,6,0,0.333333333333333
ewnv,0,4,1,3,0,0.333333333333333
vaticanism,1,10,4,6,0,0.666666666666667
rapidamente,1,11,5,6,0,0.833333333333333
soord,1,5,2,3,0,0.666666666666667
leasemongery,0,12,5,7,0,0.714285714285714
zfvmzgouyddrvmptdg,0,18,2,16,0,0.125
paron,1,5,2,3,0,0.666666666666667
moukden,1,7,3,4,0,0.75
refight,1,7,2,5,0,0.4
dymq,0,4,0,4,0,0
vapocautery,0,11,5,6,0,0.833333333333333
okxbozmjlqjurvsfrsrupgtsvunq,0,28,5,23,0,0.217391304347826
djgzfwhrxfxgxqp,0,15,0,15,0,0
dissociopellaros,0,16,7,9,0,0.777777777777778
aristotelean,1,12,6,6,0,1
swine,1,5,2,3,0,0.666666666666667
cotypic,0,7,2,5,0,0.4
quadriformable,0,14,6,8,0,0.75
occidentate,0,11,5,6,0,0.833333333333333
hadlyme,1,7,2,5,0,0.4
handplayer,0,10,3,7,0,0.428571428571429
tetraxonianist,0,14,6,8,0,0.75
brisked,1,7,2,5,0,0.4
brasseries,1,10,4,6,0,0.666666666666667
autoanalytic,1,12,6,6,0,1
yauyghvcooau,0,12,6,6,0,1
lapaintinsolentionintrojectionalisable,0,38,17,21,0,0.80952380952381
inberg,0,6,2,4,0,0.5
taed,1,4,2,2,0,1
catospelle,0,10,4,6,0,0.666666666666667
othings,0,7,2,5,0,0.4
beltis,1,6,2,4,0,0.5
xiphisuran,1,10,4,6,0,0.666666666666667
outtonguing,1,11,5,6,0,0.833333333333333
benshi,1,6,2,4,0,0.5
sulfindigotin,0,13,5,8,0,0.625
alliterationist,1,15,7,8,0,0.875
sun,1,3,1,2,0,0.5
rmslmbqnejvqwsdoa,0,17,3,14,0,0.214285714285714
pioneers,1,8,4,4,0,1
hoppings,1,8,2,6,0,0.333333333333333
genovera,1,8,4,4,0,1
nonpolarity,1,11,4,7,0,0.571428571428571
zaandam,1,7,3,4,0,0.75
unfolditermortical,0,18,7,11,0,0.636363636363636
sedimentations,1,14,6,8,0,0.75
shitkickee,0,10,4,6,0,0.666666666666667
mademoiselle,1,12,6,6,0,1
lamprey,1,7,2,5,0,0.4
cortagolders,0,12,4,8,0,0.5
belanesthicacicepteveashacor,0,28,12,16,0,0.75
paraguayaquilate,0,16,9,7,0,1.28571428571429
bomblor,0,7,2,5,0,0.4
toucanid,1,8,4,4,0,1
drick,0,5,1,4,0,0.25
schoolage,1,9,4,5,0,0.8
jewess,1,6,2,4,0,0.5
imiccis,0,7,3,4,0,0.75
diascrahienchelessons,0,21,8,13,0,0.615384615384615
auvnqbjqnnptoczeuuznoepr,0,24,8,16,0,0.5
subaqua,1,7,4,3,0,1.33333333333333
gbyjgggfywtqp,0,13,0,13,0,0
besognier,1,9,4,5,0,0.8
amission,1,8,4,4,0,1
inventionality,0,14,6,8,0,0.75
stylitism,1,9,2,7,0,0.285714285714286
homologic,1,9,4,5,0,0.8
squatnesses,1,11,4,7,0,0.571428571428571
smaik,1,5,2,3,0,0.666666666666667
aquish,0,6,3,3,0,1
distenwosy,0,10,3,7,0,0.428571428571429
enteroischiocele,1,16,8,8,0,1
orthoxazine,1,11,5,6,0,0.833333333333333
agnomen,1,7,3,4,0,0.75
courectorre,0,11,5,6,0,0.833333333333333
agriochoerus,1,12,6,6,0,1
prognosticable,1,14,5,9,0,0.555555555555556
overa,0,5,3,2,0,1.5
imponderables,1,13,5,8,0,0.625
mincoptingnocogreasend,0,22,8,14,0,0.571428571428571
vcsigwcqarvv,0,12,2,10,0,0.2
pncjkpryxaafhetkzqzv,0,20,3,17,0,0.176470588235294
evagination,1,11,6,5,0,1.2
cumarolish,0,10,4,6,0,0.666666666666667
perming,0,7,2,5,0,0.4
signmen,0,7,2,5,0,0.4
sepistic,0,8,3,5,0,0.6
oceanica,1,8,5,3,0,1.66666666666667
strica,0,6,2,4,0,0.5
bea,1,3,2,1,0,2
crogonsix,0,9,3,6,0,0.5
keysvilludibreviation,0,21,9,12,0,0.75
disquisiting,1,12,5,7,0,0.714285714285714
hooverville,1,11,5,6,0,0.833333333333333
niveau,1,6,4,2,0,2
spermologer,1,11,4,7,0,0.571428571428571
paravan,0,7,3,4,0,0.75
distorts,1,8,2,6,0,0.333333333333333
town,1,4,1,3,0,0.333333333333333
precooled,1,9,4,5,0,0.8
melanotic,1,9,4,5,0,0.8
powwower,1,8,3,5,0,0.6
cardiotherapy,1,13,5,8,0,0.625
corallines,1,10,4,6,0,0.666666666666667
pardubice,1,9,4,5,0,0.8
lanapaha,0,8,4,4,0,1
savery,1,6,2,4,0,0.5
ismaelism,1,9,4,5,0,0.8
scages,0,6,2,4,0,0.5
witchbook,0,9,3,6,0,0.5
motiforceto,0,11,5,6,0,0.833333333333333
'jooecirz'loamyfqatiu,0,21,9,12,2,0.75
hermannia,1,9,4,5,0,0.8
joub,1,4,2,2,0,1
disaccordancy,0,13,4,9,0,0.444444444444444
zeroise,1,7,4,3,0,1.33333333333333
counterattraction,1,17,7,10,0,0.7
hyperinvolution,1,15,6,9,0,0.666666666666667
jukhysrudkje'pf'cl,0,18,3,15,2,0.2
archmurderising,0,15,5,10,0,0.5
carapists,0,9,3,6,0,0.5
mawkier,1,7,3,4,0,0.75
remipedantic,0,12,5,7,0,0.714285714285714
nephropodiffish,0,15,5,10,0,0.5
unbrooded,1,9,4,5,0,0.8
disable,0,7,3,4,0,0.75
encatarrhaphy,1,13,4,9,0,0.444444444444444
limbas,1,6,2,4,0,0.5
dictograph,1,10,3,7,0,0.428571428571429
foecunditatis,1,13,6,7,0,0.857142857142857
superti,0,7,3,4,0,0.75
mistlewood,0,10,4,6,0,0.666666666666667
thewlike,1,8,3,5,0,0.6
bvz'zrctvjcjeflclswwya,0,22,2,20,1,0.1
thorvald,1,8,2,6,0,0.333333333333333
filigraphic,0,11,4,7,0,0.571428571428571
cvnnipbzwxmesgvx,0,16,2,14,0,0.142857142857143
ecdysiast,1,9,3,6,0,0.5
vhrxzqukgdnujaumzwvauwu,0,23,7,16,0,0.4375
nbknestt',0,9,1,8,1,0.125
bsc,1,3,0,3,0,0
skither,1,7,2,5,0,0.4
matrility,0,9,3,6,0,0.5
philochus,0,9,3,6,0,0.5
genotype,1,8,3,5,0,0.6
subnotebook,1,11,5,6,0,0.833333333333333
unplumped,0,9,3,6,0,0.5
overcompensated,1,15,6,9,0,0.666666666666667
ziyigddsqngkfmx,0,15,2,13,0,0.153846153846154
siliquarian,0,11,6,5,0,1.2
suborner,1,8,3,5,0,0.6
hasting,1,7,2,5,0,0.4
cancelability,1,13,5,8,0,0.625
prussianisers,1,13,5,8,0,0.625
humean,1,6,3,3,0,1
batfish,1,7,2,5,0,0.4
refright,0,8,2,6,0,0.333333333333333
casus,0,5,2,3,0,0.666666666666667
balery,0,6,2,4,0,0.5
peers,1,5,2,3,0,0.666666666666667
hibenzamia,0,10,5,5,0,1
adenomeningeal,1,14,7,7,0,1
superactive,1,11,5,6,0,0.833333333333333
orchlings,0,9,2,7,0,0.285714285714286
suppositive,1,11,5,6,0,0.833333333333333
weenen,0,6,3,3,0,1
overinsisted,0,12,5,7,0,0.714285714285714
dubois,1,6,3,3,0,1
zipporthmids,0,12,3,9,0,0.333333333333333
notorhynchus,1,12,3,9,0,0.333333333333333
fornflux,0,8,2,6,0,0.333333333333333
ahur,0,4,2,2,0,1
angulus,1,7,3,4,0,0.75
hepancentionny,0,14,5,9,0,0.555555555555556
obladiogamerography,0,19,8,11,0,0.727272727272727
floater,1,7,3,4,0,0.75
hypsophobia,1,11,4,7,0,0.571428571428571
rexes,1,5,2,3,0,0.666666666666667
unbreaking,1,10,4,6,0,0.666666666666667
clooshidathry,0,13,4,9,0,0.444444444444444
ovelaggearmollyal,0,17,7,10,0,0.7
kolea,1,5,3,2,0,1.5
lecithinases,1,12,5,7,0,0.714285714285714
sporistternctleranetearediadeprleituc,0,37,15,22,0,0.681818181818182
darlinals,0,9,3,6,0,0.5
beliefly,0,8,3,5,0,0.6
nonroy,0,6,2,4,0,0.5
derequisitions,1,14,7,7,0,1
helicopt,1,8,3,5,0,0.6
concurboatsuspers,0,17,6,11,0,0.545454545454545
trolla,0,6,2,4,0,0.5
quashey,1,7,3,4,0,0.75
cettibiditingatint,0,18,7,11,0,0.636363636363636
autoclastic,1,11,5,6,0,0.833333333333333
chipperfusingly,0,15,4,11,0,0.363636363636364
lstins,0,6,1,5,0,0.2
desmet,1,6,2,4,0,0.5
pennarcocently,0,14,4,10,0,0.4
xoacions,0,8,4,4,0,1
omktlsngqmjgnwuuhppavxk',0,24,4,20,1,0.2
dionuckludis,0,12,5,7,0,0.714285714285714
ditog,0,5,2,3,0,0.666666666666667
oatoumis,0,8,5,3,0,1.66666666666667
yethnlkbdsw,0,11,1,10,0,0.1
lxvlnjmkntty,0,12,0,12,0,0
bolandating,0,11,4,7,0,0.571428571428571
negro,1,5,2,3,0,0.666666666666667
immortalisers,1,13,5,8,0,0.625
'croh'vomnzy'npkvzcpy,0,21,2,19,3,0.105263157894737
burny,1,5,1,4,0,0.25
prm,0,3,0,3,0,0
redescender,0,11,4,7,0,0.571428571428571
whoqe,0,5,2,3,0,0.666666666666667
siametapnels,0,12,5,7,0,0.714285714285714
ungoscopula,0,11,5,6,0,0.833333333333333
zzvvhnynu,0,9,1,8,0,0.125
decimalists,1,11,4,7,0,0.571428571428571
legong,1,6,2,4,0,0.5
pedophilism,0,11,4,7,0,0.571428571428571
hechtians,0,9,3,6,0,0.5
omnites,0,7,3,4,0,0.75
disfoliageousness,0,17,8,9,0,0.888888888888889
rarong,0,6,2,4,0,0.5
wier,1,4,2,2,0,1
preaccidental,1,13,5,8,0,0.625
philhellenism,1,13,4,9,0,0.444444444444444
pxe,0,3,1,2,0,0.5
sawtimber,1,9,3,6,0,0.5
overutilizations,1,16,8,8,0,1
ssthibirhale,0,12,4,8,0,0.5
dictyopterin,0,12,4,8,0,0.5
backlashes,1,10,3,7,0,0.428571428571429
maskalonge,1,10,4,6,0,0.666666666666667
kurwx'djgcejqv'wsohpses,0,23,4,19,2,0.210526315789474
thackerville,1,12,4,8,0,0.5
unkindledness,1,13,4,9,0,0.444444444444444
ensilages,1,9,4,5,0,0.8
atermanshantopock,0,17,6,11,0,0.545454545454545
dothides,0,8,3,5,0,0.6
inferribility,1,13,5,8,0,0.625
unfallacious,1,12,6,6,0,1
allelopipedon,0,13,6,7,0,0.857142857142857
tiphianism,0,10,4,6,0,0.666666666666667
gallemulhaufficity,0,18,7,11,0,0.636363636363636
desimone,1,8,4,4,0,1
vaticinated,1,11,5,6,0,0.833333333333333
nonabsorptive,1,13,5,8,0,0.625
bundard,0,7,2,5,0,0.4
shoddylike,1,10,3,7,0,0.428571428571429
limacina,1,8,4,4,0,1
unindividuated,1,14,7,7,0,1
jmuiwfmllqwmw,0,13,2,11,0,0.181818181818182
direcrially,0,11,4,7,0,0.571428571428571
shnvjtiwmw,0,10,1,9,0,0.111111111111111
estela,1,6,3,3,0,1
nonimmunised,1,12,5,7,0,0.714285714285714
abilinstructacleascusaraucera,0,29,13,16,0,0.8125
anomaliped,1,10,5,5,0,1
nonconsulters,0,13,4,9,0,0.444444444444444
eaaoxgclhkaafjhdrdrzixjfis,0,26,8,18,0,0.444444444444444
endosome,1,8,4,4,0,1
burgle,1,6,2,4,0,0.5
saxonically,1,11,4,7,0,0.571428571428571
grough,1,6,2,4,0,0.5
turbidity,1,9,3,6,0,0.5
pew,1,3,1,2,0,0.5
panetella,1,9,4,5,0,0.8
helminthici,0,11,4,7,0,0.571428571428571
engnessang,1,10,3,7,0,0.428571428571429
omars,0,5,2,3,0,0.666666666666667
prewless,0,8,2,6,0,0.333333333333333
jacksnipe,1,9,3,6,0,0.5
milivouthoressh,0,15,6,9,0,0.666666666666667
ybprpevvokquxjqtkxzohvr'erntxd,0,30,5,25,1,0.2
merckx,1,6,1,5,0,0.2
emprosthotonos,1,14,5,9,0,0.555555555555556
upvomit,1,7,3,4,0,0.75
chalybeous,1,10,4,6,0,0.666666666666667
latitudinous,1,12,6,6,0,1
redesigned,1,10,4,6,0,0.666666666666667
thirm,0,5,1,4,0,0.25
subcontinual,1,12,5,7,0,0.714285714285714
electrifier,1,11,5,6,0,0.833333333333333
chalkeeper,0,10,4,6,0,0.666666666666667
nationalising,1,13,6,7,0,0.857142857142857
wgamfoddkmbgjn'vci,0,18,3,15,1,0.2
broek,1,5,2,3,0,0.666666666666667
hionith,0,7,3,4,0,0.75
zapodidae,1,9,5,4,0,1.25
bocasine,1,8,4,4,0,1
feeblement,0,10,4,6,0,0.666666666666667
demigrations,1,12,5,7,0,0.714285714285714
hangability,1,11,4,7,0,0.571428571428571
metrarinke,0,10,4,6,0,0.666666666666667
nod,1,3,1,2,0,0.5
flibbertigibbety,1,16,5,11,0,0.454545454545455
scholiastic,1,11,4,7,0,0.571428571428571
lomentaria,1,10,5,5,0,1
urosted,0,7,3,4,0,0.75
leprosarium,1,11,5,6,0,0.833333333333333
affatuate,1,9,5,4,0,1.25
vanisher,1,8,3,5,0,0.6
homopteran,1,10,4,6,0,0.666666666666667
margaux,1,7,3,4,0,0.75
amentula,1,8,4,4,0,1
gennevilliers,1,13,5,8,0,0.625
weaslurus,0,9,4,5,0,0.8
embonpoint,1,10,4,6,0,0.666666666666667
sandglasses,1,11,3,8,0,0.375
blindfishers,0,12,3,9,0,0.333333333333333
julita,1,6,3,3,0,1
microcosmos,1,11,4,7,0,0.571428571428571
spantary,0,8,2,6,0,0.333333333333333
dramela,0,7,3,4,0,0.75
themuses,0,8,3,5,0,0.6
brophory,0,8,2,6,0,0.333333333333333
kie',0,4,2,2,1,1
zobe,1,4,2,2,0,1
unfascinate,1,11,5,6,0,0.833333333333333
canopy,1,6,2,4,0,0.5
pyralidoidea,1,12,6,6,0,1
frisbees,1,8,3,5,0,0.6
splenalgy,1,9,2,7,0,0.285714285714286
saturality,0,10,4,6,0,0.666666666666667
galla,1,5,2,3,0,0.666666666666667
extravailabiogravispecifishes,0,29,13,16,0,0.8125
gkow'llmipmhif,0,14,3,11,1,0.272727272727273
campbellites,1,12,4,8,0,0.5
pyroline,1,8,3,5,0,0.6
bools,1,5,2,3,0,0.666666666666667
chartologic,0,11,4,7,0,0.571428571428571
phytonomy,1,9,2,7,0,0.285714285714286
reachieves,1,10,5,5,0,1
dysart,1,6,1,5,0,0.2
dislionism,0,10,4,6,0,0.666666666666667
permatropic,0,11,4,7,0,0.571428571428571
perigeratoria,0,13,7,6,0,1.16666666666667
latreuse,0,8,4,4,0,1
dgiatrda,0,8,3,5,0,0.6
cttts,0,5,0,5,0,0
kariti,1,6,3,3,0,1
rotterdam,1,9,3,6,0,0.5
richediabjis,0,12,5,7,0,0.714285714285714
gyred,1,5,1,4,0,0.25
aldermanical,1,12,5,7,0,0.714285714285714
begaudy,1,7,3,4,0,0.75
lwdneee,0,7,3,4,0,0.75
nonapprovingiana,0,16,7,9,0,0.777777777777778
commerds,0,8,2,6,0,0.333333333333333
quaternions,1,11,5,6,0,0.833333333333333
ankyloglossini,0,14,5,9,0,0.555555555555556
uncloudy,1,8,3,5,0,0.6
adbqwglie'ynhrcu'ggzgzrgglg,0,27,4,23,2,0.173913043478261
quibblings,1,10,3,7,0,0.428571428571429
reimpact,1,8,3,5,0,0.6
zkhdciqmtqpmhqyjrpbtmq,0,22,1,21,0,0.0476190476190476
rengthe,0,7,2,5,0,0.4
appaquirkingsomed,0,17,7,10,0,0.7
trigornafeaspisetalinghauns,0,27,11,16,0,0.6875
inhis,0,5,2,3,0,0.666666666666667
dasic,0,5,2,3,0,0.666666666666667
w'txymhlxx'zrfuo,0,16,2,14,2,0.142857142857143
cologies,0,8,4,4,0,1
acoustoelectric,1,15,7,8,0,0.875
meejdttnxpeqzodwoj,0,18,5,13,0,0.384615384615385
santonin,1,8,3,5,0,0.6
hytepibeaticit,0,14,6,8,0,0.75
auxoamylamine,0,13,7,6,0,1.16666666666667
wpis,0,4,1,3,0,0.333333333333333
dopped,1,6,2,4,0,0.5
theatrophon,0,11,4,7,0,0.571428571428571
volently,1,8,2,6,0,0.333333333333333
rockably,1,8,2,6,0,0.333333333333333
xnfrantqdsi'le,0,14,3,11,1,0.272727272727273
antitrypsin,1,11,3,8,0,0.375
whhflkpsu,0,9,1,8,0,0.125
rigidity,1,8,3,5,0,0.6
crimmanaria,0,11,5,6,0,0.833333333333333
kadu,1,4,2,2,0,1
akian,0,5,3,2,0,1.5
tabooleys,1,9,4,5,0,0.8
frintiong,0,9,3,6,0,0.5
deindustrialise,1,15,7,8,0,0.875
sidoney,1,7,3,4,0,0.75
importher,0,9,3,6,0,0.5
episiorrhagia,1,13,7,6,0,1.16666666666667
gemmonstandicall,0,16,5,11,0,0.454545454545455
xfzvmaondvaysvgzjuksewsygvk,0,27,5,22,0,0.227272727272727
copumotc',0,9,3,6,1,0.5
weitranalediferoacrunitiousk,0,28,14,14,0,1
himidehotasatic,0,15,7,8,0,0.875
phalacrocorax,1,13,5,8,0,0.625
etindearevillis,0,15,7,8,0,0.875
cxyhiynqdsglsinczjtpfosw,0,24,3,21,0,0.142857142857143
trestlework,1,11,3,8,0,0.375
sideat,0,6,3,3,0,1
archmonarch,1,11,3,8,0,0.375
postless,1,8,2,6,0,0.333333333333333
megacerotinae,0,13,7,6,0,1.16666666666667
deletion,1,8,4,4,0,1
cytotroph,0,9,2,7,0,0.285714285714286
reeve,1,5,3,2,0,1.5
nitudberloisometered,0,20,9,11,0,0.818181818181818
qunenapssessis,0,14,5,9,0,0.555555555555556
carnivals,1,9,3,6,0,0.5
dingen,0,6,2,4,0,0.5
lurgans,0,7,2,5,0,0.4
gastrantarish,0,13,4,9,0,0.444444444444444
kwweujrhqcgvqvnhaswjqmlsmk,0,26,3,23,0,0.130434782608696
thyreoid,1,8,3,5,0,0.6
rye,0,3,1,2,0,0.5
spreezing,1,9,3,6,0,0.5
hesitating,1,10,4,6,0,0.666666666666667
lampleticicoring,0,16,6,10,0,0.6
unbroadcasted,1,13,5,8,0,0.625
liorg,0,5,2,3,0,0.666666666666667
har,0,3,1,2,0,0.5
jwunebxbkdne,0,12,3,9,0,0.333333333333333
psescoectina,0,12,5,7,0,0.714285714285714
podsonstroddyl,0,14,3,11,0,0.272727272727273
camboose,1,8,4,4,0,1
tilvsf,0,6,1,5,0,0.2
missiventry,0,11,3,8,0,0.375
bloodlilit,0,10,4,6,0,0.666666666666667
toadyishnesses,0,14,5,9,0,0.555555555555556
scriver,1,7,2,5,0,0.4
eldfather,1,9,3,6,0,0.5
eudorunix,0,9,5,4,0,1.25
horseheads,1,10,4,6,0,0.666666666666667
burtsbitinomowdyverhinescrodromprecervermotableproushile,0,56,20,36,0,0.555555555555556
yacks,1,5,1,4,0,0.25
demergenced,0,11,4,7,0,0.571428571428571
nagged,1,6,2,4,0,0.5
theocratical,1,12,5,7,0,0.714285714285714
namaqualand,1,11,5,6,0,0.833333333333333
cront,0,5,1,4,0,0.25
velyiningent,0,12,4,8,0,0.5
resellschaft,0,12,3,9,0,0.333333333333333
pgrtekkrznnqvlovlzcllrjjve,0,26,3,23,0,0.130434782608696
superoxylenes,0,13,5,8,0,0.625
nucleolini,1,10,5,5,0,1
gauger,1,6,3,3,0,1
congeological,0,13,6,7,0,0.857142857142857
sivaite,1,7,4,3,0,1.33333333333333
noncooperationist,1,17,8,9,0,0.888888888888889
outrove,1,7,4,3,0,1.33333333333333
balanurian,0,10,5,5,0,1
flatbrod,1,8,2,6,0,0.333333333333333
frfet,0,5,1,4,0,0.25
nonintervention,1,15,6,9,0,0.666666666666667
divulsive,1,9,4,5,0,0.8
serrated,1,8,3,5,0,0.6
cormel,1,6,2,4,0,0.5
shering,0,7,2,5,0,0.4
microbes,1,8,3,5,0,0.6
alumbloom,1,9,4,5,0,0.8
unsubduedly,1,11,4,7,0,0.571428571428571
bhaktapur,1,9,3,6,0,0.5
cunteriseaticabomne,0,19,9,10,0,0.9
tenerity,1,8,3,5,0,0.6
partie,1,6,3,3,0,1
pignerate,1,9,4,5,0,0.8
nauzi,0,5,3,2,0,1.5
kendandass,0,10,3,7,0,0.428571428571429
essancia,1,8,4,4,0,1
microme,0,7,3,4,0,0.75
rommels,0,7,2,5,0,0.4
pontoniers,1,10,4,6,0,0.666666666666667
antipathogen,0,12,5,7,0,0.714285714285714
bretry,0,6,1,5,0,0.2
excludible,1,10,4,6,0,0.666666666666667
clericussations,0,15,6,9,0,0.666666666666667
catholiciser,1,12,5,7,0,0.714285714285714
multifidus,1,10,4,6,0,0.666666666666667
neritidae,1,9,5,4,0,1.25
mononitrobenzene,1,16,7,9,0,0.777777777777778
bonbon,1,6,2,4,0,0.5
spralledine,0,11,4,7,0,0.571428571428571
theomagnetisms,0,14,5,9,0,0.555555555555556
perman,0,6,2,4,0,0.5
badmouthing,1,11,4,7,0,0.571428571428571
lobulousness,0,12,5,7,0,0.714285714285714
jeto,0,4,2,2,0,1
seidlitz,1,8,3,5,0,0.6
lentles,0,7,2,5,0,0.4
hogman,0,6,2,4,0,0.5
houtionde,0,9,5,4,0,1.25
tubiporoid,1,10,5,5,0,1
olociatoverdocantew,0,19,9,10,0,0.9
exaltachi,0,9,4,5,0,0.8
tunnate,0,7,3,4,0,0.75
wolfkins,1,8,2,6,0,0.333333333333333
alkoxide,1,8,4,4,0,1
coulmer,0,7,3,4,0,0.75
preenlikeely,0,12,5,7,0,0.714285714285714
jsfuypue'pepgebbzojghmbl,0,24,6,18,1,0.333333333333333
hypericales,1,11,4,7,0,0.571428571428571
bedeter,0,7,3,4,0,0.75
aliyahaliyahs,1,13,6,7,0,0.857142857142857
barouse,0,7,4,3,0,1.33333333333333
unbraking,1,9,3,6,0,0.5
bannffaghoperuprtunolionseorvesind,0,34,13,21,0,0.619047619047619
flemish,1,7,2,5,0,0.4
unmodificative,1,14,7,7,0,1
iviccs,0,6,2,4,0,0.5
bigamy,1,6,2,4,0,0.5
ultrasonogramed,0,15,6,9,0,0.666666666666667
reindustriation,0,15,7,8,0,0.875
angevalencia,0,12,6,6,0,1
categorizing,0,12,5,7,0,0.714285714285714
decurite,0,8,4,4,0,1
isorpoired,0,10,5,5,0,1
inconvironocalle,0,16,7,9,0,0.777777777777778
appellatively,1,13,5,8,0,0.625
oderalishershan,0,15,6,9,0,0.666666666666667
ricardama,1,9,4,5,0,0.8
rntlararolama,0,13,5,8,0,0.625
gllipho,0,7,2,5,0,0.4
sympetalae,1,10,4,6,0,0.666666666666667
unmaiden,1,8,4,4,0,1
jentrid,0,7,2,5,0,0.4
rmepkownoufs,0,12,4,8,0,0.5
cetelate,0,8,4,4,0,1
queenish,0,8,4,4,0,1
goshawful,1,9,3,6,0,0.5
mullness,0,8,2,6,0,0.333333333333333
baselard,1,8,3,5,0,0.6
koralie,1,7,4,3,0,1.33333333333333
deprophenlinatchobast,0,21,7,14,0,0.5
horse,1,5,2,3,0,0.666666666666667
cultigen,1,8,3,5,0,0.6
farragut,1,8,3,5,0,0.6
ib'vxsuxvujscaxutmmojxks,0,24,6,18,1,0.333333333333333
cropamas,0,8,3,5,0,0.6
retropoleis,0,11,5,6,0,0.833333333333333
gxcjpkfpy'airw',0,15,2,13,2,0.153846153846154
impact,1,6,2,4,0,0.5
busiglous,0,9,4,5,0,0.8
doctrine,1,8,3,5,0,0.6
unfrock,1,7,2,5,0,0.4
spiegeleisen,1,12,6,6,0,1
boongary,1,8,3,5,0,0.6
status,1,6,2,4,0,0.5
brichec,0,7,2,5,0,0.4
untruckling,1,11,3,8,0,0.375
oqjcjgmrfulphotn,0,16,3,13,0,0.230769230769231
exceptionary,1,12,5,7,0,0.714285714285714
strime,0,6,2,4,0,0.5
chamiarrin,0,10,4,6,0,0.666666666666667
q'ydisjxvr,0,10,1,9,1,0.111111111111111
squandermaniac,1,14,6,8,0,0.75
rrblashele,0,10,3,7,0,0.428571428571429
reprehened,0,10,4,6,0,0.666666666666667
phonabexscty,0,12,3,9,0,0.333333333333333
wilbar,1,6,2,4,0,0.5
cahons,0,6,2,4,0,0.5
confabulated,1,12,5,7,0,0.714285714285714
reinspirits,1,11,4,7,0,0.571428571428571
unclassificated,0,15,6,9,0,0.666666666666667
ainteigadfatia,0,14,8,6,0,1.33333333333333
ironmaster,1,10,4,6,0,0.666666666666667
rokmgdlpjmsbehwjp,0,17,2,15,0,0.133333333333333
manteo,1,6,3,3,0,1
hubboestoioparittyc,0,19,8,11,0,0.727272727272727
stocoelight,0,11,4,7,0,0.571428571428571
slogouns,0,8,3,5,0,0.6
ninwork,0,7,2,5,0,0.4
hectory,0,7,2,5,0,0.4
sto,0,3,1,2,0,0.5
dreed,1,5,2,3,0,0.666666666666667
outtinkling,1,11,4,7,0,0.571428571428571
inoculated,1,10,5,5,0,1
tzutuhil,1,8,3,5,0,0.6
trophottings,0,12,3,9,0,0.333333333333333
undeparatophone,0,15,7,8,0,0.875
aftereyeing,1,11,5,6,0,0.833333333333333
bledicors,0,9,3,6,0,0.5
ctyganects,0,10,2,8,0,0.25
pirameatian,0,11,6,5,0,1.2
sweetkins,1,9,3,6,0,0.5
blickey,1,7,2,5,0,0.4
dowbleddrhuclyalarkntithaka,0,27,8,19,0,0.421052631578947
ilus,0,4,2,2,0,1
instaidness,0,11,4,7,0,0.571428571428571
melote,1,6,3,3,0,1
firebrant,0,9,3,6,0,0.5
moorberry,1,9,3,6,0,0.5
disinfectant,1,12,4,8,0,0.5
herower,0,7,3,4,0,0.75
incorrupted,1,11,4,7,0,0.571428571428571
bellied,1,7,3,4,0,0.75
mokintiverle,0,12,5,7,0,0.714285714285714
searcloth,1,9,3,6,0,0.5
reevection,0,10,5,5,0,1
burdensome,1,10,4,6,0,0.666666666666667
organtic,0,8,3,5,0,0.6
hirenerat,0,9,4,5,0,0.8
otes,1,4,2,2,0,1
icoriums,0,8,4,4,0,1
ultrarapid,1,10,4,6,0,0.666666666666667
automobiled,1,11,6,5,0,1.2
clauddetta,1,10,4,6,0,0.666666666666667
radioman,1,8,4,4,0,1
pennalisms,1,10,3,7,0,0.428571428571429
devinna,1,7,3,4,0,0.75
zels,1,4,1,3,0,0.333333333333333
cytherea,1,8,3,5,0,0.6
misdials,1,8,3,5,0,0.6
sermonist,1,9,3,6,0,0.5
oralfue,0,7,4,3,0,1.33333333333333
adiknybbyxm,0,11,2,9,0,0.222222222222222
ixfshjjyclkrphkjvktq,0,20,1,19,0,0.0526315789473684
semipiousness,1,13,6,7,0,0.857142857142857
periphrygians,0,13,4,9,0,0.444444444444444
nonprivileged,1,13,5,8,0,0.625
necklike,1,8,3,5,0,0.6
streneriatenicktiavindengglleyorifixarejapyotr,0,46,18,28,0,0.642857142857143
irj,0,3,1,2,0,0.5
diipenates,1,10,5,5,0,1
outwriggled,1,11,4,7,0,0.571428571428571
skimmington,1,11,3,8,0,0.375
peaberries,1,10,5,5,0,1
gly,0,3,0,3,0,0
niuean,1,6,4,2,0,2
catrosepiped,0,12,5,7,0,0.714285714285714
overseriously,1,13,6,7,0,0.857142857142857
subcomputations,1,15,6,9,0,0.666666666666667
pantonaccum,0,11,4,7,0,0.571428571428571
gyropilot,1,9,3,6,0,0.5
hnrjbxzozrcxamgtoyw,0,19,3,16,0,0.1875
steeve,1,6,3,3,0,1
earilinspiring,0,14,6,8,0,0.75
sorecognitobiologiest,0,21,10,11,0,0.909090909090909
sciamachy,1,9,3,6,0,0.5
dissymmetricality,0,17,5,12,0,0.416666666666667
pongess,0,7,2,5,0,0.4
fainters,1,8,3,5,0,0.6
reglossianises,0,14,6,8,0,0.75
dyswuyheytv'bwvbmsijtfjj',0,25,3,22,2,0.136363636363636
yfyduv'wmtlytcbxaouqxxfhm,0,25,4,21,1,0.19047619047619
troubadourist,1,13,6,7,0,0.857142857142857
wn,0,2,0,2,0,0
betti,1,5,2,3,0,0.666666666666667
sauncy,1,6,2,4,0,0.5
manihot,1,7,3,4,0,0.75
thouse,1,6,3,3,0,1
appreciatorily,1,14,6,8,0,0.75
enced,0,5,2,3,0,0.666666666666667
'tiytkaznxbz,0,12,2,10,1,0.2
isohyetal,1,9,4,5,0,0.8
crasin,0,6,2,4,0,0.5
abscissa,1,8,3,5,0,0.6
ostia,1,5,3,2,0,1.5
waitstaff,1,9,3,6,0,0.5
yinchmoo,0,8,3,5,0,0.6
elyse,1,5,2,3,0,0.666666666666667
telepathising,1,13,5,8,0,0.625
aerobusses,1,10,5,5,0,1
mcminutive,0,10,4,6,0,0.666666666666667
viridissa,1,9,4,5,0,0.8
autocarpial,0,11,6,5,0,1.2
pheboicabillaniting,0,19,8,11,0,0.727272727272727
geronomite,1,10,5,5,0,1
jesuist,1,7,3,4,0,0.75
hippienesses,1,12,5,7,0,0.714285714285714
feverberry,1,10,3,7,0,0.428571428571429
viragi,0,6,3,3,0,1
liverleaveningshade,0,19,8,11,0,0.727272727272727
equener,0,7,4,3,0,1.33333333333333
ifulvenorraticuneseringnetigrgges,0,33,13,20,0,0.65
contating,0,9,3,6,0,0.5
burcuros,0,8,3,5,0,0.6
rhythmies,0,9,2,7,0,0.285714285714286
pida,0,4,2,2,0,1
correkee,0,8,4,4,0,1
zpeziqpaht,0,10,3,7,0,0.428571428571429
alcmene,1,7,3,4,0,0.75
sihasapa,1,8,4,4,0,1
sansk,1,5,1,4,0,0.25
buarerocarorexichesussy,0,23,10,13,0,0.769230769230769
eparblnuhvkmsittsi,0,18,5,13,0,0.384615384615385
hypervitalicyl,0,14,4,10,0,0.4
harpsichord,1,11,3,8,0,0.375
nonreverently,1,13,4,9,0,0.444444444444444
aphyllanthaceae,1,15,6,9,0,0.666666666666667
pgrel'niozmez'h,0,15,4,11,2,0.363636363636364
outproduceable,0,14,7,7,0,1
syncopating,1,11,3,8,0,0.375
nonbelligerency,1,15,5,10,0,0.5
optatives,1,9,4,5,0,0.8
haex,0,4,2,2,0,1
pqrikstehsvecyet,0,16,4,12,0,0.333333333333333
debutes,0,7,3,4,0,0.75
crystallogeny,1,13,3,10,0,0.3
qjb,0,3,0,3,0,0
percuttermobility,0,17,6,11,0,0.545454545454545
napoleonist,1,11,5,6,0,0.833333333333333
leptoty,0,7,2,5,0,0.4
storages,1,8,3,5,0,0.6
mozzetta,1,8,3,5,0,0.6
votiveness,1,10,4,6,0,0.666666666666667
abaddie,0,7,4,3,0,1.33333333333333
payn,0,4,1,3,0,0.333333333333333
cephallical,0,11,4,7,0,0.571428571428571
yosahokli,0,9,4,5,0,0.8
lidar,1,5,2,3,0,0.666666666666667
netterousnes,0,12,5,7,0,0.714285714285714
leachous,0,8,4,4,0,1
arass,0,5,2,3,0,0.666666666666667
panspermists,1,12,3,9,0,0.333333333333333
paulinistically,1,15,6,9,0,0.666666666666667
wuproueres,0,10,5,5,0,1
pf,1,2,0,2,0,0
sociability,1,11,5,6,0,0.833333333333333
alid,0,4,2,2,0,1
babweapelmined,0,14,6,8,0,0.75
falsers,1,7,2,5,0,0.4
subscriber,1,10,3,7,0,0.428571428571429
padklb,0,6,1,5,0,0.2
mesodermaged,0,12,5,7,0,0.714285714285714
zooxanthine,0,11,5,6,0,0.833333333333333
antimodernity,0,13,5,8,0,0.625
swordsmanship,1,13,3,10,0,0.3
arethuse,1,8,4,4,0,1
anglophobe,1,10,4,6,0,0.666666666666667
disoperator,0,11,5,6,0,0.833333333333333
retrim,1,6,2,4,0,0.5
panial,0,6,3,3,0,1
anning,0,6,2,4,0,0.5
protonematoid,1,13,6,7,0,0.857142857142857
extratympanic,1,13,4,9,0,0.444444444444444
quereolastallourelmingall,0,25,11,14,0,0.785714285714286
gulitalceartaitipoida,0,21,11,10,0,1.1
eliaheraliafon,0,14,8,6,0,1.33333333333333
maximums,1,8,3,5,0,0.6
scrymatistrametiandenced,0,24,8,16,0,0.5
equitarism,0,10,5,5,0,1
lindberg,1,8,2,6,0,0.333333333333333
superstition,1,12,5,7,0,0.714285714285714
rattinesses,1,11,4,7,0,0.571428571428571
tremellales,1,11,4,7,0,0.571428571428571
extenuator,1,10,5,5,0,1
lmvhbugf,0,8,1,7,0,0.142857142857143
turividanviswanysunes,0,21,8,13,0,0.615384615384615
telesales,1,9,4,5,0,0.8
priapuses,1,9,4,5,0,0.8
desposes,0,8,3,5,0,0.6
sewes,0,5,2,3,0,0.666666666666667
cers,0,4,1,3,0,0.333333333333333
revolute,1,8,4,4,0,1
chiefship,1,9,3,6,0,0.5
cfjdjbozurogtwzfj'rouxj,0,23,5,18,1,0.277777777777778
dorsiventralities,1,17,7,10,0,0.7
tfadzmogyxzzftcvl,0,17,2,15,0,0.133333333333333
ochroma,1,7,3,4,0,0.75
prpattosta,0,10,3,7,0,0.428571428571429
unri,0,4,2,2,0,1
unfart,0,6,2,4,0,0.5
gondivile,0,9,4,5,0,0.8
jamdanis,1,8,3,5,0,0.6
heterodyning,1,12,4,8,0,0.5
peristalses,1,11,4,7,0,0.571428571428571
miratoxeness,0,12,5,7,0,0.714285714285714
anociation,1,10,6,4,0,1.5
qrrco'lsagghxtum'wmrlwqckyj,0,27,3,24,2,0.125
laue,1,4,3,1,0,3
nightriding,1,11,3,8,0,0.375
abruzzi,1,7,3,4,0,0.75
silva,1,5,2,3,0,0.666666666666667
dayanim,1,7,3,4,0,0.75
coquilhatville,1,14,6,8,0,0.75
lognesterring,0,13,4,9,0,0.444444444444444
leffen,1,6,2,4,0,0.5
unpossibly,1,10,3,7,0,0.428571428571429
cansfusionlessly,0,16,5,11,0,0.454545454545455
irreversiblenesses,1,18,7,11,0,0.636363636363636
ctivelinc,0,9,3,6,0,0.5
perap,0,5,2,3,0,0.666666666666667
capacitate,1,10,5,5,0,1
pondfulness,0,11,3,8,0,0.375
poleless,1,8,3,5,0,0.6
hcbb'e'ioa,0,10,4,6,2,0.666666666666667
chopharrimler,0,13,4,9,0,0.444444444444444
nerbuddie,0,9,4,5,0,0.8
jlogeinfdde,0,11,4,7,0,0.571428571428571
loyde,1,5,2,3,0,0.666666666666667
iibc'qkyksrkaosvkuwjytxa,0,24,6,18,1,0.333333333333333
ingnue,1,6,3,3,0,1
blatt,1,5,1,4,0,0.25
salinan,1,7,3,4,0,0.75
xwsotsykpquhwo,0,14,3,11,0,0.272727272727273
aligurlane,0,10,5,5,0,1
trirement,0,9,3,6,0,0.5
scripterons,0,11,3,8,0,0.375
etants,0,6,2,4,0,0.5
forgiellhdringlarbumake,0,23,8,15,0,0.533333333333333
lollygags,1,9,2,7,0,0.285714285714286
stracent,0,8,2,6,0,0.333333333333333
mindofure,0,9,4,5,0,0.8
chedra,0,6,2,4,0,0.5
alamate,0,7,4,3,0,1.33333333333333
overpoweringly,1,14,5,9,0,0.555555555555556
unidolised,1,10,5,5,0,1
pasang,1,6,2,4,0,0.5
epiblastic,1,10,4,6,0,0.666666666666667
ndifogouneeapa,0,14,8,6,0,1.33333333333333
monsigned,0,9,3,6,0,0.5
impresetties,0,12,5,7,0,0.714285714285714
gfttskwlnxxkcohnt''eigjd,0,24,3,21,2,0.142857142857143
auximon,0,7,4,3,0,1.33333333333333
superoanterior,1,14,7,7,0,1
proteinem,0,9,4,5,0,0.8
promotion,1,9,4,5,0,0.8
cowpoke,1,7,3,4,0,0.75
afterhug,0,8,3,5,0,0.6
uncoronaries,0,12,6,6,0,1
barna,1,5,2,3,0,0.666666666666667
virginality,0,11,4,7,0,0.571428571428571
gomes,0,5,2,3,0,0.666666666666667
peridinidae,1,11,6,5,0,1.2
xogkstofgmikbjnvqpld,0,20,3,17,0,0.176470588235294
demicirque,0,10,5,5,0,1
preminis,0,8,3,5,0,0.6
rhizoid,1,7,3,4,0,0.75
scytosis,0,8,2,6,0,0.333333333333333
excogitating,1,12,5,7,0,0.714285714285714
reflector,1,9,3,6,0,0.5
ving,0,4,1,3,0,0.333333333333333
curarinesses,0,12,5,7,0,0.714285714285714
disings,0,7,2,5,0,0.4
insatiability,1,13,6,7,0,0.857142857142857
pecht,1,5,1,4,0,0.25
lekythos,1,8,2,6,0,0.333333333333333
deverbative,1,11,5,6,0,0.833333333333333
ilabur,0,6,3,3,0,1
kejkbgbuatuogytxknnmwqfptwyy,0,28,5,23,0,0.217391304347826
paraphysate,1,11,4,7,0,0.571428571428571
zahqnuri,0,8,3,5,0,0.6
chroococcus,1,11,4,7,0,0.571428571428571
glucuronide,1,11,5,6,0,0.833333333333333
liquesces,1,9,4,5,0,0.8
undercanopy,1,11,4,7,0,0.571428571428571
machmetha,0,9,3,6,0,0.5
delphing,0,8,2,6,0,0.333333333333333
rtenonontonttrwithancs,0,22,6,16,0,0.375
reavouchments,0,13,5,8,0,0.625
copake,1,6,3,3,0,1
metairistical,0,13,6,7,0,0.857142857142857
ketal,1,5,2,3,0,0.666666666666667
appraiser,1,9,4,5,0,0.8
knitter,1,7,2,5,0,0.4
'cdhndrlzybg,0,12,0,12,1,0
sphygmoplast,0,12,2,10,0,0.2
milk,1,4,1,3,0,0.333333333333333
kerry,1,5,1,4,0,0.25
pumietetutad,0,12,6,6,0,1
gingyctronele,0,13,4,9,0,0.444444444444444
scrately,0,8,2,6,0,0.333333333333333
wisches,0,7,2,5,0,0.4
hydrometamorphism,1,17,5,12,0,0.416666666666667
awwromb'czgejpmvehmsalubssye,0,28,7,21,1,0.333333333333333
chemoprotein,0,12,5,7,0,0.714285714285714
trebuccanies,0,12,5,7,0,0.714285714285714
checklist,1,9,2,7,0,0.285714285714286
rhetorise,1,9,4,5,0,0.8
eurocarpies,0,11,6,5,0,1.2
leppiest,0,8,3,5,0,0.6
aej'lkaxvcrlowda,0,16,5,11,1,0.454545454545455
nonchine,0,8,3,5,0,0.6
tastefulness,1,12,4,8,0,0.5
footfaultless,0,13,5,8,0,0.625
enntenenodellidu,0,16,7,9,0,0.777777777777778
hartourgeous,0,12,6,6,0,1
ryfbzzbusdzshmizapvnbe,0,22,4,18,0,0.222222222222222
wose,0,4,2,2,0,1
unflag,0,6,2,4,0,0.5
insentiency,1,11,4,7,0,0.571428571428571
quasipartite,0,12,6,6,0,1
bcfxxa'ehg,0,10,2,8,1,0.25
oca,1,3,2,1,0,2
gimcrack,1,8,2,6,0,0.333333333333333
appender,1,8,3,5,0,0.6
sinciput,1,8,3,5,0,0.6
tricalycural,0,12,4,8,0,0.5
perisoma,1,8,4,4,0,1
ovet,0,4,2,2,0,1
kinder,1,6,2,4,0,0.5
tortrices,1,9,3,6,0,0.5
amba,1,4,2,2,0,1
sambo,1,5,2,3,0,0.666666666666667
liendes,0,7,3,4,0,0.75
odenvillaminable,0,16,7,9,0,0.777777777777778
microcodilia,0,12,6,6,0,1
withy,1,5,1,4,0,0.25
pseudousness,0,12,5,7,0,0.714285714285714
aquone,1,6,4,2,0,2
lawbook,1,7,3,4,0,0.75
auqjqx,0,6,2,4,0,0.5
rheobase,1,8,4,4,0,1
seminto,0,7,3,4,0,0.75
lugubium,0,8,4,4,0,1
pareos,1,6,3,3,0,1
communicatally,0,14,5,9,0,0.555555555555556
balkane,0,7,3,4,0,0.75
pentiodide,1,10,5,5,0,1
bulsejet,0,8,3,5,0,0.6
brassfoundings,1,14,4,10,0,0.4
connochaetes,1,12,5,7,0,0.714285714285714
pascale,1,7,3,4,0,0.75
effeminately,1,12,5,7,0,0.714285714285714
mallin,1,6,2,4,0,0.5
stonyford,1,9,2,7,0,0.285714285714286
licastro,1,8,3,5,0,0.6
calmend,0,7,2,5,0,0.4
ame,1,3,2,1,0,2
mesostoma,1,9,4,5,0,0.8
bidations,0,9,4,5,0,0.8
hulkily,1,7,2,5,0,0.4
horometer,1,9,4,5,0,0.8
kiredis,0,7,3,4,0,0.75
deutheringlence,0,15,6,9,0,0.666666666666667
cwgfnwk,0,7,0,7,0,0
eupolyzoan,1,10,5,5,0,1
dilutor,1,7,3,4,0,0.75
mordelloid,1,10,4,6,0,0.666666666666667
quadratrix,1,10,4,6,0,0.666666666666667
hised,0,5,2,3,0,0.666666666666667
zanthoxylum,1,11,3,8,0,0.375
tohatchi,1,8,3,5,0,0.6
subun,0,5,2,3,0,0.666666666666667
anaerobioses,1,12,7,5,0,1.4
anagers,0,7,3,4,0,0.75
agistment,1,9,3,6,0,0.5
overbless,0,9,3,6,0,0.5
acism,0,5,2,3,0,0.666666666666667
alexiler,0,8,4,4,0,1
blyioslatele,0,12,5,7,0,0.714285714285714
nscyilaledo,0,11,4,7,0,0.571428571428571
resensation,0,11,5,6,0,0.833333333333333
chite,0,5,2,3,0,0.666666666666667
outbacks,1,8,3,5,0,0.6
welldoo,0,7,3,4,0,0.75
ibidingly,0,9,3,6,0,0.5
corallum,1,8,3,5,0,0.6
racreriswng,0,11,3,8,0,0.375
neepandemium,0,12,6,6,0,1
mecca,1,5,2,3,0,0.666666666666667
poseck,0,6,2,4,0,0.5
tremolando,1,10,4,6,0,0.666666666666667
overableness,0,12,5,7,0,0.714285714285714
sinistrorse,1,11,4,7,0,0.571428571428571
trollo,0,6,2,4,0,0.5
colliculate,1,11,5,6,0,0.833333333333333
mylodon,1,7,2,5,0,0.4
firked,1,6,2,4,0,0.5
uromere,1,7,4,3,0,1.33333333333333
beabled,0,7,3,4,0,0.75
bromination,1,11,5,6,0,0.833333333333333
accessoriness,1,13,5,8,0,0.625
aless,0,5,2,3,0,0.666666666666667
orren,1,5,2,3,0,0.666666666666667
flashes,1,7,2,5,0,0.4
a'dyyuapudcrlipranmiiy,0,22,8,14,1,0.571428571428571
mitiffoleas,0,11,5,6,0,0.833333333333333
stular,0,6,2,4,0,0.5
sterization,0,11,5,6,0,0.833333333333333
uncolant,0,8,3,5,0,0.6
cizwlsnfvcigezpdi,0,17,4,13,0,0.307692307692308
extri,0,5,2,3,0,0.666666666666667
vmrozmvedboc'nd,0,15,3,12,1,0.25
jmlgaz'uiuwqkc,0,14,4,10,1,0.4
synangia,1,8,3,5,0,0.6
rescores,1,8,3,5,0,0.6
petechia,1,8,4,4,0,1
essentialist,1,12,5,7,0,0.714285714285714
yearningly,1,10,3,7,0,0.428571428571429
backaw,0,6,2,4,0,0.5
waister,1,7,3,4,0,0.75
pujmeyuuaq,0,10,5,5,0,1
chalassoed,0,10,4,6,0,0.666666666666667
huckaback,1,9,3,6,0,0.5
benedikt,1,8,3,5,0,0.6
overconfident,1,13,5,8,0,0.625
asianization,1,12,7,5,0,1.4
vinaigued,0,9,5,4,0,1.25
dylana,1,6,2,4,0,0.5
straightedges,1,13,4,9,0,0.444444444444444
bbpxyc'avbevoljj,0,16,3,13,1,0.230769230769231
trypetid,1,8,2,6,0,0.333333333333333
almadan,1,7,3,4,0,0.75
arederickers,0,12,5,7,0,0.714285714285714
vituperadvantarctic,0,19,7,12,0,0.583333333333333
huzzas,1,6,2,4,0,0.5
calamitotic,0,11,5,6,0,0.833333333333333
namopointersificalled,0,21,9,12,0,0.75
bathomeboat,0,11,5,6,0,0.833333333333333
hebraicise,1,10,5,5,0,1
yhcy,0,4,0,4,0,0
glycolipide,1,11,4,7,0,0.571428571428571
madzoon,1,7,3,4,0,0.75
kricteingly,0,11,3,8,0,0.375
overplussite,0,12,5,7,0,0.714285714285714
heaty,0,5,2,3,0,0.666666666666667
itamalate,1,9,5,4,0,1.25
jtfhed,0,6,1,5,0,0.2
pocitulmonatie,0,14,7,7,0,1
enticeship,0,10,4,6,0,0.666666666666667
truditor,0,8,3,5,0,0.6
pointlessness,1,13,4,9,0,0.444444444444444
improbabilities,1,15,7,8,0,0.875
bologically,0,11,4,7,0,0.571428571428571
proroubline,0,11,5,6,0,0.833333333333333
ogunquit,1,8,4,4,0,1
redeliveries,1,12,6,6,0,1
paxillae,1,8,4,4,0,1
armied,1,6,3,3,0,1
contum,0,6,2,4,0,0.5
ptgks,0,5,0,5,0,0
datic,0,5,2,3,0,0.666666666666667
corers,1,6,2,4,0,0.5
phantasmagory,1,13,4,9,0,0.444444444444444
perishability,1,13,5,8,0,0.625
subsoilers,1,10,4,6,0,0.666666666666667
toyally,0,7,2,5,0,0.4
communicableness,1,16,6,10,0,0.6
libonucleotide,0,14,7,7,0,1
ataxiameter,1,11,6,5,0,1.2
baperycarnicamauseninatisscanend,0,32,13,19,0,0.684210526315789
herboat,0,7,3,4,0,0.75
orthographicalnesses,0,20,7,13,0,0.538461538461538
saturatory,0,10,4,6,0,0.666666666666667
lcbxrrrfwgkeskifboni'db,0,23,4,19,1,0.210526315789474
summerhouse,1,11,5,6,0,0.833333333333333
tympanoperiotic,1,15,6,9,0,0.666666666666667
prosas,0,6,2,4,0,0.5
pyej'''pqaydw,0,13,2,11,3,0.181818181818182
inutimuts,0,9,4,5,0,0.8
reers,0,5,2,3,0,0.666666666666667
antichlorine,1,12,5,7,0,0.714285714285714
brd,0,3,0,3,0,0
achafe,1,6,3,3,0,1
vicitally,0,9,3,6,0,0.5
italicism,1,9,4,5,0,0.8
hatemonger,1,10,4,6,0,0.666666666666667
pedersen,1,8,3,5,0,0.6
occur,1,5,2,3,0,0.666666666666667
triethylstilbestrols,0,20,5,15,0,0.333333333333333
unnesia,0,7,4,3,0,1.33333333333333
gcammisiasseifore,0,17,8,9,0,0.888888888888889
tabors,1,6,2,4,0,0.5
palicourea,1,10,6,4,0,1.5
wmdzoezvwrpf,0,12,2,10,0,0.2
plet,0,4,1,3,0,0.333333333333333
drenneidlead,0,12,5,7,0,0.714285714285714
revaluated,1,10,5,5,0,1
preshipping,1,11,3,8,0,0.375
higdon,1,6,2,4,0,0.5
inderallchetenessely,0,20,7,13,0,0.538461538461538
ermalinda,1,9,4,5,0,0.8
xthtywkbyhf',0,12,0,12,1,0
arenigging,0,10,4,6,0,0.666666666666667
unchangers,0,10,3,7,0,0.428571428571429
ypolentawemipan,0,15,6,9,0,0.666666666666667
tontaciprcanoming,0,17,6,11,0,0.545454545454545
clodhopperish,1,13,4,9,0,0.444444444444444
phosphine,1,9,3,6,0,0.5
fountably,0,9,3,6,0,0.5
indiligence,1,11,5,6,0,0.833333333333333
nimoliegastrocia,0,16,8,8,0,1
anthropoiesis,0,13,6,7,0,0.857142857142857
upwheel,1,7,3,4,0,0.75
sylvicolidae,1,12,5,7,0,0.714285714285714
splenopexia,1,11,5,6,0,0.833333333333333
acroblacrentagermlesse,0,22,8,14,0,0.571428571428571
princessly,1,10,2,8,0,0.25
skinfood,1,8,3,5,0,0.6
'l'uihnldbnhdliai,0,17,5,12,2,0.416666666666667
winceyette,1,10,4,6,0,0.666666666666667
theres,1,6,2,4,0,0.5
nishaicyass,0,11,4,7,0,0.571428571428571
nonruminant,1,11,4,7,0,0.571428571428571
declassed,1,9,3,6,0,0.5
kirgless,0,8,2,6,0,0.333333333333333
unsnapballed,0,12,4,8,0,0.5
quytes,1,6,2,4,0,0.5
britinointipicu,0,15,7,8,0,0.875
chassels,0,8,2,6,0,0.333333333333333
chatterygotiativenesses,0,23,9,14,0,0.642857142857143
punkest,1,7,2,5,0,0.4
discerptions,1,12,4,8,0,0.5
ribcage,1,7,3,4,0,0.75
dawbry,1,6,1,5,0,0.2
conversating,0,12,4,8,0,0.5
superiologists,0,14,6,8,0,0.75
oscillos,0,8,3,5,0,0.6
bobble,1,6,2,4,0,0.5
trashiness,1,10,3,7,0,0.428571428571429
tonina,1,6,3,3,0,1
unaccouplit,0,11,5,6,0,0.833333333333333
disputtins,0,10,3,7,0,0.428571428571429
adansonia,1,9,5,4,0,1.25
edmontifiedness,0,15,6,9,0,0.666666666666667
pseudobulb,1,10,4,6,0,0.666666666666667
picing,0,6,2,4,0,0.5
bretwalda,1,9,3,6,0,0.5
shoddia,0,7,3,4,0,0.75
ethiodynamogal,0,14,6,8,0,0.75
ilwyciugdd,0,10,3,7,0,0.428571428571429
tricovination,0,13,6,7,0,0.857142857142857
animatic,1,8,4,4,0,1
alondectes,0,10,4,6,0,0.666666666666667
followings,1,10,3,7,0,0.428571428571429
lambyx,0,6,1,5,0,0.2
tertoveunolodntebicodnte,0,24,10,14,0,0.714285714285714
asms,0,4,1,3,0,0.333333333333333
platyrrhiny,1,11,2,9,0,0.222222222222222
uriveloune,0,10,6,4,0,1.5
untremulant,1,11,4,7,0,0.571428571428571
siephobrine,0,11,5,6,0,0.833333333333333
unparbiquitang,0,14,6,8,0,0.75
aerenchyma,1,10,4,6,0,0.666666666666667
oversubtlety,1,12,4,8,0,0.5
gaminesses,1,10,4,6,0,0.666666666666667
klongs,1,6,1,5,0,0.2
precensured,1,11,4,7,0,0.571428571428571
bedder,1,6,2,4,0,0.5
atherationality,0,15,7,8,0,0.875
quirement,0,9,4,5,0,0.8
prehenne,0,8,3,5,0,0.6
p'angbburuvhw,0,13,3,10,1,0.3
amoxibusterstandsters,0,21,7,14,0,0.5
circumstantiviral,0,17,6,11,0,0.545454545454545
perforator,1,10,4,6,0,0.666666666666667
immuration,1,10,5,5,0,1
samotherium,1,11,5,6,0,0.833333333333333
cfsq,0,4,0,4,0,0
cijpksvmtibsls,0,14,2,12,0,0.166666666666667
thamnium,1,8,3,5,0,0.6
evulgarlicking,0,14,5,9,0,0.555555555555556
nester,1,6,2,4,0,0.5
wrectinglor,0,11,3,8,0,0.375
bumemamanabrwdoupt,0,18,7,11,0,0.636363636363636
perceptiveness,1,14,5,9,0,0.555555555555556
chounes,0,7,3,4,0,0.75
prosstoa,1,8,3,5,0,0.6
lipsticks,1,9,2,7,0,0.285714285714286
hogging,1,7,2,5,0,0.4
lophophorine,1,12,5,7,0,0.714285714285714
simul,1,5,2,3,0,0.666666666666667
subpolygonatum,0,14,5,9,0,0.555555555555556
lite,1,4,2,2,0,1
bummer,1,6,2,4,0,0.5
crest,1,5,1,4,0,0.25
cruciating,1,10,4,6,0,0.666666666666667
emidlnfiolvc'nebjnxxiq,0,22,6,16,1,0.375
acceleroblasts,0,14,5,9,0,0.555555555555556
brittanic,1,9,3,6,0,0.5
porthron,0,8,2,6,0,0.333333333333333
interseminates,0,14,6,8,0,0.75
caradon,1,7,3,4,0,0.75
antomorph,0,9,3,6,0,0.5
quomodos,1,8,4,4,0,1
nonreplacement,1,14,5,9,0,0.555555555555556
baudrick,1,8,3,5,0,0.6
justinianean,1,12,6,6,0,1
dottle,1,6,2,4,0,0.5
autocephalus,0,12,6,6,0,1
jibwometaploid,0,14,6,8,0,0.75
caroaches,1,9,4,5,0,0.8
spondyls,1,8,1,7,0,0.142857142857143
teliferous,1,10,5,5,0,1
nonmutually,1,11,4,7,0,0.571428571428571
proempiricist,1,13,5,8,0,0.625
populser,0,8,3,5,0,0.6
ammey,0,5,2,3,0,0.666666666666667
hogmentanences,0,14,5,9,0,0.555555555555556
wwuzrhhid'uuhmvhawsyk,0,21,5,16,1,0.3125
phlebiting,0,10,3,7,0,0.428571428571429
mesprises,1,9,3,6,0,0.5
inturns,1,7,2,5,0,0.4
dubuncole,0,9,4,5,0,0.8
voiturin,1,8,4,4,0,1
reponed,1,7,3,4,0,0.75
chittings,0,9,2,7,0,0.285714285714286
recarociaw,0,10,5,5,0,1
reborrows,1,9,3,6,0,0.5
supernaculums,1,13,5,8,0,0.625
nonconfluenza,0,13,5,8,0,0.625
waypner,0,7,2,5,0,0.4
kapellmeister,1,13,5,8,0,0.625
vendaval,1,8,3,5,0,0.6
allium,1,6,3,3,0,1
polyteridemasils,0,16,6,10,0,0.6
prostindeenwreis,0,16,6,10,0,0.6
girtline,1,8,3,5,0,0.6
reobtains,1,9,4,5,0,0.8
suckbussubgle,0,13,4,9,0,0.444444444444444
nonfle,0,6,2,4,0,0.5
nonguests,1,9,3,6,0,0.5
unswearescer,0,12,5,7,0,0.714285714285714
sinaitic,1,8,4,4,0,1
snarliamenism,0,13,5,8,0,0.625
apocentre,1,9,4,5,0,0.8
c'xoohmgwn,0,10,2,8,1,0.25
scabriusculose,1,14,6,8,0,0.75
zoototemism,1,11,5,6,0,0.833333333333333
uilealilunttaerakerapinewelacis,0,31,16,15,0,1.06666666666667
limbeck,1,7,2,5,0,0.4
proped,0,6,2,4,0,0.5
chemstrand,1,10,2,8,0,0.25
dicoumarins,1,11,5,6,0,0.833333333333333
nodanybyrathanterus,0,19,6,13,0,0.461538461538462
nonprever,0,9,3,6,0,0.5
jackhandiest,0,12,4,8,0,0.5
dinnertimes,1,11,4,7,0,0.571428571428571
primulida,0,9,4,5,0,0.8
fagottist,1,9,3,6,0,0.5
pugids,0,6,2,4,0,0.5
straightforwardnesses,1,21,6,15,0,0.4
sarus,1,5,2,3,0,0.666666666666667
barbamol,0,8,3,5,0,0.6
horeyma,0,7,3,4,0,0.75
focsle,1,6,2,4,0,0.5
oftenness,1,9,3,6,0,0.5
patessnes,0,9,3,6,0,0.5
influents,1,9,3,6,0,0.5
mesembryanthemiasciurus,0,23,9,14,0,0.642857142857143
indions,0,7,3,4,0,0.75
maywings,1,8,2,6,0,0.333333333333333
district,1,8,2,6,0,0.333333333333333
ence,0,4,2,2,0,1
overmentasketchicalleggca,0,25,9,16,0,0.5625
regrinderbottidros,0,18,6,12,0,0.5
tottier,1,7,3,4,0,0.75
boulanger,1,9,4,5,0,0.8
cataphasias,0,11,5,6,0,0.833333333333333
mente,0,5,2,3,0,0.666666666666667
zooming,1,7,3,4,0,0.75
tanquiro,0,8,4,4,0,1
endpapers,1,9,3,6,0,0.5
motoneuralgias,0,14,7,7,0,1
hairweavings,1,12,5,7,0,0.714285714285714
factyly,0,7,1,6,0,0.166666666666667
uncentral,0,9,3,6,0,0.5
saddlebrained,0,13,5,8,0,0.625
alcanisations,0,13,6,7,0,0.857142857142857
mestrocoly,0,10,3,7,0,0.428571428571429
proboscidean,1,12,5,7,0,0.714285714285714
paideutic,1,9,5,4,0,1.25
stalued,0,7,3,4,0,0.75
rattlingish,0,11,3,8,0,0.375
mahmal,1,6,2,4,0,0.5
ectosarcous,1,11,5,6,0,0.833333333333333
leus,0,4,2,2,0,1
hyposthenia,1,11,4,7,0,0.571428571428571
ptravgylwlawbq'cdminxtkjqalf,0,28,4,24,1,0.166666666666667
ui,0,2,2,0,0,1
rzolrku'''x''dl,0,15,2,13,5,0.153846153846154
uprist,1,6,2,4,0,0.5
harity,0,6,2,4,0,0.5
pronas,0,6,2,4,0,0.5
loloner,0,7,3,4,0,0.75
ananketed,0,9,4,5,0,0.8
migraphia,0,9,4,5,0,0.8
vegenos,0,7,3,4,0,0.75
tchponism,0,9,2,7,0,0.285714285714286
sphyraenidae,1,12,5,7,0,0.714285714285714
pranonchinderoudninatliommatlllovarethoreringse,0,47,18,29,0,0.620689655172414
karli,1,5,2,3,0,0.666666666666667
misbrandian,0,11,4,7,0,0.571428571428571
flomeds,0,7,2,5,0,0.4
rgebhi,0,6,2,4,0,0.5
baldad,1,6,2,4,0,0.5
yrikquyhktzwcmdxb,0,17,2,15,0,0.133333333333333
completestamarany,0,17,6,11,0,0.545454545454545
bearer,1,6,3,3,0,1
whens,1,5,1,4,0,0.25
hibin,0,5,2,3,0,0.666666666666667
nudnick,1,7,2,5,0,0.4
pulvinni,1,8,3,5,0,0.6
phoch,0,5,1,4,0,0.25
mattrass,1,8,2,6,0,0.333333333333333
bronchaldazine,0,14,5,9,0,0.555555555555556
roccelloid,0,10,4,6,0,0.666666666666667
chucklebone,0,11,4,7,0,0.571428571428571
wgpkshgflwfy',0,13,0,13,1,0
mesodontist,0,11,4,7,0,0.571428571428571
fonvill,0,7,2,5,0,0.4
ponglisedinodw,0,14,5,9,0,0.555555555555556
ocjivkflbflilnp'ojpiwtuapwzd,0,28,7,21,1,0.333333333333333
supererogatory,1,14,6,8,0,0.75
wory,0,4,1,3,0,0.333333333333333
kilter,1,6,2,4,0,0.5
flearbited,0,10,4,6,0,0.666666666666667
nmgfoxwjoujbwrrwntc,0,19,3,16,0,0.1875
overpretonecobium,0,17,8,9,0,0.888888888888889
revette,0,7,3,4,0,0.75
custocks,1,8,2,6,0,0.333333333333333
fugitive,1,8,4,4,0,1
alishacunthosmins,0,17,6,11,0,0.545454545454545
holds,1,5,1,4,0,0.25
hinch,1,5,1,4,0,0.25
unliking,1,8,3,5,0,0.6
unfellowlike,1,12,5,7,0,0.714285714285714
dersintis,0,9,3,6,0,0.5
trhacasurs,0,10,3,7,0,0.428571428571429
algaeology,1,10,5,5,0,1
prrusteedestreereromos,0,22,9,13,0,0.692307692307692
orran,1,5,2,3,0,0.666666666666667
rachauffeusing,0,14,6,8,0,0.75
freemorphilyeable,0,17,7,10,0,0.7
yatopdwqqsjioxehj,0,17,5,12,0,0.416666666666667
unsluices,1,9,4,5,0,0.8
pownies,1,7,3,4,0,0.75
trophic,1,7,2,5,0,0.4
nabalus,1,7,3,4,0,0.75
titian,1,6,3,3,0,1
ans,0,3,1,2,0,0.5
unregurgeries,0,13,6,7,0,0.857142857142857
squatterproof,1,13,5,8,0,0.625
telepath,1,8,3,5,0,0.6
satiewmarkpoterfuluxes,0,22,9,13,0,0.692307692307692
vmrp,0,4,0,4,0,0
jtaoqbphkxpv'ojavoeqcvrs,0,24,6,18,1,0.333333333333333
tendentiousness,1,15,6,9,0,0.666666666666667
coinventing,1,11,4,7,0,0.571428571428571
guwznlctttqvqbqkeva,0,19,3,16,0,0.1875
macariableness,0,14,6,8,0,0.75
entapophysial,1,13,5,8,0,0.625
buxosens,0,8,3,5,0,0.6
agee,1,4,3,1,0,3
unavailful,1,10,5,5,0,1
traletrindocuitltyt,0,19,6,13,0,0.461538461538462
antieugenic,1,11,6,5,0,1.2
sleswick,1,8,2,6,0,0.333333333333333
spheroidisation,1,15,7,8,0,0.875
phithom,1,7,2,5,0,0.4
talker,1,6,2,4,0,0.5
gosporidae,0,10,5,5,0,1
undeparter,0,10,4,6,0,0.666666666666667
ananda,1,6,3,3,0,1
polymerisation,1,14,6,8,0,0.75
wometowess,0,10,4,6,0,0.666666666666667
vassily,1,7,2,5,0,0.4
ruteriform,0,10,4,6,0,0.666666666666667
curandero,1,9,4,5,0,0.8
sphermenism,0,11,3,8,0,0.375
unford,0,6,2,4,0,0.5
avulte,0,6,3,3,0,1
tred,0,4,1,3,0,0.333333333333333
acanagen,0,8,4,4,0,1
arquated,1,8,4,4,0,1
ossmaxmbkmeqlqsvayaurb,0,22,6,16,0,0.375
unrecognised,1,12,5,7,0,0.714285714285714
vvforzoummr,0,11,3,8,0,0.375
transubstruckmole,0,17,5,12,0,0.416666666666667
circumference,1,13,5,8,0,0.625
yeramt,0,6,2,4,0,0.5
enclitics,1,9,3,6,0,0.5
extrovertibly,0,13,4,9,0,0.444444444444444
voidal,0,6,3,3,0,1
puddleproof,0,11,4,7,0,0.571428571428571
dounperdizesms,0,14,5,9,0,0.555555555555556
netter,1,6,2,4,0,0.5
satanology,1,10,4,6,0,0.666666666666667
brokenheartener,0,15,6,9,0,0.666666666666667
apostatism,1,10,4,6,0,0.666666666666667
fomiscaisule,0,12,6,6,0,1
keslahas,0,8,3,5,0,0.6
aminta,1,6,3,3,0,1
crepis,1,6,2,4,0,0.5
vvjijntjecxnqbd,0,15,2,13,0,0.153846153846154
peption,0,7,3,4,0,0.75
uncommersionist,0,15,6,9,0,0.666666666666667
nilotic,1,7,3,4,0,0.75
platessigenes,0,13,5,8,0,0.625
weldor,1,6,2,4,0,0.5
neuronym,1,8,3,5,0,0.6
chiai,1,5,3,2,0,1.5
polysin,0,7,2,5,0,0.4
deviationist,1,12,6,6,0,1
chinookan,1,9,4,5,0,0.8
lacintrfaenaheruleclopoongiermas,0,32,14,18,0,0.777777777777778
acres,1,5,2,3,0,0.666666666666667
obeyers,1,7,3,4,0,0.75
ryleyearbad,0,11,4,7,0,0.571428571428571
zared,1,5,2,3,0,0.666666666666667
crenulation,1,11,5,6,0,0.833333333333333
unstaysail,0,10,4,6,0,0.666666666666667
newgawen,0,8,3,5,0,0.6
uabjkgqixkevrafpck,0,18,5,13,0,0.384615384615385
sculturg,0,8,2,6,0,0.333333333333333
fibrisations,0,12,5,7,0,0.714285714285714
finianiship,0,11,5,6,0,0.833333333333333
birl,1,4,1,3,0,0.333333333333333
noninflammatory,1,15,5,10,0,0.5
axiniform,1,9,4,5,0,0.8
abiete,0,6,4,2,0,2
tal,1,3,1,2,0,0.5
ur''lmrpafrdrlzcymok'g,0,22,3,19,3,0.157894736842105
ovitioenand,0,11,6,5,0,1.2
hyzya,0,5,1,4,0,0.25
assorblas,0,9,3,6,0,0.5
panderma,1,8,3,5,0,0.6
beerbelly,1,9,3,6,0,0.5
madrilitype,0,11,4,7,0,0.571428571428571
edallediatoun,0,13,7,6,0,1.16666666666667
involucella,0,11,5,6,0,0.833333333333333
vltpeslezc''bisnq,0,17,3,14,2,0.214285714285714
tkdysbchhbzfiycizppk,0,20,2,18,0,0.111111111111111
hokier,1,6,3,3,0,1
relimity,0,8,3,5,0,0.6
overfallen,1,10,4,6,0,0.666666666666667
m'gjfix''fxfeb'wpqtxye,0,22,3,19,4,0.157894736842105
bb,1,2,0,2,0,0
premenstrually,1,14,4,10,0,0.4
judgeship,1,9,3,6,0,0.5
xanthophore,1,11,4,7,0,0.571428571428571
magindanao,1,10,5,5,0,1
naish,1,5,2,3,0,0.666666666666667
sempiternizes,0,13,5,8,0,0.625
postdigenemiclinomining,0,23,9,14,0,0.642857142857143
fairview,1,8,4,4,0,1
scootching,1,10,3,7,0,0.428571428571429
tubfish,1,7,2,5,0,0.4
wnos,0,4,1,3,0,0.333333333333333
mauvines,1,8,4,4,0,1
pxdmzwntbkxpplivijwbuzpdev,0,26,4,22,0,0.181818181818182
krambukrounprent,0,16,5,11,0,0.454545454545455
aus,0,3,2,1,0,2
gymslip,1,7,1,6,0,0.166666666666667
duster,1,6,2,4,0,0.5
waxers,1,6,2,4,0,0.5
twistor,1,7,2,5,0,0.4
teruteru,1,8,4,4,0,1
nonindulgiate,0,13,6,7,0,0.857142857142857
geotechnist,0,11,4,7,0,0.571428571428571
mammoni,1,7,3,4,0,0.75
husband,1,7,2,5,0,0.4
qwiazkaitithtvbblvvuef,0,22,7,15,0,0.466666666666667
tallinarseille,0,14,6,8,0,0.75
subclinically,1,13,4,9,0,0.444444444444444
kynthomasville,0,14,4,10,0,0.4
metopryls,1,9,2,7,0,0.285714285714286
podocarp,1,8,3,5,0,0.6
acivensamoly,0,12,5,7,0,0.714285714285714
f'ccakugs,0,9,2,7,1,0.285714285714286
there,1,5,2,3,0,0.666666666666667
apocrystallman,0,14,4,10,0,0.4
actiniarian,1,11,6,5,0,1.2
countertop,1,10,4,6,0,0.666666666666667
microsecond,1,11,4,7,0,0.571428571428571
meghan,1,6,2,4,0,0.5
ardath,1,6,2,4,0,0.5
cornel,1,6,2,4,0,0.5
dissyish,0,8,2,6,0,0.333333333333333
salley,1,6,2,4,0,0.5
ortet,1,5,2,3,0,0.666666666666667
unshawl,1,7,2,5,0,0.4
flagstaffs,1,10,2,8,0,0.25
tiees,0,5,3,2,0,1.5
spatterdash,1,11,3,8,0,0.375
nonnachromleadonaraphotogitrupedualluenchecriatheadomissocancryo,0,64,27,37,0,0.72972972972973
nephorelike,0,11,5,6,0,0.833333333333333
eyrkojpv'lgcygzcux,0,18,3,15,1,0.2
eccring,0,7,2,5,0,0.4
bewig,1,5,2,3,0,0.666666666666667
elixed,1,6,3,3,0,1
springtown,1,10,2,8,0,0.25
hlon,0,4,1,3,0,0.333333333333333
myxospongiae,1,12,5,7,0,0.714285714285714
slubbering,1,10,3,7,0,0.428571428571429
cnidocyst,1,9,2,7,0,0.285714285714286
barr,1,4,1,3,0,0.333333333333333
mvaekaoswi,0,10,5,5,0,1
telekij'btnltajziwvu',0,21,6,15,2,0.4
christianography,1,16,5,11,0,0.454545454545455
ylcodrmgpckkahxzlpzmcvyhp,0,25,2,23,0,0.0869565217391304
acroctas,0,8,3,5,0,0.6
lvkkj'asjyzsbgr,0,15,1,14,1,0.0714285714285714
chaetanotis,0,11,5,6,0,0.833333333333333
undereying,1,10,4,6,0,0.666666666666667
teleodesmacea,1,13,7,6,0,1.16666666666667
mellifluousness,1,15,6,9,0,0.666666666666667
voyettyism,0,10,3,7,0,0.428571428571429
mor,1,3,1,2,0,0.5
macrocephalous,1,14,6,8,0,0.75
corfiots,1,8,3,5,0,0.6
gnycttv'joaohtntboeaxyjs,0,24,6,18,1,0.333333333333333
interwise,0,9,4,5,0,0.8
noncomplementary,1,16,5,11,0,0.454545454545455
squire,1,6,3,3,0,1
pess'krtdk,0,10,1,9,1,0.111111111111111
tralleness,0,10,3,7,0,0.428571428571429
porkman,1,7,2,5,0,0.4
spinstrelessly,0,14,3,11,0,0.272727272727273
alluids,0,7,3,4,0,0.75
cc,1,2,0,2,0,0
hitmen,1,6,2,4,0,0.5
mewls,1,5,1,4,0,0.25
gravagered,0,10,4,6,0,0.666666666666667
nonconducture,0,13,5,8,0,0.625
saladroobrigatonical,0,20,9,11,0,0.818181818181818
scutelliplantar,1,15,5,10,0,0.5
cetologist,1,10,4,6,0,0.666666666666667
ooenbfzluaneodqvjlwqn,0,21,7,14,0,0.5
mamseller,0,9,3,6,0,0.5
mescuzer,0,8,3,5,0,0.6
pseudodramatically,1,18,7,11,0,0.636363636363636
gravianism,0,10,4,6,0,0.666666666666667
epeehl,0,6,3,3,0,1
draba,1,5,2,3,0,0.666666666666667
unisomorphic,1,12,5,7,0,0.714285714285714
superspecular,0,13,5,8,0,0.625
undefra,0,7,3,4,0,0.75
ancine,0,6,3,3,0,1
unworshipful,1,12,4,8,0,0.5
sitlbadnyrs,0,11,2,9,0,0.222222222222222
hedonically,1,11,4,7,0,0.571428571428571
biirwmrvcwufrcklvntl,0,20,3,17,0,0.176470588235294
burnweed,1,8,3,5,0,0.6
thallochlore,1,12,4,8,0,0.5
jarrelled,0,9,3,6,0,0.5
shadine,1,7,3,4,0,0.75
polycythaemic,1,13,4,9,0,0.444444444444444
acholous,1,8,4,4,0,1
lavon,1,5,2,3,0,0.666666666666667
sotols,1,6,2,4,0,0.5
strapontins,1,11,3,8,0,0.375
pemis,0,5,2,3,0,0.666666666666667
musketry,1,8,2,6,0,0.333333333333333
treptor,0,7,2,5,0,0.4
memorablenesses,1,15,6,9,0,0.666666666666667
cmyb,0,4,0,4,0,0
ciszek,1,6,2,4,0,0.5
fo'ikojojhzns'dumjskshtpywc',0,28,5,23,3,0.217391304347826
tussled,1,7,2,5,0,0.4
beneighbored,1,12,5,7,0,0.714285714285714
parasympathetic,1,15,5,10,0,0.5
repudiations,1,12,6,6,0,1
acientaliatone,0,14,8,6,0,1.33333333333333
skzlntclbtunvtou,0,16,3,13,0,0.230769230769231
epizoplayanimatah,0,17,8,9,0,0.888888888888889
lymphogranulomatosis,1,20,7,13,0,0.538461538461538
xmnieobmyxciy,0,13,4,9,0,0.444444444444444
qvntrtreqkjzzo,0,14,2,12,0,0.166666666666667
timne,1,5,2,3,0,0.666666666666667
eivnzptjjvgsca,0,14,3,11,0,0.272727272727273
gazpi,0,5,2,3,0,0.666666666666667
ickhrns,0,7,1,6,0,0.166666666666667
pavemental,1,10,4,6,0,0.666666666666667
mandington,0,10,3,7,0,0.428571428571429
bonaveria,1,9,5,4,0,1.25
taxoseusynanting,0,16,6,10,0,0.6
cically,0,7,2,5,0,0.4
locor,0,5,2,3,0,0.666666666666667
timeliine,1,9,5,4,0,1.25
ime,0,3,2,1,0,2
jundi,0,5,2,3,0,0.666666666666667
inventorying,1,12,4,8,0,0.5
irenidae,0,8,5,3,0,1.66666666666667
dorsoabdominalisations,0,22,10,12,0,0.833333333333333
zkubqtwcsuqrhef,0,15,3,12,0,0.25
tetioted,0,8,4,4,0,1
narras,1,6,2,4,0,0.5
condybooms,0,10,3,7,0,0.428571428571429
randalia,1,8,4,4,0,1
eausthriota,0,11,6,5,0,1.2
boggling,0,8,2,6,0,0.333333333333333
uepaboma,0,8,5,3,0,1.66666666666667
jxdarba,0,7,2,5,0,0.4
declaimants,1,11,4,7,0,0.571428571428571
galia,0,5,3,2,0,1.5
amaurosis,1,9,5,4,0,1.25
literaryism,1,11,4,7,0,0.571428571428571
hauls,1,5,2,3,0,0.666666666666667
rowletts,1,8,2,6,0,0.333333333333333
poidently,0,9,3,6,0,0.5
cline,1,5,2,3,0,0.666666666666667
tetraceratous,1,13,6,7,0,0.857142857142857
respiritual,0,11,5,6,0,0.833333333333333
anchimbeyebence,0,15,6,9,0,0.666666666666667
clacton,1,7,2,5,0,0.4
'cewsuoczdjudwfxqguzhkr,0,23,5,18,1,0.277777777777778
cowriter,1,8,3,5,0,0.6
truisms,1,7,2,5,0,0.4
clession,0,8,3,5,0,0.6
undaentrinvia,0,13,6,7,0,0.857142857142857
overneglectfulness,1,18,6,12,0,0.5
tv,1,2,0,2,0,0
unated,0,6,3,3,0,1
jgclginslrl,0,11,1,10,0,0.1
gordan,1,6,2,4,0,0.5
conotonthewalc,0,14,5,9,0,0.555555555555556
dolichocracies,0,14,6,8,0,0.75
cornwallis,1,10,3,7,0,0.428571428571429
unmartyr,1,8,2,6,0,0.333333333333333
farreation,1,10,5,5,0,1
insincerite,0,11,5,6,0,0.833333333333333
preadolescent,1,13,5,8,0,0.625
ourpologpes,0,11,5,6,0,0.833333333333333
centrates,0,9,3,6,0,0.5
exochlegadvist,0,14,5,9,0,0.555555555555556
scaul,1,5,2,3,0,0.666666666666667
argently,0,8,2,6,0,0.333333333333333
precantagitart,0,14,5,9,0,0.555555555555556
impicoel,0,8,4,4,0,1
bridesman,1,9,3,6,0,0.5
sideless,1,8,3,5,0,0.6
fructiferously,1,14,5,9,0,0.555555555555556
cories,1,6,3,3,0,1
kados,1,5,2,3,0,0.666666666666667
rhoenoun,0,8,4,4,0,1
hatbrushes,1,10,3,7,0,0.428571428571429
accreted,1,8,3,5,0,0.6
mmedote,0,7,3,4,0,0.75
semnopithecine,1,14,6,8,0,0.75
ombudsperson,1,12,4,8,0,0.5
dagruaeetochybanin,0,18,8,10,0,0.8
zygogeness,0,10,3,7,0,0.428571428571429
aporetical,1,10,5,5,0,1
mauritanie,1,10,6,4,0,1.5
rangifer,1,8,3,5,0,0.6
rotariat,0,8,4,4,0,1
ntoruerveme,0,11,5,6,0,0.833333333333333
litigiousness,1,13,6,7,0,0.857142857142857
luller,1,6,2,4,0,0.5
scausly,0,7,2,5,0,0.4
croissant,1,9,3,6,0,0.5
milisodymaxua,0,13,6,7,0,0.857142857142857
mammalogy,1,9,3,6,0,0.5
orsa,1,4,2,2,0,1
europa,1,6,4,2,0,2
tinsels,1,7,2,5,0,0.4
enfoncee,1,8,4,4,0,1
'pkf'v'gczlyehys,0,16,1,15,3,0.0666666666666667
homochromatic,1,13,5,8,0,0.625
crewell,0,7,2,5,0,0.4
shulamite,1,9,4,5,0,0.8
subcritical,1,11,4,7,0,0.571428571428571
ybislffvbxibx,0,13,2,11,0,0.181818181818182
chroporackierpothetic,0,21,8,13,0,0.615384615384615
natika,1,6,3,3,0,1
picrotoxins,1,11,4,7,0,0.571428571428571
bushments,0,9,2,7,0,0.285714285714286
reisc,0,5,2,3,0,0.666666666666667
haquetted,0,9,4,5,0,0.8
bushkill,1,8,2,6,0,0.333333333333333
naphthoquinone,1,14,6,8,0,0.75
foreignness,1,11,4,7,0,0.571428571428571
nonhomogeneous,1,14,7,7,0,1
counterligament,0,15,6,9,0,0.666666666666667
zostomiumittingle,0,17,7,10,0,0.7
cowley,1,6,2,4,0,0.5
posadas,1,7,3,4,0,0.75
migraphylouish,0,14,5,9,0,0.555555555555556
taphoniate,0,10,5,5,0,1
agquewv'xvoaih,0,14,6,8,1,0.75
stanchering,1,11,3,8,0,0.375
amphimacean,0,11,5,6,0,0.833333333333333
lychazvqvilsdnnykgyzkvmusiw,0,27,4,23,0,0.173913043478261
vesiculotubular,1,15,7,8,0,0.875
modernisation,1,13,6,7,0,0.857142857142857
abbreviates,1,11,5,6,0,0.833333333333333
indonesia,1,9,5,4,0,1.25
trinely,1,7,2,5,0,0.4
entwistable,0,11,4,7,0,0.571428571428571
zooindism,0,9,4,5,0,0.8
mitlchtrmmouxorbekjj,0,20,5,15,0,0.333333333333333
kaph,1,4,1,3,0,0.333333333333333
poulaines,1,9,5,4,0,1.25
speedboat,1,9,4,5,0,0.8
labobiforioung,0,14,7,7,0,1
borderline,1,10,4,6,0,0.666666666666667
neurophily,0,10,4,6,0,0.666666666666667
bolis,0,5,2,3,0,0.666666666666667
piery,0,5,2,3,0,0.666666666666667
aneurs,0,6,3,3,0,1
vesturing,1,9,3,6,0,0.5
homophonic,1,10,4,6,0,0.666666666666667
crotes,0,6,2,4,0,0.5
pyruline,1,8,3,5,0,0.6
discepheraphinian,0,17,7,10,0,0.7
aldunglerigmies,0,15,6,9,0,0.666666666666667
bdutyd,0,6,1,5,0,0.2
rabbanite,1,9,4,5,0,0.8
statute,1,7,3,4,0,0.75
andropov,1,8,3,5,0,0.6
edlsslfgnnr'ifhnfrtucdhiu,0,25,5,20,1,0.25
imaum,1,5,3,2,0,1.5
pironi,1,6,3,3,0,1
buckminsterfullerene,1,20,7,13,0,0.538461538461538
chaulmoogras,1,12,5,7,0,0.714285714285714
storeroom,1,9,4,5,0,0.8
dicteroneshates,0,15,6,9,0,0.666666666666667
trebleness,1,10,3,7,0,0.428571428571429
uncoveted,1,9,4,5,0,0.8
ieot,0,4,3,1,0,3
bungies,1,7,3,4,0,0.75
listening,1,9,3,6,0,0.5
recovery,1,8,3,5,0,0.6
emblebes,0,8,3,5,0,0.6
curuba,1,6,3,3,0,1
tertulia,1,8,4,4,0,1
namas,1,5,2,3,0,0.666666666666667
arist,0,5,2,3,0,0.666666666666667
nagyvrad,1,8,2,6,0,0.333333333333333
electrothermics,1,15,5,10,0,0.5
jurisprudents,1,13,4,9,0,0.444444444444444
gabilight,0,9,3,6,0,0.5
sxvce'nw,0,8,1,7,1,0.142857142857143
flagsta,0,7,2,5,0,0.4
mcukozl,0,7,2,5,0,0.4
gypsoplast,1,10,2,8,0,0.25
undampable,1,10,4,6,0,0.666666666666667
sharecha,0,8,3,5,0,0.6
wherewitchbackscatterspace,0,26,8,18,0,0.444444444444444
wors,0,4,1,3,0,0.333333333333333
anagrammats,0,11,4,7,0,0.571428571428571
zymogenes,1,9,3,6,0,0.5
mools,1,5,2,3,0,0.666666666666667
asexualist,0,10,5,5,0,1
othemorrhea,1,11,5,6,0,0.833333333333333
bairas,0,6,3,3,0,1
dediwxstnjeufvvlnokuvjolqn,0,26,7,19,0,0.368421052631579
impetigos,1,9,4,5,0,0.8
totuqude,0,8,4,4,0,1
unitarist,0,9,4,5,0,0.8
wiseling,1,8,3,5,0,0.6
rebeccaites,1,11,5,6,0,0.833333333333333
metasilia,0,9,5,4,0,1.25
amphibole,1,9,4,5,0,0.8
masochists,1,10,3,7,0,0.428571428571429
avitandoff,0,10,4,6,0,0.666666666666667
exilarchate,1,11,5,6,0,0.833333333333333
elysia,1,6,3,3,0,1
causey,1,6,3,3,0,1
pablanktonopolatter,0,19,7,12,0,0.583333333333333
hulwort,1,7,2,5,0,0.4
gasphoboding,0,12,4,8,0,0.5
rangemen,1,8,3,5,0,0.6
xagbosdsva',0,11,3,8,1,0.375
yivuxhossrrx'cdyznv,0,19,3,16,1,0.1875
ridianised,0,10,5,5,0,1
stowninoceria,0,13,6,7,0,0.857142857142857
unconcentrative,1,15,6,9,0,0.666666666666667
simitar,1,7,3,4,0,0.75
p'guchluaq,0,10,3,7,1,0.428571428571429
honestonish,0,11,4,7,0,0.571428571428571
inter,0,5,2,3,0,0.666666666666667
djiboutian,1,10,5,5,0,1
jubougglors,0,11,4,7,0,0.571428571428571
cariban,1,7,3,4,0,0.75
harghesion,0,10,4,6,0,0.666666666666667
tural,0,5,2,3,0,0.666666666666667
iceskate,1,8,4,4,0,1
cradnecus,0,9,3,6,0,0.5
blastemas,1,9,3,6,0,0.5
facrevalinte,0,12,5,7,0,0.714285714285714
retrojugulators,0,15,6,9,0,0.666666666666667
laban,1,5,2,3,0,0.666666666666667
ugrianize,1,9,5,4,0,1.25
destrejocer,0,11,4,7,0,0.571428571428571
unwallycope,0,11,4,7,0,0.571428571428571
qwdmttqqirusmvibizp,0,19,4,15,0,0.266666666666667
oeyoqyskdbz,0,11,3,8,0,0.375
droppage,1,8,3,5,0,0.6
precapitalist,1,13,5,8,0,0.625
hluchy,1,6,1,5,0,0.2
rubenise,0,8,4,4,0,1
nereis,1,6,3,3,0,1
andledge,0,8,3,5,0,0.6
bippectate,0,10,4,6,0,0.666666666666667
lapiderwort,0,11,4,7,0,0.571428571428571
uninfolded,1,10,4,6,0,0.666666666666667
phatogubaus,0,11,5,6,0,0.833333333333333
unbedding,1,9,3,6,0,0.5
woodgeld,1,8,3,5,0,0.6
artenmental,0,11,4,7,0,0.571428571428571
kylik,0,5,1,4,0,0.25
nonrhythmic,1,11,2,9,0,0.222222222222222
ccatialive,0,10,5,5,0,1
distressfulness,1,15,4,11,0,0.363636363636364
fleetinghouseclean,0,18,8,10,0,0.8
travelerlike,1,12,5,7,0,0.714285714285714
havives,0,7,3,4,0,0.75
mushiest,1,8,3,5,0,0.6
jotting,1,7,2,5,0,0.4
stonemple,0,9,3,6,0,0.5
yowlanduridiocyterism,0,21,8,13,0,0.615384615384615
easterly,1,8,3,5,0,0.6
anic,0,4,2,2,0,1
incorrigibly,1,12,4,8,0,0.5
nonadmirers,1,11,4,7,0,0.571428571428571
stomiss,0,7,2,5,0,0.4
crackback,1,9,2,7,0,0.285714285714286
stancial,0,8,3,5,0,0.6
eosinophilisms,0,14,6,8,0,0.75
penrod,1,6,2,4,0,0.5
desyl,1,5,1,4,0,0.25
antimodern,1,10,4,6,0,0.666666666666667
jayn,1,4,1,3,0,0.333333333333333
ouxk,0,4,2,2,0,1
battakhin,1,9,3,6,0,0.5
hurobuvftgbqipawyp,0,18,5,13,0,0.384615384615385
playlist,1,8,2,6,0,0.333333333333333
balnibarbi,1,10,4,6,0,0.666666666666667
burnette,0,8,3,5,0,0.6
nsichy,0,6,1,5,0,0.2
nuevo,1,5,3,2,0,1.5
adrenolytic,1,11,4,7,0,0.571428571428571
skatikas,1,8,3,5,0,0.6
scourt,0,6,2,4,0,0.5
hadclqacyafidzjzvxgue,0,21,6,15,0,0.4
uncoincidentate,0,15,7,8,0,0.875
snaphthalesteropneumonically,0,28,10,18,0,0.555555555555556
ridge,1,5,2,3,0,0.666666666666667
cladophyta,0,10,3,7,0,0.428571428571429
nops,0,4,1,3,0,0.333333333333333
treadlers,1,9,3,6,0,0.5
erodability,1,11,5,6,0,0.833333333333333
chambermaid,1,11,4,7,0,0.571428571428571
kg'tqr,0,6,0,6,1,0
oswin,1,5,2,3,0,0.666666666666667
crossion,0,8,3,5,0,0.6
dozily,1,6,2,4,0,0.5
exte,0,4,2,2,0,1
algesia,0,7,4,3,0,1.33333333333333
zwitte,0,6,2,4,0,0.5
troid,0,5,2,3,0,0.666666666666667
phospoorwangiparakpennablemercovising,0,37,14,23,0,0.608695652173913
unremonstrative,1,15,6,9,0,0.666666666666667
chloroiodide,1,12,6,6,0,1
pseudospectral,1,14,5,9,0,0.555555555555556
etchiffcy,0,9,2,7,0,0.285714285714286
cugblcpnazxo,0,12,3,9,0,0.333333333333333
preinsulators,0,13,5,8,0,0.625
anderachart,0,11,4,7,0,0.571428571428571
waterbelly,1,10,3,7,0,0.428571428571429
zjvjyifknqbhzuivizb'cwlxeqda,0,28,6,22,1,0.272727272727273
ramballograpostcapsibilians,0,27,10,17,0,0.588235294117647
ingenes,0,7,3,4,0,0.75
skiogram,1,8,3,5,0,0.6
otozoum,1,7,4,3,0,1.33333333333333
prematurine,0,11,5,6,0,0.833333333333333
brigherruperc,0,13,4,9,0,0.444444444444444
brynhild,1,8,1,7,0,0.142857142857143
enframe,1,7,3,4,0,0.75
eyjs,0,4,1,3,0,0.333333333333333
apiarians,1,9,5,4,0,1.25
albuquerquean,1,13,7,6,0,1.16666666666667
dawding,0,7,2,5,0,0.4
cephalos,0,8,3,5,0,0.6
unexaminable,1,12,6,6,0,1
defloccule,0,10,4,6,0,0.666666666666667
freemarumpies,0,13,6,7,0,0.857142857142857
penelopising,1,12,5,7,0,0.714285714285714
'ohuugd'ip,0,10,4,6,2,0.666666666666667
monand,0,6,2,4,0,0.5
vourfmen,0,8,3,5,0,0.6
anthropocollas,0,14,5,9,0,0.555555555555556
mbawtoghis,0,10,3,7,0,0.428571428571429
subtraceae,0,10,5,5,0,1
portcullis,1,10,3,7,0,0.428571428571429
bjyv,0,4,0,4,0,0
busked,1,6,2,4,0,0.5
stogeys,1,7,2,5,0,0.4
melinite,1,8,4,4,0,1
unenduring,1,10,4,6,0,0.666666666666667
cruciated,1,9,4,5,0,0.8
elvaston,1,8,3,5,0,0.6
capelet,1,7,3,4,0,0.75
infantries,1,10,4,6,0,0.666666666666667
bedad,1,5,2,3,0,0.666666666666667
coudersport,1,11,4,7,0,0.571428571428571
biosynthesis,1,12,4,8,0,0.5
peptive,0,7,3,4,0,0.75
sarra,1,5,2,3,0,0.666666666666667
danieu,1,6,4,2,0,2
pondistealthy,0,13,4,9,0,0.444444444444444
dochoenchisms,0,13,4,9,0,0.444444444444444
brayton,1,7,2,5,0,0.4
gingerroot,1,10,4,6,0,0.666666666666667
schliemann,1,10,3,7,0,0.428571428571429
volvedly,0,8,2,6,0,0.333333333333333
tomonininse,0,11,5,6,0,0.833333333333333
syne,0,4,1,3,0,0.333333333333333
mesometed,0,9,4,5,0,0.8
aler,0,4,2,2,0,1
bethane,0,7,3,4,0,0.75
proptamtichamicklity,0,20,6,14,0,0.428571428571429
ossible,0,7,3,4,0,0.75
sedlik,1,6,2,4,0,0.5
miphganwaeveaumurunostoernag,0,28,13,15,0,0.866666666666667
romilly,1,7,2,5,0,0.4
piskitifichanagy,0,16,6,10,0,0.6
burnitorise,0,11,5,6,0,0.833333333333333
lingly,0,6,1,5,0,0.2
hospitalization,0,15,7,8,0,0.875
middlesex,1,9,3,6,0,0.5
cielleiopts,0,11,5,6,0,0.833333333333333
aseshiastiont,0,13,6,7,0,0.857142857142857
muggering,1,9,3,6,0,0.5
piendilshllarisereottidicawads,0,30,12,18,0,0.666666666666667
millithrum,1,10,3,7,0,0.428571428571429
nqrnoh,0,6,1,5,0,0.2
nugae,1,5,3,2,0,1.5
aucanian,1,8,5,3,0,1.66666666666667
hehra,0,5,2,3,0,0.666666666666667
labrealitionalibiddy,0,20,9,11,0,0.818181818181818
unpragmatical,1,13,5,8,0,0.625
malectrochlorenzier,0,19,7,12,0,0.583333333333333
bougruvematentyn,0,16,6,10,0,0.6
hypoplastex,0,11,3,8,0,0.375
auriform,1,8,4,4,0,1
brandisher,1,10,3,7,0,0.428571428571429
tcawi,1,5,2,3,0,0.666666666666667
dbridement,1,10,3,7,0,0.428571428571429
unenterprising,1,14,5,9,0,0.555555555555556
mulus,0,5,2,3,0,0.666666666666667
od,1,2,1,1,0,1
fooleerindicle,0,14,7,7,0,1
transmigranomian,0,16,6,10,0,0.6
godewyn,1,7,2,5,0,0.4
lomi,0,4,2,2,0,1
hkhbifstsrwxqunpc,0,17,2,15,0,0.133333333333333
kesomioote,0,10,6,4,0,1.5
superian,0,8,4,4,0,1
dampishly,1,9,2,7,0,0.285714285714286
flashcards,1,10,2,8,0,0.25
vereditarily,0,12,5,7,0,0.714285714285714
snoove,1,6,3,3,0,1
lendings,1,8,2,6,0,0.333333333333333
rapsislutodrativapuleel,0,23,10,13,0,0.769230769230769
scatroinstiterle,0,16,6,10,0,0.6
sawhore,0,7,3,4,0,0.75
didoulesunaconcalelit,0,21,10,11,0,0.909090909090909
cereuses,1,8,4,4,0,1
feminity,1,8,3,5,0,0.6
bechic,1,6,2,4,0,0.5
uptalk,1,6,2,4,0,0.5
mounte,0,6,3,3,0,1
isidium,0,7,4,3,0,1.33333333333333
penoid,0,6,3,3,0,1
aviha,0,5,3,2,0,1.5
vroqfnkdleabpqgpwz,0,18,3,15,0,0.2
thesterisabibunadingeevikshede,0,30,13,17,0,0.764705882352941
uncooperating,1,13,6,7,0,0.857142857142857
parthenius,1,10,4,6,0,0.666666666666667
biuplogunila,0,12,6,6,0,1
sitophyre,0,9,3,6,0,0.5
jlxq,0,4,0,4,0,0
vapidism,1,8,3,5,0,0.6
conclamation,1,12,5,7,0,0.714285714285714
laudeteria,0,10,6,4,0,1.5
highlands,1,9,2,7,0,0.285714285714286
akund,1,5,2,3,0,0.666666666666667
breechcloth,1,11,3,8,0,0.375
nonoblast,0,9,3,6,0,0.5
revelociculatation,0,18,9,9,0,1
velishableadaloweinagallisany,0,29,13,16,0,0.8125
vatoifeunangsipll,0,17,7,10,0,0.7
laything,0,8,2,6,0,0.333333333333333
teus,0,4,2,2,0,1
intraperineal,1,13,6,7,0,0.857142857142857
malvaceae,1,9,5,4,0,1.25
brunotogy,0,9,3,6,0,0.5
hetampbelock,0,12,4,8,0,0.5
juevvxrznnyv,0,12,2,10,0,0.2
gtfvsscurchdcyrqb',0,18,1,17,1,0.0588235294117647
plowjogger,1,10,3,7,0,0.428571428571429
gypsy,1,5,0,5,0,0
altand,0,6,2,4,0,0.5
stists,0,6,1,5,0,0.2
stemmy,1,6,1,5,0,0.2
pledged,1,7,2,5,0,0.4
revator,0,7,3,4,0,0.75
fleah,0,5,2,3,0,0.666666666666667
orchese,0,7,3,4,0,0.75
retten,0,6,2,4,0,0.5
jech,0,4,1,3,0,0.333333333333333
lotherbesean,0,12,5,7,0,0.714285714285714
resis,0,5,2,3,0,0.666666666666667
rafaelof,1,8,4,4,0,1
tulusabilither,0,14,6,8,0,0.75
'iqsxut,0,7,2,5,1,0.4
brucella,1,8,3,5,0,0.6
pinjays,0,7,2,5,0,0.4
lanistic,0,8,3,5,0,0.6
bargemen,1,8,3,5,0,0.6
florae,1,6,3,3,0,1
enflowerablenesses,0,18,7,11,0,0.636363636363636
hocalifellysibewer,0,18,7,11,0,0.636363636363636
blackage,0,8,3,5,0,0.6
oviparousnesses,0,15,7,8,0,0.875
tion,0,4,2,2,0,1
carpopoditic,1,12,5,7,0,0.714285714285714
didelphiness,0,12,4,8,0,0.5
izvestia,1,8,4,4,0,1
humablency,0,10,3,7,0,0.428571428571429
kopelle,0,7,3,4,0,0.75
desarighted,0,11,4,7,0,0.571428571428571
lectern,1,7,2,5,0,0.4
reforgeable,1,11,5,6,0,0.833333333333333
largenius,0,9,4,5,0,0.8
euously,0,7,4,3,0,1.33333333333333
imposthumates,1,13,5,8,0,0.625
bridgeables,1,11,4,7,0,0.571428571428571
phiporogaterety,0,15,6,9,0,0.666666666666667
ckauareroditins,0,15,7,8,0,0.875
areocentric,1,11,5,6,0,0.833333333333333
nonhomogeneousness,0,18,8,10,0,0.8
pachismeserileted,0,17,7,10,0,0.7
cedernghiacoeciosis,0,19,9,10,0,0.9
sutteeism,1,9,4,5,0,0.8
signage,1,7,3,4,0,0.75
elaterometer,1,12,6,6,0,1
sheenie,1,7,4,3,0,1.33333333333333
counterterm,1,11,4,7,0,0.571428571428571
rmyyoqimaazgl,0,13,4,9,0,0.444444444444444
homelessnesses,1,14,5,9,0,0.555555555555556
upwrencher,0,10,3,7,0,0.428571428571429
cnr,1,3,0,3,0,0
swillbelly,1,10,2,8,0,0.25
zonr,0,4,1,3,0,0.333333333333333
umbloochetes,0,12,5,7,0,0.714285714285714
gynoecious,0,10,5,5,0,1
coneogrefolgoeucariani,0,22,12,10,0,1.2
supermysteries,1,14,5,9,0,0.555555555555556
uralite,1,7,4,3,0,1.33333333333333
anom,0,4,2,2,0,1
neallispecatichantwidntola,0,26,10,16,0,0.625
darrouzett,1,10,4,6,0,0.666666666666667
medromalactivalethodistically,0,29,11,18,0,0.611111111111111
fletchedly,0,10,2,8,0,0.25
caryophyllin,1,12,3,9,0,0.333333333333333
cincinctnesses,0,14,4,10,0,0.4
snakishness,0,11,3,8,0,0.375
convalustan,0,11,4,7,0,0.571428571428571
nimrodic,1,8,3,5,0,0.6
dichlorides,1,11,4,7,0,0.571428571428571
hyperiqua,0,9,4,5,0,0.8
ghostily,1,8,2,6,0,0.333333333333333
oliphant,1,8,3,5,0,0.6
oviste,0,6,3,3,0,1
exauthoritarianism,0,18,9,9,0,1
pqnkjbqfc'ijdzkcv,0,17,1,16,1,0.0625
bustier,1,7,3,4,0,0.75
pleomorphosis,0,13,5,8,0,0.625
parnellite,1,10,4,6,0,0.666666666666667
araeometry,1,10,5,5,0,1
laparohysterotomy,1,17,6,11,0,0.545454545454545
proctopushed,0,12,4,8,0,0.5
midittles,0,9,3,6,0,0.5
wynuchoutteral,0,14,5,9,0,0.555555555555556
renculace,0,9,4,5,0,0.8
overgallamuchillahs,0,19,7,12,0,0.583333333333333
diffusednesses,1,14,5,9,0,0.555555555555556
designees,1,9,4,5,0,0.8
scended,1,7,2,5,0,0.4
animatronics,1,12,5,7,0,0.714285714285714
epigone,1,7,4,3,0,1.33333333333333
prepleviewable,0,14,6,8,0,0.75
korah,1,5,2,3,0,0.666666666666667
pos,1,3,1,2,0,0.5
sivated,0,7,3,4,0,0.75
consequel,0,9,4,5,0,0.8
norm,1,4,1,3,0,0.333333333333333
parearts,0,8,3,5,0,0.6
preadjustments,1,14,4,10,0,0.4
futtock,1,7,2,5,0,0.4
tundish,1,7,2,5,0,0.4
bogexato,0,8,4,4,0,1
brachytactyly,1,13,2,11,0,0.181818181818182
buckler,1,7,2,5,0,0.4
immortiser,0,10,4,6,0,0.666666666666667
gitas,1,5,2,3,0,0.666666666666667
lnwfytaccatezjkkg'owcsxgjkg,0,27,4,23,1,0.173913043478261
vinegarroon,1,11,5,6,0,0.833333333333333
chysts,0,6,0,6,0,0
acupuncturist,1,13,5,8,0,0.625
contipopterning,0,15,5,10,0,0.5
bools,1,5,2,3,0,0.666666666666667
mixodectes,1,10,4,6,0,0.666666666666667
xcoxmyejcxz,0,11,2,9,0,0.222222222222222
subtlet,0,7,2,5,0,0.4
absarah,0,7,3,4,0,0.75
decketicand,0,11,4,7,0,0.571428571428571
nonprognost,0,11,3,8,0,0.375
unquietable,1,11,6,5,0,1.2
underminding,1,12,4,8,0,0.5
fubar,1,5,2,3,0,0.666666666666667
jerald,1,6,2,4,0,0.5
isohydric,1,9,3,6,0,0.5
widespread,1,10,4,6,0,0.666666666666667
cuzpllursss,0,11,2,9,0,0.222222222222222
hippocration,0,12,5,7,0,0.714285714285714
drigaticiolatingwiggler,0,23,9,14,0,0.642857142857143
jablon,1,6,2,4,0,0.5
extoum,0,6,3,3,0,1
etruscans,1,9,3,6,0,0.5
tjvcbzcuamwpvnuv,0,16,3,13,0,0.230769230769231
occurring,1,9,3,6,0,0.5
heliped,0,7,3,4,0,0.75
xenolite,1,8,4,4,0,1
nonleguminositol,0,16,7,9,0,0.777777777777778
nalats,0,6,2,4,0,0.5
burrow,1,6,2,4,0,0.5
xtcitaxqe,0,9,3,6,0,0.5
esophorbitely,0,13,5,8,0,0.625
nonproducible,1,13,5,8,0,0.625
rrqlj'mfpquftwzhcqvrcqy,0,23,1,22,1,0.0454545454545455
transmittings,0,13,3,10,0,0.3
prestrean,0,9,3,6,0,0.5
ditoss,0,6,2,4,0,0.5
precomputing,1,12,4,8,0,0.5
kiwqagk'xpnqfhl'k'ypvibobg'jl,0,29,4,25,4,0.16
canas,0,5,2,3,0,0.666666666666667
dero,0,4,2,2,0,1
okevvy,0,6,2,4,0,0.5
anasarca,1,8,4,4,0,1
unprofessionally,1,16,6,10,0,0.6
uneeda,1,6,4,2,0,2
frederica,1,9,4,5,0,0.8
trimmerally,0,11,3,8,0,0.375
momently,1,8,2,6,0,0.333333333333333
stomorpts,0,9,2,7,0,0.285714285714286
euclenbreassies,0,15,7,8,0,0.875
endocele,0,8,4,4,0,1
hejanilabilitiona,0,17,9,8,0,1.125
columbar,0,8,3,5,0,0.6
reronium,0,8,4,4,0,1
mycolite,0,8,3,5,0,0.6
cludufurantison,0,15,6,9,0,0.666666666666667
jixiomper,0,9,4,5,0,0.8
libb,1,4,1,3,0,0.333333333333333
vrouws,1,6,2,4,0,0.5
archenemies,1,11,5,6,0,0.833333333333333
shortsightedness,1,16,4,12,0,0.333333333333333
hessian,1,7,3,4,0,0.75
archimime,1,9,4,5,0,0.8
tecxevfklurjbxop',0,17,4,13,1,0.307692307692308
bakehouse,1,9,5,4,0,1.25
anklebones,1,10,4,6,0,0.666666666666667
fbtynoufuskbzqwynfgmivanq,0,25,5,20,0,0.25
nondkic,0,7,2,5,0,0.4
offered,1,7,3,4,0,0.75
uyect'dsvfmotk,0,14,3,11,1,0.272727272727273
superstar,1,9,3,6,0,0.5
zbyczhyttxqeaw'b'dzbh,0,21,2,19,2,0.105263157894737
sapphisms,1,9,2,7,0,0.285714285714286
mutabilities,1,12,6,6,0,1
slavonias,0,9,4,5,0,0.8
alysoun,1,7,3,4,0,0.75
cloup,0,5,2,3,0,0.666666666666667
acceptablenesses,1,16,6,10,0,0.6
antiricin,1,9,4,5,0,0.8
needleproof,1,11,5,6,0,0.833333333333333
homospories,1,11,5,6,0,0.833333333333333
uqj'komyzvp,0,11,2,9,1,0.222222222222222
strauchted,1,10,3,7,0,0.428571428571429
portative,0,9,4,5,0,0.8
outlawins,0,9,4,5,0,0.8
cola,1,4,2,2,0,1
burgoo,1,6,3,3,0,1
mazateco,1,8,4,4,0,1
kd,1,2,0,2,0,0
clems,1,5,1,4,0,0.25
gitana,1,6,3,3,0,1
avkasvppwf''c,0,13,2,11,2,0.181818181818182
scornings,1,9,2,7,0,0.285714285714286
lipariontsdinymishmen,0,21,7,14,0,0.5
egomsulatreinierros,0,19,9,10,0,0.9
sulphantimonite,1,15,6,9,0,0.666666666666667
condoes,1,7,3,4,0,0.75
conicamole,0,10,5,5,0,1
harmaning,1,9,3,6,0,0.5
worthmetelted,0,13,4,9,0,0.444444444444444
untathebanthodoubletisms,0,24,9,15,0,0.6
ventiducts,1,10,3,7,0,0.428571428571429
tofruid,0,7,3,4,0,0.75
preachments,1,11,3,8,0,0.375
unrefracting,1,12,4,8,0,0.5
osbourn,1,7,3,4,0,0.75
readvances,1,10,4,6,0,0.666666666666667
tenchifying,0,11,3,8,0,0.375
'qiwyykkzu,0,10,2,8,1,0.25
vedis,1,5,2,3,0,0.666666666666667
philomel,1,8,3,5,0,0.6
spain,1,5,2,3,0,0.666666666666667
rhical,0,6,2,4,0,0.5
frogeye,1,7,3,4,0,0.75
bubo,1,4,2,2,0,1
supersoler,0,10,4,6,0,0.666666666666667
blllaunavingrretes,0,18,6,12,0,0.5
heartthrob,1,10,3,7,0,0.428571428571429
marawling,0,9,3,6,0,0.5
nonphysiologically,1,18,6,12,0,0.5
ophilocybin,0,11,4,7,0,0.571428571428571
divulgence,1,10,4,6,0,0.666666666666667
cydipping,0,9,2,7,0,0.285714285714286
reenthrones,1,11,4,7,0,0.571428571428571
interwise,0,9,4,5,0,0.8
chronogrammic,1,13,4,9,0,0.444444444444444
qfjykuqemjqlthhldpvhiynyvk,0,26,3,23,0,0.130434782608696
reaumur,1,7,4,3,0,1.33333333333333
microcration,0,12,5,7,0,0.714285714285714
litsertingly,0,12,3,9,0,0.333333333333333
bridered,0,8,3,5,0,0.6
countertransversely,0,19,6,13,0,0.461538461538462
hfoayjytnvbbn,0,13,2,11,0,0.181818181818182
preceptories,1,12,5,7,0,0.714285714285714
yshhtkq,0,7,0,7,0,0
champignons,1,11,3,8,0,0.375
charterioculamite,0,17,8,9,0,0.888888888888889
takhan,0,6,2,4,0,0.5
tenetruddys,0,11,3,8,0,0.375
alplerounancocrfr,0,17,6,11,0,0.545454545454545
footganger,1,10,4,6,0,0.666666666666667
distocles,0,9,3,6,0,0.5
harbon,0,6,2,4,0,0.5
ovenintic,0,9,4,5,0,0.8
dinks,1,5,1,4,0,0.25
leblood,0,7,3,4,0,0.75
shle,0,4,1,3,0,0.333333333333333
unsettled,1,9,3,6,0,0.5
obsecrations,1,12,5,7,0,0.714285714285714
g'jgbmwqthvwpvlctms'uo'yzv,0,26,2,24,3,0.0833333333333333
mhakccefanlsoifucdyz,0,20,6,14,0,0.428571428571429
precaudal,1,9,4,5,0,0.8
bcjnqtrlrfv'pm'alzd,0,19,1,18,2,0.0555555555555556
omniscaling,0,11,4,7,0,0.571428571428571
achlor,0,6,2,4,0,0.5
laboratories,1,12,6,6,0,1
softies,1,7,3,4,0,0.75
nonfusibility,1,13,5,8,0,0.625
guinn,1,5,2,3,0,0.666666666666667
ontrititopablerainerontanastogaled,0,34,15,19,0,0.789473684210526
lunik,1,5,2,3,0,0.666666666666667
xyty'fnhixtxeddtcsv,0,19,2,17,1,0.117647058823529
ub'l'lqqvsejrcukvzhlbxple,0,25,4,21,2,0.19047619047619
electant,1,8,3,5,0,0.6
kiehl,1,5,2,3,0,0.666666666666667
riated,0,6,3,3,0,1
hypersensitised,1,15,5,10,0,0.5
heptachronous,1,13,5,8,0,0.625
bllogllsmis,0,11,2,9,0,0.222222222222222
nadbus,1,6,2,4,0,0.5
vlftqhupw,0,9,1,8,0,0.125
selva,1,5,2,3,0,0.666666666666667
harmereillysinga,0,16,6,10,0,0.6
influenced,1,10,4,6,0,0.666666666666667
instateroom,0,11,5,6,0,0.833333333333333
pethanegracast,0,14,5,9,0,0.555555555555556
hubman,0,6,2,4,0,0.5
hemapo,0,6,3,3,0,1
gchilvilly,0,10,2,8,0,0.25
ougamy,1,6,3,3,0,1
butleresses,0,11,4,7,0,0.571428571428571
cemitaur,0,8,4,4,0,1
physicobiological,1,17,7,10,0,0.7
berytidae,1,9,4,5,0,0.8
provocation,1,11,5,6,0,0.833333333333333
ingleneuks,1,10,4,6,0,0.666666666666667
bailee,1,6,4,2,0,2
postadolescences,1,16,6,10,0,0.6
ananite,1,7,4,3,0,1.33333333333333
mahatmas,1,8,3,5,0,0.6
teco,1,4,2,2,0,1
horsemongers,0,12,4,8,0,0.5
epidote,1,7,4,3,0,1.33333333333333
mesoparapteron,1,14,6,8,0,0.75
decivilizing,0,12,5,7,0,0.714285714285714
fingerpaints,1,12,4,8,0,0.5
presurmises,1,11,4,7,0,0.571428571428571
phras,0,5,1,4,0,0.25
dation,0,6,3,3,0,1
apfelstadt,1,10,3,7,0,0.428571428571429
ludovico,1,8,4,4,0,1
munwarconwg,0,11,3,8,0,0.375
cmzfll,0,6,0,6,0,0
gqpaodrn'weozsffqswgr,0,21,4,17,1,0.235294117647059
trus,0,4,1,3,0,0.333333333333333
cariniana,1,9,5,4,0,1.25
raddi,1,5,2,3,0,0.666666666666667
beelting,0,8,3,5,0,0.6
outbury,0,7,3,4,0,0.75
yellowknife,1,11,4,7,0,0.571428571428571
formulisms,1,10,3,7,0,0.428571428571429
fultioncoologuebartetowzi,0,25,12,13,0,0.923076923076923
noodi,0,5,3,2,0,1.5
jerma,0,5,2,3,0,0.666666666666667
alco,1,4,2,2,0,1
galactometeor,0,13,6,7,0,0.857142857142857
gazeucitroganders,0,17,7,10,0,0.7
melloni,0,7,3,4,0,0.75
redeploy,1,8,3,5,0,0.6
hintonesis,0,10,4,6,0,0.666666666666667
buckshee,1,8,3,5,0,0.6
qmywafaphv,0,10,2,8,0,0.25
infeighterede,0,13,6,7,0,0.857142857142857
hardress,0,8,2,6,0,0.333333333333333
hom,1,3,1,2,0,0.5
dolgeville,1,10,4,6,0,0.666666666666667
nonrecombinant,1,14,5,9,0,0.555555555555556
glm,0,3,0,3,0,0
hisqunkoky'rbckweft'mzj'nab,0,27,5,22,3,0.227272727272727
qumellie,0,8,4,4,0,1
oebatbowjsjunshidxbdmli,0,23,7,16,0,0.4375
cangr,0,5,1,4,0,0.25
subdeb,1,6,2,4,0,0.5
casecreate,0,10,5,5,0,1
chauncing,1,9,3,6,0,0.5
nonychial,0,9,3,6,0,0.5
cqlzpoirqqtbamrgvjznnmujnmagub,0,30,6,24,0,0.25
constocytosigmativiolaptings,0,28,10,18,0,0.555555555555556
fusted,0,6,2,4,0,0.5
woodilurism,0,11,5,6,0,0.833333333333333
ooblast,1,7,3,4,0,0.75
alicrande,0,9,4,5,0,0.8
interlocutor,1,12,5,7,0,0.714285714285714
bechet,1,6,2,4,0,0.5
eltx,0,4,1,3,0,0.333333333333333
seleness,0,8,3,5,0,0.6
nemus,0,5,2,3,0,0.666666666666667
tegumentum,1,10,4,6,0,0.666666666666667
forklifted,1,10,3,7,0,0.428571428571429
nytgtzpvnv,0,10,0,10,0,0
hector,1,6,2,4,0,0.5
pyreantesquirer,0,15,6,9,0,0.666666666666667
undaily,1,7,3,4,0,0.75
friendship,1,10,3,7,0,0.428571428571429
skarless,0,8,2,6,0,0.333333333333333
phantic,1,7,2,5,0,0.4
filiety,1,7,3,4,0,0.75
iodis,0,5,3,2,0,1.5
wrjjqzlf,0,8,0,8,0,0
underwheels,0,11,4,7,0,0.571428571428571
renal,1,5,2,3,0,0.666666666666667
didders,1,7,2,5,0,0.4
dzqm'iqbpfjlf,0,13,1,12,1,0.0833333333333333
proctoral,1,9,3,6,0,0.5
unsymbolineariehs,0,17,7,10,0,0.7
elite,1,5,3,2,0,1.5
fiestralits,0,11,4,7,0,0.571428571428571
fenelton,1,8,3,5,0,0.6
vitilitigated,1,13,6,7,0,0.857142857142857
footyphytes,0,11,3,8,0,0.375
semiradicalness,1,15,6,9,0,0.666666666666667
kuroshio,1,8,4,4,0,1
toponymic,1,9,3,6,0,0.5
rosemonopolis,0,13,6,7,0,0.857142857142857
asyurelantitiscrystervicelournut,0,32,12,20,0,0.6
rechesentheimpianonoralengs,0,27,11,16,0,0.6875
photome,0,7,3,4,0,0.75
swp'bsi'ai,0,10,3,7,2,0.428571428571429
keyport,1,7,2,5,0,0.4
peremma,0,7,3,4,0,0.75
sobersidedness,1,14,5,9,0,0.555555555555556
retrude,1,7,3,4,0,0.75
afterwit,1,8,3,5,0,0.6
barbecue,1,8,4,4,0,1
simule,1,6,3,3,0,1
ravaw,0,5,2,3,0,0.666666666666667
muckworm,1,8,2,6,0,0.333333333333333
voltmentonists,0,14,4,10,0,0.4
commemorational,1,15,7,8,0,0.875
epispadiases,0,12,6,6,0,1
orrices,1,7,3,4,0,0.75
etudes,1,6,3,3,0,1
oredly,0,6,2,4,0,0.5
scribbleomania,1,14,6,8,0,0.75
misferon,0,8,3,5,0,0.6
multicausality,0,14,6,8,0,0.75
rumaki,1,6,3,3,0,1
hesperiphona,1,12,5,7,0,0.714285714285714
vapidnesses,1,11,4,7,0,0.571428571428571
garners,1,7,2,5,0,0.4
stemonous,0,9,4,5,0,0.8
petroleous,1,10,5,5,0,1
bridapona,0,9,4,5,0,0.8
l'oreal,1,7,3,4,1,0.75
cundiflorales,0,13,5,8,0,0.625
benenstein,0,10,4,6,0,0.666666666666667
qutownctialap,0,13,5,8,0,0.625
insolubilisation,1,16,8,8,0,1
apind,0,5,2,3,0,0.666666666666667
ddis,0,4,1,3,0,0.333333333333333
reblame,1,7,3,4,0,0.75
nbckrkjvt',0,10,0,10,1,0
pickier,1,7,3,4,0,0.75
brusha,0,6,2,4,0,0.5
meneers,1,7,3,4,0,0.75
windraminia,0,11,5,6,0,0.833333333333333
opisthodomus,1,12,5,7,0,0.714285714285714
syverson,1,8,2,6,0,0.333333333333333
devlen,1,6,2,4,0,0.5
inarguable,1,10,5,5,0,1
ultraradically,0,14,5,9,0,0.555555555555556
eutaxite,1,8,5,3,0,1.66666666666667
overcommunication,1,17,8,9,0,0.888888888888889
redrives,1,8,3,5,0,0.6
flumish,0,7,2,5,0,0.4
artensively,0,11,4,7,0,0.571428571428571
capulation,0,10,5,5,0,1
wirebird,1,8,3,5,0,0.6
slaister,1,8,3,5,0,0.6
chuoy,0,5,2,3,0,0.666666666666667
colourtype,1,10,4,6,0,0.666666666666667
seriolations,0,12,6,6,0,1
turrile,0,7,3,4,0,0.75
vseevzxwrzw,0,11,2,9,0,0.222222222222222
bpmwofmrunyrpy,0,14,2,12,0,0.166666666666667
kyprbucleshapt,0,14,3,11,0,0.272727272727273
classman,1,8,2,6,0,0.333333333333333
imod'cbuhvozrmnuxvr,0,19,5,14,1,0.357142857142857
burnish,1,7,2,5,0,0.4
veringriunvinton,0,16,6,10,0,0.6
ackneys,0,7,2,5,0,0.4
raropis,0,7,3,4,0,0.75
blankety,1,8,2,6,0,0.333333333333333
canistota,1,9,4,5,0,0.8
cyberpunk,1,9,2,7,0,0.285714285714286
tonganoxie,1,10,5,5,0,1
pampination,1,11,5,6,0,0.833333333333333
preedit,1,7,3,4,0,0.75
deflatform,0,10,3,7,0,0.428571428571429
miermal,0,7,3,4,0,0.75
uncoifed,1,8,4,4,0,1
maxatawny,1,9,3,6,0,0.5
pandreidls,0,10,3,7,0,0.428571428571429
shermanesque,1,12,5,7,0,0.714285714285714
hetaerist,1,9,4,5,0,0.8
elenchize,1,9,4,5,0,0.8
patrocities,0,11,5,6,0,0.833333333333333
nitrogenergirlfried,0,19,7,12,0,0.583333333333333
scopate,1,7,3,4,0,0.75
disciss,0,7,2,5,0,0.4
toski,0,5,2,3,0,0.666666666666667
ooscicidalskabomarfis,0,21,9,12,0,0.75
cannelated,1,10,4,6,0,0.666666666666667
chou,1,4,2,2,0,1
monsterhood,1,11,4,7,0,0.571428571428571
bunbury,1,7,2,5,0,0.4
hhubt'usqdbugmbjqgdvdhqhuocay,0,29,6,23,1,0.260869565217391
hippolytungstate,0,16,5,11,0,0.454545454545455
scltgwkhelbeeopmu,0,17,5,12,0,0.416666666666667
lithr,0,5,1,4,0,0.25
senatia,0,7,4,3,0,1.33333333333333
opisthenar,1,10,4,6,0,0.666666666666667
varmint,1,7,2,5,0,0.4
somniloquentness,0,16,6,10,0,0.6
weslophy,0,8,2,6,0,0.333333333333333
sphegidae,1,9,4,5,0,0.8
amahorocame,0,11,6,5,0,1.2
triaster,1,8,3,5,0,0.6
scalz,1,5,1,4,0,0.25
wianipigavasequmoravepholiondasuci,0,34,17,17,0,1
hackman,1,7,2,5,0,0.4
jaimie,1,6,4,2,0,2
years,1,5,2,3,0,0.666666666666667
skixwonofbxpbsr,0,15,3,12,0,0.25
entiat,1,6,3,3,0,1
tredecillion,1,12,5,7,0,0.714285714285714
lavqorplswghnjuseohldhqroo,0,26,7,19,0,0.368421052631579
prologing,1,9,3,6,0,0.5
baler,1,5,2,3,0,0.666666666666667
mfumbit'lrj'vovnqacy'wlqrdrayf,0,30,5,25,3,0.2
amaliladurisenians,0,18,9,9,0,1
motioner,1,8,4,4,0,1
forestaysail,1,12,5,7,0,0.714285714285714
orsini,1,6,3,3,0,1
gynarchy,1,8,1,7,0,0.142857142857143
mascularises,0,12,5,7,0,0.714285714285714
sntove,0,6,2,4,0,0.5
cannibals,1,9,3,6,0,0.5
mendebsing,0,10,3,7,0,0.428571428571429
mushaa,1,6,3,3,0,1
hloplkmtczjemxzqxsbqgssvsqk,0,27,2,25,0,0.08
phlebology,1,10,3,7,0,0.428571428571429
vappes,0,6,2,4,0,0.5
dunker,1,6,2,4,0,0.5
atevecinittretighos,0,19,8,11,0,0.727272727272727
twangings,1,9,2,7,0,0.285714285714286
germinable,1,10,4,6,0,0.666666666666667
mouthedly,0,9,3,6,0,0.5
homoeochromate,0,14,7,7,0,1
unchulle,0,8,3,5,0,0.6
lackeyed,1,8,3,5,0,0.6
cheerlessness,1,13,4,9,0,0.444444444444444
rotal,1,5,2,3,0,0.666666666666667
lilojhoaezibmbr,0,15,6,9,0,0.666666666666667
cloisterellos,0,13,5,8,0,0.625
systoles,1,8,2,6,0,0.333333333333333
aga,1,3,2,1,0,2
bleaks,1,6,2,4,0,0.5
slatemaker,1,10,4,6,0,0.666666666666667
anamiter,0,8,4,4,0,1
dopantioutiona,0,14,8,6,0,1.33333333333333
cassioners,0,10,4,6,0,0.666666666666667
cnftdbcyyc,0,10,0,10,0,0
gmeaau',0,7,4,3,1,1.33333333333333
unseraphical,1,12,5,7,0,0.714285714285714
hospropiper,0,11,4,7,0,0.571428571428571
thy,1,3,0,3,0,0
regule,0,6,3,3,0,1
buvety,0,6,2,4,0,0.5
malfeasor,1,9,4,5,0,0.8
zaptist,0,7,2,5,0,0.4
phrenes,0,7,2,5,0,0.4
sottiaccar,0,10,4,6,0,0.666666666666667
binocular,1,9,4,5,0,0.8
opaline,1,7,4,3,0,1.33333333333333
polymixiidae,1,12,6,6,0,1
tunicumnus,0,10,4,6,0,0.666666666666667
yijdyvljplex,0,12,2,10,0,0.2
corcaseigh,0,10,4,6,0,0.666666666666667
xorhziogzbn,0,11,3,8,0,0.375
fistics,0,7,2,5,0,0.4
cabrfalalnhamanonfovisly,0,24,8,16,0,0.5
resails,1,7,3,4,0,0.75
ctrs,0,4,0,4,0,0
zfqysbaettcijlfairqavquydk,0,26,7,19,0,0.368421052631579
oaklawn,1,7,3,4,0,0.75
unclarity,1,9,3,6,0,0.5
supratrochlear,1,14,5,9,0,0.555555555555556
convolypocryosalling,0,20,6,14,0,0.428571428571429
gibsonburg,1,10,3,7,0,0.428571428571429
ngleauremadamr,0,14,6,8,0,0.75
prouloettes,0,11,5,6,0,0.833333333333333
geodesy,1,7,3,4,0,0.75
gynaecocratic,1,13,5,8,0,0.625
zacharia,1,8,4,4,0,1
indully,0,7,2,5,0,0.4
sitaiverscofterpsone,0,20,8,12,0,0.666666666666667
varietotoluentialis,0,19,10,9,0,1.11111111111111
bazzazz,0,7,2,5,0,0.4
inatrbkilem,0,11,4,7,0,0.571428571428571
repaper,1,7,3,4,0,0.75
upo'xkhacjee,0,12,5,7,1,0.714285714285714
bulid,0,5,2,3,0,0.666666666666667
manilas,1,7,3,4,0,0.75
laree,1,5,3,2,0,1.5
undervaulting,1,13,5,8,0,0.625
roceous,0,7,4,3,0,1.33333333333333
reminegraveless,0,15,6,9,0,0.666666666666667
foreseau,0,8,5,3,0,1.66666666666667
stertorious,1,11,5,6,0,0.833333333333333
abatjour,1,8,4,4,0,1
ngelishod,0,9,3,6,0,0.5
radars,1,6,2,4,0,0.5
helquje,0,7,3,4,0,0.75
entaculli,0,9,4,5,0,0.8
qczrpxvoxeu,0,11,3,8,0,0.375
heortologion,1,12,6,6,0,1
lithite,1,7,3,4,0,0.75
santini,1,7,3,4,0,0.75
gabbed,1,6,2,4,0,0.5
missu,0,5,2,3,0,0.666666666666667
unexpectable,1,12,5,7,0,0.714285714285714
alulosurioplaba,0,15,8,7,0,1.14285714285714
beneighbored,1,12,5,7,0,0.714285714285714
lwl,1,3,0,3,0,0
unmalignant,1,11,4,7,0,0.571428571428571
shopharyngonasa,0,15,5,10,0,0.5
trian,0,5,2,3,0,0.666666666666667
blticowoo,0,9,4,5,0,0.8
brummie,1,7,3,4,0,0.75
dirige,1,6,3,3,0,1
tremendousness,1,14,5,9,0,0.555555555555556
firelit,1,7,3,4,0,0.75
sacramentariness,0,16,6,10,0,0.6
expositresses,1,13,5,8,0,0.625
kk,0,2,0,2,0,0
'veutz'yf'w'mf,0,14,2,12,4,0.166666666666667
atiptoe,1,7,4,3,0,1.33333333333333
kelayre,0,7,3,4,0,0.75
shily,1,5,1,4,0,0.25
callused,1,8,3,5,0,0.6
bevomite,0,8,4,4,0,1
verdit,1,6,2,4,0,0.5
almerrined,0,10,4,6,0,0.666666666666667
citriculturists,1,15,5,10,0,0.5
uezhkirpbwcvo,0,13,4,9,0,0.444444444444444
promorouvassurin,0,16,7,9,0,0.777777777777778
mussolini,1,9,4,5,0,0.8
rosential,0,9,4,5,0,0.8
hingerbreeder,0,13,5,8,0,0.625
mucilaginae,0,11,6,5,0,1.2
neurorthoptera,1,14,6,8,0,0.75
heterokaryosis,1,14,6,8,0,0.75
auxograph,1,9,4,5,0,0.8
chemoserotherapy,1,16,6,10,0,0.6
wigless,1,7,2,5,0,0.4
fantisferrel,0,12,4,8,0,0.5
emporidenhurrin,0,15,6,9,0,0.666666666666667
hagiolater,1,10,5,5,0,1
wokenetrun,0,10,4,6,0,0.666666666666667
windians,0,8,3,5,0,0.6
nondeciduata,1,12,6,6,0,1
britannicus,1,11,4,7,0,0.571428571428571
clappress,0,9,2,7,0,0.285714285714286
pron,0,4,1,3,0,0.333333333333333
betfbidogesoperpemiuminesphd,0,28,11,17,0,0.647058823529412
preinterreign,0,13,5,8,0,0.625
caeijcfcmqnul',0,14,4,10,1,0.4
rys,0,3,0,3,0,0
kingfisher,1,10,3,7,0,0.428571428571429
rejacketier,0,11,5,6,0,0.833333333333333
monregarting,0,12,4,8,0,0.5
uyvvjgsggaktdwgev,0,17,3,14,0,0.214285714285714
blatchang,1,9,2,7,0,0.285714285714286
joineral,0,8,4,4,0,1
connectors,1,10,3,7,0,0.428571428571429
interpretableness,1,17,6,11,0,0.545454545454545
samessability,0,13,5,8,0,0.625
jamator,0,7,3,4,0,0.75
underpaying,1,11,4,7,0,0.571428571428571
wedron,1,6,2,4,0,0.5
hastened,1,8,3,5,0,0.6
brachygrapher,1,13,3,10,0,0.3
tentily,1,7,2,5,0,0.4
diapherome,0,10,5,5,0,1
maunch,1,6,2,4,0,0.5
antinoma,0,8,4,4,0,1
transvaluer,1,11,4,7,0,0.571428571428571
ferrals,0,7,2,5,0,0.4
gribirobistitypirubbertaridgeemocyograseming,0,44,17,27,0,0.62962962962963
spellcheck,1,10,2,8,0,0.25
nwp'qyivuc,0,10,2,8,1,0.25
mvssafroevotacy,0,15,5,10,0,0.5
saccharobacillus,1,16,6,10,0,0.6
outbore,1,7,4,3,0,1.33333333333333
maxilliped,1,10,4,6,0,0.666666666666667
dovehouseman,0,12,6,6,0,1
ochrana,1,7,3,4,0,0.75
anilao,1,6,4,2,0,2
unpurian,0,8,4,4,0,1
pinfolds,1,8,2,6,0,0.333333333333333
bromoisie,0,9,5,4,0,1.25
utsan,0,5,2,3,0,0.666666666666667
shoetroxime,0,11,5,6,0,0.833333333333333
javelining,1,10,4,6,0,0.666666666666667
ununified,1,9,5,4,0,1.25
bornites,1,8,3,5,0,0.6
hocumangors,0,11,4,7,0,0.571428571428571
asness,0,6,2,4,0,0.5
rial,1,4,2,2,0,1
enesids,0,7,3,4,0,0.75
centralisers,1,12,4,8,0,0.5
'fcoextqfjzidd,0,14,3,11,1,0.272727272727273
absorber,1,8,3,5,0,0.6
atmolybdenia,0,12,5,7,0,0.714285714285714
unmacer,0,7,3,4,0,0.75
innuits,1,7,3,4,0,0.75
arein,0,5,3,2,0,1.5
subillerprollowwales,0,20,7,13,0,0.538461538461538
salvia,1,6,3,3,0,1
mutums,0,6,2,4,0,0.5
communism,1,9,3,6,0,0.5
umbraculum,1,10,4,6,0,0.666666666666667
epitously,0,9,4,5,0,0.8
prophylactodontist,1,18,5,13,0,0.384615384615385
almoindexing,0,12,5,7,0,0.714285714285714
antecedence,1,11,5,6,0,0.833333333333333
galvaniser,1,10,4,6,0,0.666666666666667
hatchettolite,1,13,5,8,0,0.625
gier,0,4,2,2,0,1
apleta,0,6,3,3,0,1
osteostixis,1,11,5,6,0,0.833333333333333
lppyjqfagge,0,11,2,9,0,0.222222222222222
epigraphies,1,11,5,6,0,0.833333333333333
lacunulose,1,10,5,5,0,1
abola,0,5,3,2,0,1.5
embra,0,5,2,3,0,0.666666666666667
lacar,0,5,2,3,0,0.666666666666667
ateste,1,6,3,3,0,1
endosiphonate,1,13,6,7,0,0.857142857142857
theolatrous,1,11,5,6,0,0.833333333333333
sualistiastres,0,14,6,8,0,0.75
jlrvgygqddbcq,0,13,0,13,0,0
neckties,1,8,3,5,0,0.6
stic,0,4,1,3,0,0.333333333333333
meditatedly,1,11,4,7,0,0.571428571428571
lichenography,1,13,4,9,0,0.444444444444444
hotshot,1,7,2,5,0,0.4
amboyna,1,7,3,4,0,0.75
'vvxhl'zmgvfislfhkdozczm,0,24,2,22,2,0.0909090909090909
highboys,1,8,2,6,0,0.333333333333333
suce,0,4,2,2,0,1
endogastritis,1,13,5,8,0,0.625
unformularize,1,13,6,7,0,0.857142857142857
cotid,0,5,2,3,0,0.666666666666667
saucissoidal,0,12,6,6,0,1
baukaeim'gwocswdiom,0,19,8,11,1,0.727272727272727
benge,1,5,2,3,0,0.666666666666667
autoimmunities,1,14,8,6,0,1.33333333333333
sapphist,1,8,2,6,0,0.333333333333333
lockeanism,1,10,4,6,0,0.666666666666667
hmkhkf'uomporwiwny,0,18,4,14,1,0.285714285714286
phenytoin,1,9,3,6,0,0.5
oneshy,0,6,2,4,0,0.5
ghethfundrial,0,13,4,9,0,0.444444444444444
adjoin,1,6,3,3,0,1
pibermardale,0,12,5,7,0,0.714285714285714
anomerelia,0,10,6,4,0,1.5
orthid,1,6,2,4,0,0.5
cheesecutor,0,11,5,6,0,0.833333333333333
ralph,1,5,1,4,0,0.25
outcrying,1,9,3,6,0,0.5
phogal,0,6,2,4,0,0.5
cults,0,5,1,4,0,0.25
rubbit,1,6,2,4,0,0.5
murtaugh,1,8,3,5,0,0.6
bathinette,1,10,4,6,0,0.666666666666667
blunda,0,6,2,4,0,0.5
jinglebob,1,9,3,6,0,0.5
paralyse,1,8,3,5,0,0.6
z'omtocakcqg,0,12,3,9,1,0.333333333333333
rhythmy,0,7,0,7,0,0
sticharions,1,11,4,7,0,0.571428571428571
duckboards,1,10,3,7,0,0.428571428571429
parvati,1,7,3,4,0,0.75
inoul,0,5,3,2,0,1.5
thoroughgang,0,12,4,8,0,0.5
thanadarko,0,10,4,6,0,0.666666666666667
protensional,0,12,5,7,0,0.714285714285714
irascibilities,1,14,7,7,0,1
thermoreceptor,1,14,5,9,0,0.555555555555556
repeal,1,6,3,3,0,1
pottering,1,9,3,6,0,0.5
ernerboaria,0,11,6,5,0,1.2
fearer,1,6,3,3,0,1
knaster,1,7,2,5,0,0.4
widerately,0,10,4,6,0,0.666666666666667
mperes,0,6,2,4,0,0.5
dyirbals,1,8,2,6,0,0.333333333333333
overpraise,1,10,5,5,0,1
intrepidity,1,11,4,7,0,0.571428571428571
vadsore,0,7,3,4,0,0.75
petfood,1,7,3,4,0,0.75
snaillas,0,8,3,5,0,0.6
nobic,0,5,2,3,0,0.666666666666667
eny,0,3,1,2,0,0.5
reimprovement,1,13,5,8,0,0.625
phocammerists,0,13,4,9,0,0.444444444444444
cclqa,0,5,1,4,0,0.25
pargethishidrads,0,16,5,11,0,0.454545454545455
smokeboards,1,11,4,7,0,0.571428571428571
proacademic,1,11,5,6,0,0.833333333333333
unfattenishment,0,15,5,10,0,0.5
unrichlian,0,10,4,6,0,0.666666666666667
pinkeyes,1,8,3,5,0,0.6
thrum,1,5,1,4,0,0.25
hookswingings,0,13,4,9,0,0.444444444444444
xanthopsin,1,10,3,7,0,0.428571428571429
agroindustries,1,14,6,8,0,0.75
wavefronting,0,12,4,8,0,0.5
romethpans,0,10,3,7,0,0.428571428571429
sehllyprongrobegron,0,19,5,14,0,0.357142857142857
labournmenta,0,12,5,7,0,0.714285714285714
hemationisate,0,13,7,6,0,1.16666666666667
dockinders,0,10,3,7,0,0.428571428571429
jerrymander,1,11,3,8,0,0.375
grigioni,1,8,4,4,0,1
overfaithful,1,12,5,7,0,0.714285714285714
hyetometrographic,1,17,6,11,0,0.545454545454545
paupered,1,8,4,4,0,1
breadnesses,0,11,4,7,0,0.571428571428571
sydneysider,1,11,3,8,0,0.375
pecherg,0,7,2,5,0,0.4
abadejo,1,7,4,3,0,1.33333333333333
kzvjsyi'f'ghmcvbgvurqua,0,23,4,19,2,0.210526315789474
akra,1,4,2,2,0,1
presong,1,7,2,5,0,0.4
siberson,1,8,3,5,0,0.6
intice,1,6,3,3,0,1
unsulfureousness,1,16,7,9,0,0.777777777777778
comor,0,5,2,3,0,0.666666666666667
picea,1,5,3,2,0,1.5
racefulness,0,11,4,7,0,0.571428571428571
glower,1,6,2,4,0,0.5
nmadjqdnpbanmwxif,0,17,3,14,0,0.214285714285714
aquanautics,1,11,6,5,0,1.2
hmfqkpmeqzomnzkhwiqryvirokbqz,0,29,5,24,0,0.208333333333333
tootsie,1,7,4,3,0,1.33333333333333
delegatees,1,10,5,5,0,1
boilermaking,1,12,5,7,0,0.714285714285714
frutex,1,6,2,4,0,0.5
zoehemertificatedly,0,19,8,11,0,0.727272727272727
chrysopidae,1,11,4,7,0,0.571428571428571
ulitises,1,8,4,4,0,1
sallowings,0,10,3,7,0,0.428571428571429
orchesography,1,13,4,9,0,0.444444444444444
noncapital,1,10,4,6,0,0.666666666666667
ardoch,1,6,2,4,0,0.5
soundboard,1,10,4,6,0,0.666666666666667
dpedeniq,0,8,3,5,0,0.6
insures,1,7,3,4,0,0.75
ferrocking,0,10,3,7,0,0.428571428571429
isorberatology,0,14,6,8,0,0.75
fistiaro,0,8,4,4,0,1
pseudoscines,1,12,5,7,0,0.714285714285714
effectively,1,11,4,7,0,0.571428571428571
ebldmba'bni'wout,0,16,5,11,2,0.454545454545455
spammiest,1,9,3,6,0,0.5
vacationland,1,12,5,7,0,0.714285714285714
latensifier,0,11,5,6,0,0.833333333333333
hare,1,4,2,2,0,1
allot,1,5,2,3,0,0.666666666666667
brownson,1,8,2,6,0,0.333333333333333
gillie,1,6,3,3,0,1
ultracelsic,0,11,4,7,0,0.571428571428571
xjuswuqluwdc'dgwmv'm,0,20,3,17,2,0.176470588235294
oceanology,1,10,5,5,0,1
yaai,0,4,3,1,0,3
slouchily,1,9,3,6,0,0.5
assubjugated,1,12,5,7,0,0.714285714285714
'rltnqtautgbgmdisl,0,18,3,15,1,0.2
aquiculturation,0,15,8,7,0,1.14285714285714
kopiation,0,9,5,4,0,1.25
somnambulous,1,12,5,7,0,0.714285714285714
psychology,1,10,2,8,0,0.25
csdecnlcrjti,0,12,2,10,0,0.2
unynnvvroovv'y,0,14,3,11,1,0.272727272727273
annin,0,5,2,3,0,0.666666666666667
toevnruv'z'kg,0,13,3,10,2,0.3
spirtle,1,7,2,5,0,0.4
predevelopments,1,15,5,10,0,0.5
statins,1,7,2,5,0,0.4
autarch,1,7,3,4,0,0.75
kakapo,1,6,3,3,0,1
electure,0,8,4,4,0,1
nkchtiz'g,0,9,1,8,1,0.125
misenta,0,7,3,4,0,0.75
yelk,1,4,1,3,0,0.333333333333333
uacpyvfwpfawfn,0,14,3,11,0,0.272727272727273
lacies,0,6,3,3,0,1
vouchscreectopaths,0,18,6,12,0,0.5
saloonkeeper,1,12,6,6,0,1
salicornians,0,12,5,7,0,0.714285714285714
relicensed,1,10,4,6,0,0.666666666666667
deltahedra,1,10,4,6,0,0.666666666666667
zebrinny,1,8,2,6,0,0.333333333333333
mojaved,0,7,3,4,0,0.75
epiloguising,1,12,6,6,0,1
corillstice,0,11,4,7,0,0.571428571428571
vigenish,0,8,3,5,0,0.6
penic,0,5,2,3,0,0.666666666666667
phytalus,1,8,2,6,0,0.333333333333333
rwutxbgfilzvdm,0,14,2,12,0,0.166666666666667
zizania,1,7,4,3,0,1.33333333333333
antithetics,1,11,4,7,0,0.571428571428571
tridell,1,7,2,5,0,0.4
straightforwards,1,16,4,12,0,0.333333333333333
lationary,0,9,4,5,0,0.8
helivints,0,9,3,6,0,0.5
fyzuriuobrucinaxt,0,17,7,10,0,0.7
lallands,1,8,2,6,0,0.333333333333333
oraconic,0,8,4,4,0,1
drabbier,1,8,3,5,0,0.6
splagiarine,0,11,5,6,0,0.833333333333333
yemasser,0,8,3,5,0,0.6
reprivish,0,9,3,6,0,0.5
maceously,0,9,4,5,0,0.8
epithetical,1,11,5,6,0,0.833333333333333
chtestangrbashitlayamarinexhoa,0,30,11,19,0,0.578947368421053
vnn'qjipnbfgrvjjjyfa,0,20,2,18,1,0.111111111111111
thollespes,0,10,3,7,0,0.428571428571429
artdolhblnzfogd,0,15,3,12,0,0.25
muzak,1,5,2,3,0,0.666666666666667
maintenance,1,11,5,6,0,0.833333333333333
airville,1,8,4,4,0,1
underlayment,1,12,4,8,0,0.5
radiodiagnosis,1,14,7,7,0,1
intersalvable,0,13,5,8,0,0.625
afterhand,1,9,3,6,0,0.5
pite,0,4,2,2,0,1
angiocardiography,1,17,7,10,0,0.7
aposis,0,6,3,3,0,1
catguts,1,7,2,5,0,0.4
antulcaellia,0,12,6,6,0,1
teratism,1,8,3,5,0,0.6
scribner,1,8,2,6,0,0.333333333333333
homesteadings,1,13,5,8,0,0.625
jouachals,0,9,4,5,0,0.8
factorisations,1,14,6,8,0,0.75
zmkolnodinlqjnjllrgpsb,0,22,3,19,0,0.157894736842105
kowals,0,6,2,4,0,0.5
miscellanea,1,11,5,6,0,0.833333333333333
cobblery,1,8,2,6,0,0.333333333333333
ntiunc,0,6,2,4,0,0.5
gosport,1,7,2,5,0,0.4
electrocatalysis,1,16,6,10,0,0.6
leptochloride,0,13,5,8,0,0.625
pizzelle,1,8,3,5,0,0.6
homeowner,1,9,4,5,0,0.8
aphoconightombae,0,16,7,9,0,0.777777777777778
ingpvakfdewwem,0,14,4,10,0,0.4
gnotobiograph,0,13,5,8,0,0.625
psionics,1,8,3,5,0,0.6
carangidae,1,10,5,5,0,1
brachydactyly,1,13,2,11,0,0.181818181818182
sorriness,1,9,3,6,0,0.5
cavendish,1,9,3,6,0,0.5
dhekelia,1,8,4,4,0,1
quipu,1,5,3,2,0,1.5
nonfactious,1,11,5,6,0,0.833333333333333
diestock,1,8,3,5,0,0.6
baaskaap,1,8,4,4,0,1
vividest,1,8,3,5,0,0.6
dinnie,1,6,3,3,0,1
cuseentzindsmos,0,15,5,10,0,0.5
septentational,0,14,6,8,0,0.75
lcaihhgbrzn,0,11,2,9,0,0.222222222222222
bequily,0,7,3,4,0,0.75
pched,0,5,1,4,0,0.25
costae,1,6,3,3,0,1
pressel,1,7,2,5,0,0.4
hive,1,4,2,2,0,1
ationter,0,8,4,4,0,1
redefield,0,9,4,5,0,0.8
swarming,1,8,2,6,0,0.333333333333333
jjlqtmjxlnhamjiqskc,0,19,2,17,0,0.117647058823529
supertension,1,12,5,7,0,0.714285714285714
knuckleballer,1,13,4,9,0,0.444444444444444
nonextreme,1,10,4,6,0,0.666666666666667
chamal,1,6,2,4,0,0.5
electrobiologist,1,16,7,9,0,0.777777777777778
trsyfy,0,6,0,6,0,0
selealy,0,7,3,4,0,0.75
motuca,1,6,3,3,0,1
enlanklephrear,0,14,5,9,0,0.555555555555556
skapat,0,6,2,4,0,0.5
eute,0,4,3,1,0,3
nondelsson,0,10,3,7,0,0.428571428571429
limulagurdredless,0,17,6,11,0,0.545454545454545
mutiniant,0,9,4,5,0,0.8
nonobjections,0,13,5,8,0,0.625
conograuncompressnessnessers,0,28,9,19,0,0.473684210526316
moylarcquelittellayodepopechoslart,0,34,13,21,0,0.619047619047619
madanis,0,7,3,4,0,0.75
hexabiblos,1,10,4,6,0,0.666666666666667
toadflaxes,1,10,4,6,0,0.666666666666667
codeveloping,1,12,5,7,0,0.714285714285714
grologyn,0,8,2,6,0,0.333333333333333
antiphyllum,0,11,3,8,0,0.375
zoophobias,1,10,5,5,0,1
gloomeris,0,9,4,5,0,0.8
rudulph,1,7,2,5,0,0.4
sergelisol,0,10,4,6,0,0.666666666666667
superluminal,1,12,5,7,0,0.714285714285714
saddletownsend,0,14,4,10,0,0.4
repropoeinteritominess,0,22,10,12,0,0.833333333333333
defoliates,1,10,5,5,0,1
flowerist,1,9,3,6,0,0.5
aslatrulan,0,10,4,6,0,0.666666666666667
cardiolysis,1,11,4,7,0,0.571428571428571
qns,1,3,0,3,0,0
consecertuan,0,12,5,7,0,0.714285714285714
intersina,0,9,4,5,0,0.8
triglandular,1,12,4,8,0,0.5
reencountrifixation,0,19,9,10,0,0.9
karela,1,6,3,3,0,1
ringsmuth,1,9,2,7,0,0.285714285714286
urothicatfulleprous,0,19,8,11,0,0.727272727272727
eriodictyon,1,11,5,6,0,0.833333333333333
carcinogenesis,1,14,6,8,0,0.75
nonthreaded,1,11,4,7,0,0.571428571428571
pmormoerscol,0,12,4,8,0,0.5
othy,0,4,1,3,0,0.333333333333333
onoplg,0,6,2,4,0,0.5
cueist,1,6,3,3,0,1
superfuses,1,10,4,6,0,0.666666666666667
forebodes,1,9,4,5,0,0.8
tintinnabulata,0,14,6,8,0,0.75
aidos,1,5,3,2,0,1.5
chalbootter,0,11,4,7,0,0.571428571428571
nephroncus,1,10,3,7,0,0.428571428571429
bumbags,1,7,2,5,0,0.4
kuris,1,5,2,3,0,0.666666666666667
herbivorousness,1,15,6,9,0,0.666666666666667
rosava,0,6,3,3,0,1
ckechatul,0,9,3,6,0,0.5
odelle,1,6,3,3,0,1
tkdeejuhhzkbvfpsu'kvskteoim,0,27,7,20,1,0.35
deration,0,8,4,4,0,1
apriorists,1,10,4,6,0,0.666666666666667
composal,0,8,3,5,0,0.6
bridegroom,1,10,4,6,0,0.666666666666667
fjshraixvkfcubexxuf,0,19,5,14,0,0.357142857142857
ovtadryfyem,0,11,3,8,0,0.375
parrely,0,7,2,5,0,0.4
descheapsidiosmothymatiably,0,27,10,17,0,0.588235294117647
deponing,1,8,3,5,0,0.6
despotist,1,9,3,6,0,0.5
remajum,0,7,3,4,0,0.75
zascryt'kaf'le,0,14,3,11,2,0.272727272727273
polyme,0,6,2,4,0,0.5
wear,1,4,2,2,0,1
shniusettionavotivent,0,21,9,12,0,0.75
mogztvdgbgfezgeg,0,16,3,13,0,0.230769230769231
infuneral,1,9,4,5,0,0.8
rak,0,3,1,2,0,0.5
extollingly,1,11,3,8,0,0.375
lametrymentar,0,13,4,9,0,0.444444444444444
arbutin,1,7,3,4,0,0.75
laparosplenotomy,1,16,6,10,0,0.6
slockens,1,8,2,6,0,0.333333333333333
bitonal,1,7,3,4,0,0.75
qjzdkypyld,0,10,0,10,0,0
tues,1,4,2,2,0,1
pter,0,4,1,3,0,0.333333333333333
nonacquiescement,0,16,7,9,0,0.777777777777778
zack,1,4,1,3,0,0.333333333333333
muinospisiarteamea,0,18,10,8,0,1.25
aurofocunder,0,12,6,6,0,1
pitchfields,0,11,3,8,0,0.375
zrivj'acdrsmtakxppig',0,21,4,17,2,0.235294117647059
lanific,1,7,3,4,0,0.75
ditary,0,6,2,4,0,0.5
pedestrianises,1,14,6,8,0,0.75
chrygonikkim,0,12,3,9,0,0.333333333333333
rhea,1,4,2,2,0,1
ragley,1,6,2,4,0,0.5
acyetic,1,7,3,4,0,0.75
basoga,1,6,3,3,0,1
cesqutttinansus,0,15,5,10,0,0.5
laurister,0,9,4,5,0,0.8
nectar,1,6,2,4,0,0.5
nonprotectively,1,15,5,10,0,0.5
rponmsibludie,0,13,5,8,0,0.625
biogenetical,1,12,6,6,0,1
sepiidae,1,8,5,3,0,1.66666666666667
renested,1,8,3,5,0,0.6
masty,0,5,1,4,0,0.25
bles,0,4,1,3,0,0.333333333333333
uncatastrophically,1,18,6,12,0,0.5
sandplayda,0,10,3,7,0,0.428571428571429
nestories,0,9,4,5,0,0.8
administ,0,8,3,5,0,0.6
mastocarpous,0,12,5,7,0,0.714285714285714
survivers,1,9,3,6,0,0.5
kamik,1,5,2,3,0,0.666666666666667
algeria,1,7,4,3,0,1.33333333333333
dinitrile,1,9,4,5,0,0.8
bonelis,0,7,3,4,0,0.75
plenipotentiarize,1,17,8,9,0,0.888888888888889
z'lj,0,4,0,4,1,0
boorhydromoroupole,0,18,8,10,0,0.8
dectopodishingcgir,0,18,6,12,0,0.5
angikragaphenuneras,0,19,8,11,0,0.727272727272727
pomance,0,7,3,4,0,0.75
urgers,1,6,2,4,0,0.5
recordial,0,9,4,5,0,0.8
sper,0,4,1,3,0,0.333333333333333
balabsolinatting,0,16,6,10,0,0.6
sbexiongova,0,11,5,6,0,0.833333333333333
cgpxifkq'yxic,0,13,2,11,1,0.181818181818182
kenesaw,1,7,3,4,0,0.75
probwehr,0,8,2,6,0,0.333333333333333
aegopodium,1,10,6,4,0,1.5
jesher,1,6,2,4,0,0.5
parame,0,6,3,3,0,1
glossia,0,7,3,4,0,0.75
pfannkuchen,1,11,3,8,0,0.375
grotianism,1,10,4,6,0,0.666666666666667
prismation,0,10,4,6,0,0.666666666666667
mceounkingmonalanta,0,19,8,11,0,0.727272727272727
lutheranism,1,11,4,7,0,0.571428571428571
fulettis,0,8,3,5,0,0.6
p'ujyee'qhsof,0,13,4,9,2,0.444444444444444
esqueakproofe,0,13,7,6,0,1.16666666666667
jalous,0,6,3,3,0,1
junyc,0,5,1,4,0,0.25
rzaykshkzggfhrzn,0,16,1,15,0,0.0666666666666667
meffie,0,6,3,3,0,1
mantell,1,7,2,5,0,0.4
senoliadintmy,0,13,5,8,0,0.625
jettisoning,1,11,4,7,0,0.571428571428571
laingian,1,8,4,4,0,1
unascertainably,1,15,6,9,0,0.666666666666667
coapers,0,7,3,4,0,0.75
dayshine,1,8,3,5,0,0.6
glot,0,4,1,3,0,0.333333333333333
chaete,0,6,3,3,0,1
unaciousness,0,12,6,6,0,1
allanky,0,7,2,5,0,0.4
sharawadgi,1,10,4,6,0,0.666666666666667
maturaps,0,8,3,5,0,0.6
domeleis,0,8,4,4,0,1
uplong,1,6,2,4,0,0.5
superacoochoisters,0,18,8,10,0,0.8
alar,1,4,2,2,0,1
oculously,0,9,4,5,0,0.8
collinsia,1,9,4,5,0,0.8
condely,0,7,2,5,0,0.4
camerata,1,8,4,4,0,1
underhangman,1,12,4,8,0,0.5
rthos,0,5,1,4,0,0.25
jigin,0,5,2,3,0,0.666666666666667
zdvyhbc,0,7,0,7,0,0
lasomitecrmerale,0,16,7,9,0,0.777777777777778
wlrrsxjpnvqvnh'n,0,16,0,16,1,0
euscaro,1,7,4,3,0,1.33333333333333
gintopenagholiba,0,16,7,9,0,0.777777777777778
rasion,1,6,3,3,0,1
sicksburg,0,9,2,7,0,0.285714285714286
roughly,1,7,2,5,0,0.4
parotid,1,7,3,4,0,0.75
aculable,0,8,4,4,0,1
corridos,1,8,3,5,0,0.6
valvotomy,1,9,3,6,0,0.5
ined,0,4,2,2,0,1
vizardedness,0,12,4,8,0,0.5
inogeneses,0,10,5,5,0,1
puppodum,1,8,3,5,0,0.6
snamiotini,0,10,5,5,0,1
fonginck,0,8,2,6,0,0.333333333333333
mafaayh'jldqq'urdngbkzadmtshg,0,29,5,24,2,0.208333333333333
eglency,0,7,2,5,0,0.4
diborate,1,8,4,4,0,1
natrix,1,6,2,4,0,0.5
nonrumir,0,8,3,5,0,0.6
teseparanaciceeus,0,17,9,8,0,1.125
hanae,1,5,3,2,0,1.5
acise,0,5,3,2,0,1.5
angelian,0,8,4,4,0,1
opharlates,0,10,4,6,0,0.666666666666667
mimeoned,0,8,4,4,0,1
lathiophenonerrably,0,19,7,12,0,0.583333333333333
ulbeck,0,6,2,4,0,0.5
chy,0,3,0,3,0,0
skivi,0,5,2,3,0,0.666666666666667
homotransplants,1,15,4,11,0,0.363636363636364
philatelism,1,11,4,7,0,0.571428571428571
lunge,1,5,2,3,0,0.666666666666667
phalyanodocalon,0,15,6,9,0,0.666666666666667
yogity,0,6,2,4,0,0.5
ultrabasic,1,10,4,6,0,0.666666666666667
knoll,1,5,1,4,0,0.25
musicianship,1,12,5,7,0,0.714285714285714
weatogue,1,8,5,3,0,1.66666666666667
colonnade,1,9,4,5,0,0.8
nanotes,0,7,3,4,0,0.75
repartiemolotiogua,0,18,10,8,0,1.25
desacralisation,1,15,7,8,0,0.875
boobie,1,6,4,2,0,2
evertebrata,1,11,5,6,0,0.833333333333333
redemanding,0,11,4,7,0,0.571428571428571
provitamine,0,11,5,6,0,0.833333333333333
dese,0,4,2,2,0,1
seceder,1,7,3,4,0,0.75
rzvyyxbpjvoqzmuiu,0,17,4,13,0,0.307692307692308
typifier,1,8,3,5,0,0.6
epeolatries,1,11,6,5,0,1.2
begetting,1,9,3,6,0,0.5
bvbuuwrvdypessfwbfcvtj,0,22,3,19,0,0.157894736842105
preinsinuating,1,14,6,8,0,0.75
rigmarolist,0,11,4,7,0,0.571428571428571
phyleus,1,7,2,5,0,0.4
neatened,1,8,4,4,0,1
unfertally,0,10,3,7,0,0.428571428571429
aliaceae,0,8,6,2,0,3
rouserie,0,8,5,3,0,1.66666666666667
lotocks,0,7,2,5,0,0.4
cosaurinted,0,11,5,6,0,0.833333333333333
huntiegowks,1,11,4,7,0,0.571428571428571
metereforman,0,12,5,7,0,0.714285714285714
jamblis,0,7,2,5,0,0.4
cnufsneitw'rmwrltv,0,18,3,15,1,0.2
swashbuckler,1,12,3,9,0,0.333333333333333
hemelyttra,1,10,3,7,0,0.428571428571429
pancreatotomies,1,15,7,8,0,0.875
carednesqual,0,12,5,7,0,0.714285714285714
puddingberry,1,12,3,9,0,0.333333333333333
surrena,0,7,3,4,0,0.75
serology,1,8,3,5,0,0.6
gless,0,5,1,4,0,0.25
quadruplexing,1,13,5,8,0,0.625
introspectionist,1,16,6,10,0,0.6
fiches,1,6,2,4,0,0.5
nontyrannical,1,13,4,9,0,0.444444444444444
chittering,1,10,3,7,0,0.428571428571429
arbovale,1,8,4,4,0,1
'zfkfujqajq,0,11,2,9,1,0.222222222222222
puncerighastiones,0,17,7,10,0,0.7
battalie,0,8,4,4,0,1
overtiming,1,10,4,6,0,0.666666666666667
inhaustics,0,10,4,6,0,0.666666666666667
kozdkjyvwolmyyjnpxl,0,19,2,17,0,0.117647058823529
fbwmzibppflfhnwgciwquwj,0,23,3,20,0,0.15
pyrodia,0,7,3,4,0,0.75
discrepance,1,11,4,7,0,0.571428571428571
topheling,0,9,3,6,0,0.5
''wfyffsbrx,0,11,0,11,2,0
abels,0,5,2,3,0,0.666666666666667
wiggier,1,7,3,4,0,0.75
whafabout,1,9,4,5,0,0.8
haggardly,1,9,2,7,0,0.285714285714286
nailset,1,7,3,4,0,0.75
gissive,0,7,3,4,0,0.75
triatoma,1,8,4,4,0,1
jirery,0,6,2,4,0,0.5
dantoid,0,7,3,4,0,0.75
pemberton,1,9,3,6,0,0.5
uncepallonfrouscrelenza,0,23,9,14,0,0.642857142857143
piet,1,4,2,2,0,1
plasteanephendity,0,17,6,11,0,0.545454545454545
journey,1,7,3,4,0,0.75
sarconstant,0,11,3,8,0,0.375
inexivenesses,0,13,6,7,0,0.857142857142857
cruzan,1,6,2,4,0,0.5
vigotanises,0,11,5,6,0,0.833333333333333
phicos,0,6,2,4,0,0.5
fagara,1,6,3,3,0,1
jshcj,0,5,0,5,0,0
tonemes,1,7,3,4,0,0.75
execrations,1,11,5,6,0,0.833333333333333
tyndaceanolinerboardescript,0,27,10,17,0,0.588235294117647
anaker,0,6,3,3,0,1
rgabu'rlvumhcjfj,0,16,3,13,1,0.230769230769231
faulchions,1,10,4,6,0,0.666666666666667
assocomen,0,9,4,5,0,0.8
unichord,0,8,3,5,0,0.6
changedale,1,10,4,6,0,0.666666666666667
expressmen,1,10,3,7,0,0.428571428571429
unmisgiving,0,11,4,7,0,0.571428571428571
undaters,0,8,3,5,0,0.6
beling,0,6,2,4,0,0.5
brioche,1,7,3,4,0,0.75
neew'tqeldknswaoymwz,0,20,5,15,1,0.333333333333333
mildew,1,6,2,4,0,0.5
nonfarm,1,7,2,5,0,0.4
katakinetomeric,1,15,7,8,0,0.875
sgzbtggvnlmkuwu,0,15,2,13,0,0.153846153846154
hinterland,1,10,3,7,0,0.428571428571429
oryctognostically,1,17,5,12,0,0.416666666666667
hypophoran,0,10,3,7,0,0.428571428571429
montoya,1,7,3,4,0,0.75
yqweabdwvjoqxu,0,14,4,10,0,0.4
omas,0,4,2,2,0,1
endocarditic,1,12,5,7,0,0.714285714285714
web,1,3,1,2,0,0.5
pycnichinal,0,11,3,8,0,0.375
angelon,1,7,3,4,0,0.75
teri,1,4,2,2,0,1
hydrin,0,6,1,5,0,0.2
ovent,0,5,2,3,0,0.666666666666667
inabordable,1,11,5,6,0,0.833333333333333
acrogynae,1,9,4,5,0,0.8
taxidriver,1,10,4,6,0,0.666666666666667
amadyddvpbaumei,0,15,6,9,0,0.666666666666667
cowhand,1,7,2,5,0,0.4
gwcor'nlrx'njs'iqvwdgex,0,23,3,20,3,0.15
referableness,0,13,5,8,0,0.625
max,1,3,1,2,0,0.5
grannieing,1,10,4,6,0,0.666666666666667
flodyntonchoolour,0,17,6,11,0,0.545454545454545
vwrusycvmsqp'dhisrrnkgkp,0,24,2,22,1,0.0909090909090909
dissolvings,1,11,3,8,0,0.375
multivagant,1,11,4,7,0,0.571428571428571
beerothite,1,10,5,5,0,1
vknyh,0,5,0,5,0,0
cashilollibles,0,14,5,9,0,0.555555555555556
librium,1,7,3,4,0,0.75
anathmerarackerp,0,16,6,10,0,0.6
undering,0,8,3,5,0,0.6
hyperaeolism,1,12,5,7,0,0.714285714285714
ordain,1,6,3,3,0,1
prewardais,0,10,4,6,0,0.666666666666667
lisulaedazlinletipanandvis,0,26,11,15,0,0.733333333333333
haemipoeting,0,12,6,6,0,1
muonic,1,6,3,3,0,1
choppering,1,10,3,7,0,0.428571428571429
hebaties,0,8,4,4,0,1
unproportionably,1,16,6,10,0,0.6
znbcqxftlsgltciiuwd,0,19,3,16,0,0.1875
acknowledgeable,1,15,6,9,0,0.666666666666667
complimentalness,1,16,5,11,0,0.454545454545455
hibachi,1,7,3,4,0,0.75
pyrogallols,1,11,3,8,0,0.375
butterblast,0,11,3,8,0,0.375
toponymics,1,10,3,7,0,0.428571428571429
lionist,0,7,3,4,0,0.75
sweetroot,1,9,4,5,0,0.8
dorsi,1,5,2,3,0,0.666666666666667
pronuclearise,0,13,6,7,0,0.857142857142857
dzlxqmtrctv'r,0,13,0,13,1,0
sermoneutron,0,12,5,7,0,0.714285714285714
glassport,1,9,2,7,0,0.285714285714286
prge,0,4,1,3,0,0.333333333333333
aaybjmgxwwopord,0,15,4,11,0,0.363636363636364
postformly,0,10,2,8,0,0.25
trachodont,1,10,3,7,0,0.428571428571429
richen,1,6,2,4,0,0.5
antinepotic,1,11,5,6,0,0.833333333333333
soochow,1,7,3,4,0,0.75
tragacantha,1,11,4,7,0,0.571428571428571
xoqsuymhughqgmzieyrlge,0,22,6,16,0,0.375
superitory,0,10,4,6,0,0.666666666666667
spooneymous,0,11,5,6,0,0.833333333333333
tactosol,1,8,3,5,0,0.6
rohonoutonsmsstesmprecetota,0,27,10,17,0,0.588235294117647
monochrons,0,10,3,7,0,0.428571428571429
damager,1,7,3,4,0,0.75
sovranty,1,8,2,6,0,0.333333333333333
naian,0,5,3,2,0,1.5
menisperm,1,9,3,6,0,0.5
unbalancement,0,13,5,8,0,0.625
morphically,1,11,3,8,0,0.375
bineumamigest,0,13,6,7,0,0.857142857142857
cataract,1,8,3,5,0,0.6
overindividualiser,0,18,9,9,0,1
pestologists,1,12,4,8,0,0.5
sola,1,4,2,2,0,1
driftwood,1,9,3,6,0,0.5
setales,0,7,3,4,0,0.75
percivilly,0,10,3,7,0,0.428571428571429
tiougunilabied,0,14,8,6,0,1.33333333333333
fabience,0,8,4,4,0,1
darness,0,7,2,5,0,0.4
dermen,0,6,2,4,0,0.5
lophocomi,1,9,4,5,0,0.8
ptemelaies,0,10,5,5,0,1
tenn,1,4,1,3,0,0.333333333333333
actionizing,1,11,5,6,0,0.833333333333333
clubwoofer,0,10,4,6,0,0.666666666666667
helene,1,6,3,3,0,1
cyllenian,1,9,3,6,0,0.5
turnback,1,8,2,6,0,0.333333333333333
plicates,1,8,3,5,0,0.6
voulgently,0,10,3,7,0,0.428571428571429
nonenville,0,10,4,6,0,0.666666666666667
retreader,0,9,4,5,0,0.8
exasperate,1,10,5,5,0,1
flesticerlee,0,12,5,7,0,0.714285714285714
padderwentwards,0,15,4,11,0,0.363636363636364
rdgvbp,0,6,0,6,0,0
hemihydrated,1,12,4,8,0,0.5
sharkish,1,8,2,6,0,0.333333333333333
acetimeter,1,10,5,5,0,1
aavtech,1,7,3,4,0,0.75
press,1,5,1,4,0,0.25
gyttich,0,7,1,6,0,0.166666666666667
coudaredunomy,0,13,6,7,0,0.857142857142857
roadsman,1,8,3,5,0,0.6
sfmpgqmqffbrbwta,0,16,1,15,0,0.0666666666666667
g'wpvekybytglyxawnxgpvxyipg,0,27,3,24,1,0.125
kytoon,1,6,2,4,0,0.5
ahqpcmhplmglvqzw,0,16,1,15,0,0.0666666666666667
unsocketed,1,10,4,6,0,0.666666666666667
nondesert,1,9,3,6,0,0.5
bonduc,1,6,2,4,0,0.5
bladrol,0,7,2,5,0,0.4
sluookt',0,8,3,5,1,0.6
antias,0,6,3,3,0,1
mammered,1,8,3,5,0,0.6
iliadromic,0,10,5,5,0,1
scratchingly,1,12,2,10,0,0.2
targeted,1,8,3,5,0,0.6
demothemigativacy,0,17,7,10,0,0.7
solic,0,5,2,3,0,0.666666666666667
phimorulo,0,9,4,5,0,0.8
gdlev,0,5,1,4,0,0.25
cryptivelluli,0,13,4,9,0,0.444444444444444
unbelieffulness,1,15,6,9,0,0.666666666666667
engrails,1,8,3,5,0,0.6
protohymenopterous,1,18,7,11,0,0.636363636363636
unfidelity,1,10,4,6,0,0.666666666666667
bilathus,0,8,3,5,0,0.6
yously,0,6,2,4,0,0.5
corporally,1,10,3,7,0,0.428571428571429
saristrisymalignasepg,0,21,7,14,0,0.5
hopaunog,0,8,4,4,0,1
endoproctous,1,12,5,7,0,0.714285714285714
shuquiescalita,0,14,7,7,0,1
sxivistkvkrah,0,13,3,10,0,0.3
hobson,1,6,2,4,0,0.5
unritually,1,10,4,6,0,0.666666666666667
haxesun,0,7,3,4,0,0.75
cuspidae,0,8,4,4,0,1
foofflu,0,7,3,4,0,0.75
adorned,1,7,3,4,0,0.75
ingots,1,6,2,4,0,0.5
miraculise,1,10,5,5,0,1
radicates,1,9,4,5,0,0.8
reagireionomartolihdonwaga,0,26,13,13,0,1
occupable,1,9,4,5,0,0.8
auscultate,1,10,5,5,0,1
uriniparous,1,11,6,5,0,1.2
sandra,1,6,2,4,0,0.5
bickie,1,6,3,3,0,1
hepatologeryope,0,15,7,8,0,0.875
harmonides,1,10,4,6,0,0.666666666666667
absceporiopass,0,14,6,8,0,0.75
babblers,1,8,2,6,0,0.333333333333333
chiquite,0,8,4,4,0,1
homeristakhands,0,15,5,10,0,0.5
hoimo,0,5,3,2,0,1.5
miasklleraphablinixterucll,0,26,9,17,0,0.529411764705882
teleostome,1,10,5,5,0,1
frsinnette,0,10,3,7,0,0.428571428571429
rhabdomine,0,10,4,6,0,0.666666666666667
phantom,1,7,2,5,0,0.4
forcella,0,8,3,5,0,0.6
vacuous,1,7,4,3,0,1.33333333333333
xbpshvklriv'rxlb'auih,0,21,4,17,2,0.235294117647059
kalakh,1,6,2,4,0,0.5
lockmaster,1,10,3,7,0,0.428571428571429
blous,0,5,2,3,0,0.666666666666667
keen,1,4,2,2,0,1
tetanigenous,1,12,6,6,0,1
clu,1,3,1,2,0,0.5
ephonquatia,0,11,6,5,0,1.2
baganatious,0,11,6,5,0,1.2
zygomaticino,0,12,5,7,0,0.714285714285714
schiarendenlecogaacourphl,0,25,10,15,0,0.666666666666667
nonstandardised,1,15,5,10,0,0.5
samuela,1,7,4,3,0,1.33333333333333
coenenchymatal,0,14,5,9,0,0.555555555555556
oxismerlaphemeresses,0,20,8,12,0,0.666666666666667
aphelnset,0,9,3,6,0,0.5
njzva,0,5,1,4,0,0.25
ignatianist,1,11,5,6,0,0.833333333333333
angelocracy,1,11,4,7,0,0.571428571428571
bournochies,0,11,5,6,0,0.833333333333333
connemara,1,9,4,5,0,0.8
culturist,1,9,3,6,0,0.5
skinny,1,6,1,5,0,0.2
tanglefish,1,10,3,7,0,0.428571428571429
crowstep,1,8,2,6,0,0.333333333333333
cevbxyqshjcidjqq,0,16,2,14,0,0.142857142857143
euy'ejb'wdn,0,11,3,8,2,0.375
boospurtagers,0,13,5,8,0,0.625
baxton,0,6,2,4,0,0.5
sund,0,4,1,3,0,0.333333333333333
clypeastrina,1,12,4,8,0,0.5
docudrama,1,9,4,5,0,0.8
larris,0,6,2,4,0,0.5
alliterate,1,10,5,5,0,1
greed,1,5,2,3,0,0.666666666666667
quadripulmonary,1,15,6,9,0,0.666666666666667
swaybacked,1,10,3,7,0,0.428571428571429
gallantriidae,0,13,6,7,0,0.857142857142857
telacoller,0,10,4,6,0,0.666666666666667
paddleballs,1,11,3,8,0,0.375
precipitated,1,12,5,7,0,0.714285714285714
tralliance,0,10,4,6,0,0.666666666666667
soldans,1,7,2,5,0,0.4
microinch,1,9,3,6,0,0.5
succantiid,0,10,4,6,0,0.666666666666667
fribblery,1,9,2,7,0,0.285714285714286
skatognifer,0,11,4,7,0,0.571428571428571
awesomeness,1,11,5,6,0,0.833333333333333
pbzormndhbascfoijvfveiwlcei,0,27,8,19,0,0.421052631578947
raphic,0,6,2,4,0,0.5
top,1,3,1,2,0,0.5
lonole,0,6,3,3,0,1
domiciles,1,9,4,5,0,0.8
stereoscopically,1,16,6,10,0,0.6
fiopy,0,5,2,3,0,0.666666666666667
hapelisbronginestinescin,0,24,9,15,0,0.6
slicatotacytrropiesaivagethexiremmarwurellecllesth,0,50,19,31,0,0.612903225806452
sensitivities,1,13,6,7,0,0.857142857142857
barning,0,7,2,5,0,0.4
ogcocephalan,0,12,5,7,0,0.714285714285714
repandolobate,1,13,6,7,0,0.857142857142857
stoneworker,1,11,4,7,0,0.571428571428571
cathedra,1,8,3,5,0,0.6
wits,1,4,1,3,0,0.333333333333333
noncircumvallated,1,17,6,11,0,0.545454545454545
pataries,0,8,4,4,0,1
architectonica,1,14,6,8,0,0.75
condolencies,0,12,5,7,0,0.714285714285714
ftoxomaumarobulor,0,17,8,9,0,0.888888888888889
hereof,1,6,3,3,0,1
afright,1,7,2,5,0,0.4
imposaltsburt,0,13,4,9,0,0.444444444444444
tincalendarme,0,13,5,8,0,0.625
culnes,0,6,2,4,0,0.5
giycsljigtxxdcdmdujstnnph'qxsk,0,30,3,27,1,0.111111111111111
cline,1,5,2,3,0,0.666666666666667
regious,0,7,4,3,0,1.33333333333333
docimasies,1,10,5,5,0,1
rebalanoid,0,10,5,5,0,1
nonsynoptical,1,13,4,9,0,0.444444444444444
euploeinae,1,10,7,3,0,2.33333333333333
fluffe,0,6,2,4,0,0.5
annueler,1,8,4,4,0,1
eschaunge,1,9,4,5,0,0.8
vill,1,4,1,3,0,0.333333333333333
xybnhmsntm'l,0,12,0,12,1,0
bepijolfundentins,0,17,6,11,0,0.545454545454545
feeses,1,6,3,3,0,1
tecpanec,1,8,3,5,0,0.6
latedockbial,0,12,5,7,0,0.714285714285714
chinah,0,6,2,4,0,0.5
cowbirds,1,8,2,6,0,0.333333333333333
concipient,1,10,4,6,0,0.666666666666667
nonobserve,0,10,4,6,0,0.666666666666667
overspend,1,9,3,6,0,0.5
pyromoreticopick,0,16,6,10,0,0.6
chodulupemilainchede,0,20,9,11,0,0.818181818181818
kinnor,1,6,2,4,0,0.5
noach,1,5,2,3,0,0.666666666666667
menardakerectarathum,0,20,8,12,0,0.666666666666667
zytsvaziuzc',0,12,3,9,1,0.333333333333333
undercoat,1,9,4,5,0,0.8
photomapping,1,12,4,8,0,0.5
limier,1,6,3,3,0,1
beglerbey,1,9,3,6,0,0.5
swat,1,4,1,3,0,0.333333333333333
aepyov,0,6,3,3,0,1
cater,0,5,2,3,0,0.666666666666667
explaining,1,10,4,6,0,0.666666666666667
mimmocky,1,8,2,6,0,0.333333333333333
oxyproducibly,0,13,4,9,0,0.444444444444444
normoblast,1,10,3,7,0,0.428571428571429
capitalise,0,10,5,5,0,1
retardates,1,10,4,6,0,0.666666666666667
manat,1,5,2,3,0,0.666666666666667
pkoddlsvtyjcu,0,13,2,11,0,0.181818181818182
bowmanstown,1,11,3,8,0,0.375
delevitis,0,9,4,5,0,0.8
predeliberation,1,15,7,8,0,0.875
utopian,1,7,4,3,0,1.33333333333333
trainmaster,1,11,4,7,0,0.571428571428571
christinesmative,0,16,6,10,0,0.6
pianmbats,0,9,3,6,0,0.5
sukers,0,6,2,4,0,0.5
transfusionisms,0,15,5,10,0,0.5
qpgpftck'qprm,0,13,0,13,1,0
mundify,1,7,2,5,0,0.4
efenely,0,7,3,4,0,0.75
calley,1,6,2,4,0,0.5
qegbsrkl,0,8,1,7,0,0.142857142857143
cybernetic,1,10,3,7,0,0.428571428571429
castigator,1,10,4,6,0,0.666666666666667
ktk,0,3,0,3,0,0
yancewoodgmentragaries,0,22,9,13,0,0.692307692307692
discommode,1,10,4,6,0,0.666666666666667
chaementartrusses,0,17,6,11,0,0.545454545454545
neurod,0,6,3,3,0,1
wannie,0,6,3,3,0,1
tressee,0,7,3,4,0,0.75
roundhands,1,10,3,7,0,0.428571428571429
odontia,0,7,4,3,0,1.33333333333333
deches,0,6,2,4,0,0.5
sarcological,1,12,5,7,0,0.714285714285714
smiang,0,6,2,4,0,0.5
allianced,1,9,4,5,0,0.8
shiftshop,0,9,2,7,0,0.285714285714286
animals,1,7,3,4,0,0.75
cornopionage,0,12,6,6,0,1
cvdbaf,0,6,1,5,0,0.2
stephentolamin,0,14,5,9,0,0.555555555555556
frendemiobited,0,14,6,8,0,0.75
nonobjective,1,12,5,7,0,0.714285714285714
slaughteries,1,12,5,7,0,0.714285714285714
unbellachiversaxopipfies,0,24,10,14,0,0.714285714285714
shoggled,1,8,2,6,0,0.333333333333333
translucences,1,13,4,9,0,0.444444444444444
revelations,1,11,5,6,0,0.833333333333333
gimmie,1,6,3,3,0,1
steatocystic,0,12,4,8,0,0.5
knpgnlgvbw,0,10,0,10,0,0
kxdiob'tft,0,10,2,8,1,0.25
capito,1,6,3,3,0,1
titanic,1,7,3,4,0,0.75
cletan,0,6,2,4,0,0.5
labarum,1,7,3,4,0,0.75
wdxnpjbyfgodkmkldwimmepjm,0,25,3,22,0,0.136363636363636
amphioxidae,1,11,6,5,0,1.2
coompfrbxe,0,10,3,7,0,0.428571428571429
sporter,1,7,2,5,0,0.4
tenges,1,6,2,4,0,0.5
quakership,1,10,4,6,0,0.666666666666667
butauma,0,7,4,3,0,1.33333333333333
granulations,1,12,5,7,0,0.714285714285714
ments,0,5,1,4,0,0.25
svea,1,4,2,2,0,1
mancunian,1,9,4,5,0,0.8
aing,0,4,2,2,0,1
assarid,0,7,3,4,0,0.75
schluter,1,8,2,6,0,0.333333333333333
vessess,0,7,2,5,0,0.4
chropteres,0,10,3,7,0,0.428571428571429
blennia,0,7,3,4,0,0.75
gibbettsville,0,13,4,9,0,0.444444444444444
distained,1,9,4,5,0,0.8
hiyas,1,5,2,3,0,0.666666666666667
microticists,0,12,4,8,0,0.5
uttery,0,6,2,4,0,0.5
hmonge,0,6,2,4,0,0.5
naianisymachatroryfjaper,0,24,9,15,0,0.6
argasid,1,7,3,4,0,0.75
eternancy,0,9,3,6,0,0.5
pensionat,1,9,4,5,0,0.8
edriophthalmology,0,17,6,11,0,0.545454545454545
blynnette,0,9,2,7,0,0.285714285714286
woodcarvers,1,11,4,7,0,0.571428571428571
indigenousness,1,14,6,8,0,0.75
qyiqnbojzwnb,0,12,2,10,0,0.2
somnolism,1,9,3,6,0,0.5
parliamentarism,1,15,6,9,0,0.666666666666667
nereus,1,6,3,3,0,1
strigiles,1,9,3,6,0,0.5
wondreat,0,8,3,5,0,0.6
pentachlorophyllic,0,18,5,13,0,0.384615384615385
noctiluca,1,9,4,5,0,0.8
nailer,1,6,3,3,0,1
yteaijivhiw,0,11,5,6,0,0.833333333333333
owheuchleresatided,0,18,8,10,0,0.8
spondylid,1,9,2,7,0,0.285714285714286
vucer,0,5,2,3,0,0.666666666666667
sprup,0,5,1,4,0,0.25
calamelmiturvantivers,0,21,8,13,0,0.615384615384615
eleen,1,5,3,2,0,1.5
oxbxtfkgzgwtzy,0,14,1,13,0,0.0769230769230769
affixion,1,8,4,4,0,1
nidiavormaskis,0,14,6,8,0,0.75
celtoman,0,8,3,5,0,0.6
schobe,0,6,2,4,0,0.5
ctzqnm'iwgpxanvqhqtivfyowartpj,0,30,5,25,1,0.2
consulships,1,11,3,8,0,0.375
tyronierisman,0,13,5,8,0,0.625
eyepatch,1,8,3,5,0,0.6
culminations,1,12,5,7,0,0.714285714285714
mosch,0,5,1,4,0,0.25
lightplane,1,10,3,7,0,0.428571428571429
fablenesses,0,11,4,7,0,0.571428571428571
kmbzgttpkpln,0,12,0,12,0,0
chdhrdbgxlvjmpiioklfxups',0,25,4,21,1,0.19047619047619
ophthalmotome,0,13,5,8,0,0.625
canstick,1,8,2,6,0,0.333333333333333
neisanction,0,11,5,6,0,0.833333333333333
nonfeudation,0,12,6,6,0,1
foredesignment,1,14,5,9,0,0.555555555555556
yqokmqqjim,0,10,2,8,0,0.25
rubineous,1,9,5,4,0,1.25
ungambolled,1,11,4,7,0,0.571428571428571
neuring,0,7,3,4,0,0.75
salamandrina,1,12,5,7,0,0.714285714285714
nontion,0,7,3,4,0,0.75
fdjufefuprgngih,0,15,4,11,0,0.363636363636364
madelia,1,7,4,3,0,1.33333333333333
bockpolicarculaen,0,17,7,10,0,0.7
sycephium,0,9,3,6,0,0.5
fretwise,1,8,3,5,0,0.6
featherway,1,10,4,6,0,0.666666666666667
highness,1,8,2,6,0,0.333333333333333
animadversiveness,1,17,7,10,0,0.7
uncto,0,5,2,3,0,0.666666666666667
initiator,1,9,5,4,0,1.25
superassumingness,0,17,6,11,0,0.545454545454545
arctosiphunchecksiess,0,21,7,14,0,0.5
varidgessporedness,0,18,6,12,0,0.5
equingly,0,8,3,5,0,0.6
glyll,0,5,0,5,0,0
carnitine,1,9,4,5,0,0.8
noma,1,4,2,2,0,1
aniss,0,5,2,3,0,0.666666666666667
sleets,1,6,2,4,0,0.5
wooleated,0,9,5,4,0,1.25
grammaticism,1,12,4,8,0,0.5
termly,1,6,1,5,0,0.2
acitiladet,0,10,5,5,0,1
shanney,1,7,2,5,0,0.4
unstage,0,7,3,4,0,0.75
kertacowhorne,0,13,5,8,0,0.625
flkkacfgmllew,0,13,2,11,0,0.181818181818182
weasel,1,6,3,3,0,1
saurischians,1,12,5,7,0,0.714285714285714
waddie,1,6,3,3,0,1
acifs,0,5,2,3,0,0.666666666666667
saturant,1,8,3,5,0,0.6
whephyereestitiondefon,0,22,9,13,0,0.692307692307692
tnseasureren,0,12,5,7,0,0.714285714285714
backstitching,1,13,3,10,0,0.3
peripeteian,1,11,6,5,0,1.2
npccmrvxrnexvomatvzwzehxhaye,0,28,6,22,0,0.272727272727273
terrell,1,7,2,5,0,0.4
choccies,1,8,3,5,0,0.6
stocklocks,1,10,2,8,0,0.25
sedatingly,0,10,3,7,0,0.428571428571429
trajects,1,8,2,6,0,0.333333333333333
distrackilgispes,0,16,5,11,0,0.454545454545455
sympositiformnad,0,16,5,11,0,0.454545454545455
spilogale,1,9,4,5,0,0.8
reedstop,1,8,3,5,0,0.6
timondablendo,0,13,5,8,0,0.625
bentiness,1,9,3,6,0,0.5
retingly,0,8,2,6,0,0.333333333333333
dism,0,4,1,3,0,0.333333333333333
urochord,1,8,3,5,0,0.6
gooseflesh,1,10,4,6,0,0.666666666666667
toyer,1,5,2,3,0,0.666666666666667
'b'mosmlqrxfzywj',0,17,1,16,3,0.0625
porina,1,6,3,3,0,1
tricyanica,0,10,4,6,0,0.666666666666667
polliflore,0,10,4,6,0,0.666666666666667
compuserve,1,10,4,6,0,0.666666666666667
entoaxilla,0,10,5,5,0,1
acso'igcxlqwezrggict,0,20,5,15,1,0.333333333333333
eeoekcuqg,0,9,5,4,0,1.25
cockroach,1,9,3,6,0,0.5
saratogas,1,9,4,5,0,0.8
axfeeloadesoles,0,15,8,7,0,1.14285714285714
corsleted,1,9,3,6,0,0.5
hyarded,0,7,2,5,0,0.4
justiceship,1,11,4,7,0,0.571428571428571
indwinoddhisaut,0,15,6,9,0,0.666666666666667
kaliyuga,1,8,4,4,0,1
unpurse,1,7,3,4,0,0.75
minessesquawleyyounternappetunupramps,0,37,14,23,0,0.608695652173913
fyqpjsewlvchazbg,0,16,2,14,0,0.142857142857143
beziers,1,7,3,4,0,0.75
emanating,1,9,4,5,0,0.8
sudras,1,6,2,4,0,0.5
ireland,1,7,3,4,0,0.75
nonassonant,1,11,4,7,0,0.571428571428571
winchancushkar,0,14,4,10,0,0.4
bristoloching,0,13,4,9,0,0.444444444444444
uncoacted,1,9,4,5,0,0.8
dimitrov,1,8,3,5,0,0.6
impressment,1,11,3,8,0,0.375
rodleighballsburg,0,17,5,12,0,0.416666666666667
szsv,0,4,0,4,0,0
ethoxyethane,1,12,5,7,0,0.714285714285714
oresticler,0,10,4,6,0,0.666666666666667
maccarated,0,10,4,6,0,0.666666666666667
unnichering,0,11,4,7,0,0.571428571428571
adourithated,0,12,6,6,0,1
pretritables,0,12,4,8,0,0.5
septemvir,1,9,3,6,0,0.5
unchambered,1,11,4,7,0,0.571428571428571
pertainable,0,11,5,6,0,0.833333333333333
unklismoning,0,12,4,8,0,0.5
thersander,1,10,3,7,0,0.428571428571429
endolabyrinthitis,1,17,6,11,0,0.545454545454545
overcommercializes,1,18,8,10,0,0.8
gcjamtuivy'tlj,0,14,3,11,1,0.272727272727273
steinites,0,9,4,5,0,0.8
cushinesses,1,11,4,7,0,0.571428571428571
shopkeep,1,8,3,5,0,0.6
olirxtnslwmrscocp,0,17,3,14,0,0.214285714285714
tikes,1,5,2,3,0,0.666666666666667
unobservatorium,0,15,7,8,0,0.875
maceheads,0,9,4,5,0,0.8
ultralisation,0,13,6,7,0,0.857142857142857
hubertusburg,1,12,4,8,0,0.5
extraornaturate,0,15,7,8,0,0.875
secunderfests,0,13,4,9,0,0.444444444444444
whaserfeo,0,9,4,5,0,0.8
stegosauria,1,11,6,5,0,1.2
theverexplostic,0,15,5,10,0,0.5
iphition,1,8,4,4,0,1
gehm,0,4,1,3,0,0.333333333333333
fangert,0,7,2,5,0,0.4
superformal,1,11,4,7,0,0.571428571428571
batinsive,0,9,4,5,0,0.8
divisionism,1,11,5,6,0,0.833333333333333
scarrow,1,7,2,5,0,0.4
petiolular,1,10,5,5,0,1
percrafficeous,0,14,6,8,0,0.75
amildar,1,7,3,4,0,0.75
nonpopulati,0,11,5,6,0,0.833333333333333
metaxite,1,8,4,4,0,1
cound,0,5,2,3,0,0.666666666666667
coccolithophoridae,1,18,8,10,0,0.8
sunbathers,1,10,3,7,0,0.428571428571429
relerd,0,6,2,4,0,0.5
backcock,0,8,2,6,0,0.333333333333333
phthalyl,1,8,1,7,0,0.142857142857143
caingangs,1,9,3,6,0,0.5
cortinider,0,10,4,6,0,0.666666666666667
rqctxjlhdqwzbibd'uy,0,19,2,17,1,0.117647058823529
willis,1,6,2,4,0,0.5
californ,0,8,3,5,0,0.6
unbitio,0,7,4,3,0,1.33333333333333
cpjhxqczqtxocxk,0,15,1,14,0,0.0714285714285714
shifgaagpnavki,0,14,5,9,0,0.555555555555556
fubb,0,4,1,3,0,0.333333333333333
jmaqsg'jctscl,0,13,1,12,1,0.0833333333333333
cohe,1,4,2,2,0,1
dihydractuarise,0,15,6,9,0,0.666666666666667
anechoic,1,8,4,4,0,1
hotpontol,0,9,3,6,0,0.5
adelphoi,1,8,4,4,0,1
bipaliidae,1,10,6,4,0,1.5
wvcxcrfspsej,0,12,1,11,0,0.0909090909090909
indistinctible,1,14,5,9,0,0.555555555555556
spinning,1,8,2,6,0,0.333333333333333
goniatitid,1,10,5,5,0,1
wiq'piekfgfwylpegfjp,0,20,4,16,1,0.25
tradedness,0,10,3,7,0,0.428571428571429
ycfhj'qi'mqouklaojpqzsu,0,23,6,17,2,0.352941176470588
abundevoke,0,10,5,5,0,1
laciniose,1,9,5,4,0,1.25
fourche,1,7,3,4,0,0.75
abobjectives,0,12,5,7,0,0.714285714285714
pw'cmmbxjmcdkjqyhpxvp,0,21,0,21,1,0
baragon,0,7,3,4,0,0.75
lethologica,1,11,5,6,0,0.833333333333333
isochromide,0,11,5,6,0,0.833333333333333
lususes,1,7,3,4,0,0.75
unmasmallopotoglencimors,0,24,9,15,0,0.6
taxiing,1,7,3,4,0,0.75
mosylvallaceae,0,14,6,8,0,0.75
pelagia,1,7,4,3,0,1.33333333333333
hairdo,1,6,3,3,0,1
jfzmjzk,0,7,0,7,0,0
trasteverine,1,12,5,7,0,0.714285714285714
halpern,1,7,2,5,0,0.4
wat,1,3,1,2,0,0.5
flanigan,1,8,3,5,0,0.6
ntenyciecki,0,11,4,7,0,0.571428571428571
wailuku,1,7,4,3,0,1.33333333333333
pedagoguishnesses,1,17,7,10,0,0.7
rectified,1,9,4,5,0,0.8
malcoman,0,8,3,5,0,0.6
junaezdov'c'yqlomsduhqpc,0,24,6,18,2,0.333333333333333
dopa,1,4,2,2,0,1
sharns,1,6,1,5,0,0.2
weedful,1,7,3,4,0,0.75
adamster,0,8,3,5,0,0.6
spelaeothems,1,12,5,7,0,0.714285714285714
thiotenmanid,0,12,5,7,0,0.714285714285714
wiskelochurroopincheenanchoovy,0,30,12,18,0,0.666666666666667
intercomprehensibility,1,22,8,14,0,0.571428571428571
pellach,1,7,2,5,0,0.4
unchosneli,0,10,4,6,0,0.666666666666667
cerotion,0,8,4,4,0,1
scrimshanders,1,13,3,10,0,0.3
outbleated,1,10,5,5,0,1
reus,1,4,2,2,0,1
aetograminnebrut,0,16,7,9,0,0.777777777777778
obly,0,4,1,3,0,0.333333333333333
concordant,1,10,3,7,0,0.428571428571429
ivinontoses,0,11,5,6,0,0.833333333333333
fireworm,1,8,3,5,0,0.6
unrelish,0,8,3,5,0,0.6
slidingly,1,9,2,7,0,0.285714285714286
infundish,0,9,3,6,0,0.5
daclassa,1,8,3,5,0,0.6
fucose,1,6,3,3,0,1
palmerin,1,8,3,5,0,0.6
mythogreen,1,10,3,7,0,0.428571428571429
musculospiral,1,13,5,8,0,0.625
notus,1,5,2,3,0,0.666666666666667
fleur,1,5,2,3,0,0.666666666666667
reaccommodated,1,14,6,8,0,0.75
punct,1,5,1,4,0,0.25
gosh,1,4,1,3,0,0.333333333333333
urodelinquellencer,0,18,8,10,0,0.8
also,1,4,2,2,0,1
nfgvdadqfdgncv,0,14,1,13,0,0.0769230769230769
diminution,1,10,5,5,0,1
contaminator,1,12,5,7,0,0.714285714285714
semiliberating,0,14,6,8,0,0.75
litonarog,0,9,4,5,0,0.8
preassurance,1,12,5,7,0,0.714285714285714
cuts,1,4,1,3,0,0.333333333333333
keavy,1,5,2,3,0,0.666666666666667
herzegovinian,1,13,6,7,0,0.857142857142857
actively,1,8,3,5,0,0.6
apaoruchacanps,0,14,6,8,0,0.75
ctsoebzbnunjsawze,0,17,5,12,0,0.416666666666667
unsorrowing,1,11,4,7,0,0.571428571428571
salums,0,6,2,4,0,0.5
bekissing,1,9,3,6,0,0.5
iridoptosis,1,11,5,6,0,0.833333333333333
hemiamblyocarpous,0,17,7,10,0,0.7
microfilarial,1,13,6,7,0,0.857142857142857
surthunbraccer,0,14,4,10,0,0.4
transcient,0,10,3,7,0,0.428571428571429
proxygent,0,9,2,7,0,0.285714285714286
unencumbered,1,12,5,7,0,0.714285714285714
yilb,0,4,1,3,0,0.333333333333333
abraids,1,7,3,4,0,0.75
scevubawqkklcbcasrltay,0,22,5,17,0,0.294117647058824
applier,1,7,3,4,0,0.75
tarkio,1,6,3,3,0,1
cymbalaria,1,10,4,6,0,0.666666666666667
bulldogism,1,10,3,7,0,0.428571428571429
ptilimnium,1,10,4,6,0,0.666666666666667
tidivating,1,10,4,6,0,0.666666666666667
delapidate,1,10,5,5,0,1
ayroctatophromesignetic,0,23,9,14,0,0.642857142857143
sinis,1,5,2,3,0,0.666666666666667
aldide,1,6,3,3,0,1
wvunnrvxqdgdqmsbjjledctrkx'tb,0,29,2,27,1,0.0740740740740741
cloquentecheve,0,14,6,8,0,0.75
hyperrealisable,0,15,6,9,0,0.666666666666667
adx'yuzqwcdo,0,12,3,9,1,0.333333333333333
scibdhqrpjjfadqix',0,18,3,15,1,0.2
stercourse,0,10,4,6,0,0.666666666666667
daten,0,5,2,3,0,0.666666666666667
dlxyfm,0,6,0,6,0,0
exrghcl'nuyfdecmn,0,17,3,14,1,0.214285714285714
drooker,0,7,3,4,0,0.75
wonalls,0,7,2,5,0,0.4
quadrinomically,0,15,6,9,0,0.666666666666667
twotiess,0,8,3,5,0,0.6
holotron,0,8,3,5,0,0.6
reconvolterothionancane,0,23,10,13,0,0.769230769230769
ghetti,1,6,2,4,0,0.5
speums,0,6,2,4,0,0.5
princonvent,0,11,3,8,0,0.375
resuping,0,8,3,5,0,0.6
supentriabiale,0,14,7,7,0,1
selenidera,1,10,5,5,0,1
apologetic,1,10,5,5,0,1
squill,1,6,2,4,0,0.5
wncjeophvomzcxglzsgrfh,0,22,3,19,0,0.157894736842105
prad,1,4,1,3,0,0.333333333333333
chemiluminescences,1,18,7,11,0,0.636363636363636
semedediannars,0,14,6,8,0,0.75
linkeditor,1,10,4,6,0,0.666666666666667
'mporbcocrf'qryxrofqclsk,0,24,3,21,2,0.142857142857143
dicente,0,7,3,4,0,0.75
airtime,1,7,4,3,0,1.33333333333333
projectile,1,10,4,6,0,0.666666666666667
ethmolith,1,9,3,6,0,0.5
ophilianida,0,11,6,5,0,1.2
nonthers,0,8,2,6,0,0.333333333333333
extensionally,1,13,5,8,0,0.625
midlife,1,7,3,4,0,0.75
skulpaneoana,0,12,6,6,0,1
dithelette,0,10,4,6,0,0.666666666666667
gjelled,0,7,2,5,0,0.4
coer,1,4,2,2,0,1
mosque,1,6,3,3,0,1
japonaiserieses,0,15,8,7,0,1.14285714285714
backtracanthic,0,14,4,10,0,0.4
hiptraxecrum,0,12,4,8,0,0.5
prociphilus,1,11,4,7,0,0.571428571428571
nagittlelindlebombs,0,19,6,13,0,0.461538461538462
alle,1,4,2,2,0,1
chesting,1,8,2,6,0,0.333333333333333
thremmatological,0,16,6,10,0,0.6
carpocratian,1,12,5,7,0,0.714285714285714
negotiatress,1,12,5,7,0,0.714285714285714
lithogenous,1,11,5,6,0,0.833333333333333
oreodon,1,7,4,3,0,1.33333333333333
hsxs'iznetihpcgrompfta,0,22,5,17,1,0.294117647058824
provencalizes,0,13,5,8,0,0.625
boumdienne,1,10,5,5,0,1
gablencorrettisteroceliolatteringeridgehate,0,43,18,25,0,0.72
niarada,1,7,4,3,0,1.33333333333333
unicite,0,7,4,3,0,1.33333333333333
czepreing,0,9,3,6,0,0.5
deliquium,1,9,5,4,0,1.25
euphemispheric,0,14,6,8,0,0.75
spuffle,1,7,2,5,0,0.4
hsbc,1,4,0,4,0,0
kittrell,1,8,2,6,0,0.333333333333333
brittly,1,7,1,6,0,0.166666666666667
inged,0,5,2,3,0,0.666666666666667
lao,1,3,2,1,0,2
vaga,0,4,2,2,0,1
turken,1,6,2,4,0,0.5
godius,0,6,3,3,0,1
armentis,0,8,3,5,0,0.6
forepresentative,0,16,7,9,0,0.777777777777778
ultrasonography,1,15,5,10,0,0.5
spieled,1,7,3,4,0,0.75
mazirds,0,7,2,5,0,0.4
berklike,0,8,3,5,0,0.6
foprineshuiedariomigetlyo,0,25,12,13,0,0.923076923076923
plkeriomarsutemeis,0,18,8,10,0,0.8
smationg,0,8,3,5,0,0.6
mmxlnch,0,7,0,7,0,0
croconate,1,9,4,5,0,0.8
myographies,1,11,4,7,0,0.571428571428571
inulas,1,6,3,3,0,1
listserv,1,8,2,6,0,0.333333333333333
subornion,0,9,4,5,0,0.8
synonymous,1,10,3,7,0,0.428571428571429
coboss,1,6,2,4,0,0.5
basiscopic,1,10,4,6,0,0.666666666666667
semimanagerial,1,14,7,7,0,1
opical,0,6,3,3,0,1
sheer,1,5,2,3,0,0.666666666666667
sclerotics,1,10,3,7,0,0.428571428571429
callychusne,0,11,3,8,0,0.375
transparentness,1,15,4,11,0,0.363636363636364
tutania,1,7,4,3,0,1.33333333333333
waling,1,6,2,4,0,0.5
spherometer,1,11,4,7,0,0.571428571428571
costlew,1,7,2,5,0,0.4
vqq'rkgsugdxqfkljyv'xniza,0,25,3,22,2,0.136363636363636
underspend,1,10,3,7,0,0.428571428571429
litous,0,6,3,3,0,1
heteromon,0,9,4,5,0,0.8
astee,0,5,3,2,0,1.5
surucucus,1,9,4,5,0,0.8
demarciasville,0,14,6,8,0,0.75
lustrations,1,11,4,7,0,0.571428571428571
uninherited,1,11,5,6,0,0.833333333333333
taylesses,0,9,3,6,0,0.5
moloffdma,0,9,3,6,0,0.5
deflow,1,6,2,4,0,0.5
transvestisms,1,13,3,10,0,0.3
unctic,0,6,2,4,0,0.5
balted,0,6,2,4,0,0.5
antatis,0,7,3,4,0,0.75
apatan,1,6,3,3,0,1
waxfist,0,7,2,5,0,0.4
balator,0,7,3,4,0,0.75
ysawfuopxtwonlqu,0,16,5,11,0,0.454545454545455
edin,1,4,2,2,0,1
lazaret,1,7,3,4,0,0.75
nonaccentual,1,12,5,7,0,0.714285714285714
kyasfnxsexhf,0,12,2,10,0,0.2
firious,0,7,4,3,0,1.33333333333333
physiatric,1,10,3,7,0,0.428571428571429
'fxz,0,4,0,4,1,0
croaker,1,7,3,4,0,0.75
prahu,1,5,2,3,0,0.666666666666667
sticksman,0,9,2,7,0,0.285714285714286
flche,1,5,1,4,0,0.25
nonornamental,0,13,5,8,0,0.625
reenia,0,6,4,2,0,2
dionysian,1,9,4,5,0,0.8
knawel,1,6,2,4,0,0.5
scot,1,4,1,3,0,0.333333333333333
unchar,0,6,2,4,0,0.5
creedon,1,7,3,4,0,0.75
heter,0,5,2,3,0,0.666666666666667
fores,0,5,2,3,0,0.666666666666667
shan,1,4,1,3,0,0.333333333333333
kirium,0,6,3,3,0,1
ofosww,0,6,2,4,0,0.5
muldes,0,6,2,4,0,0.5
ungroupable,1,11,5,6,0,0.833333333333333
almswomen,1,9,3,6,0,0.5
cotlands,1,8,2,6,0,0.333333333333333
affix,1,5,2,3,0,0.666666666666667
longthene,0,9,3,6,0,0.5
crepituses,1,10,4,6,0,0.666666666666667
obstupefy,1,9,3,6,0,0.5
rosaceae,1,8,5,3,0,1.66666666666667
divisionists,1,12,5,7,0,0.714285714285714
colobansated,0,12,5,7,0,0.714285714285714
jhcgjzghidghmrcpmkgx,0,20,1,19,0,0.0526315789473684
macushclodontensteperidae,0,25,10,15,0,0.666666666666667
clopticidsworter,0,16,5,11,0,0.454545454545455
diagrammaticalizes,0,18,8,10,0,0.8
nongratulation,0,14,6,8,0,0.75
chalicotheres,1,13,5,8,0,0.625
lswosmerds,0,10,2,8,0,0.25
wimbivorcinualness,0,18,7,11,0,0.636363636363636
parognitosponderoppers,0,22,8,14,0,0.571428571428571
neralships,0,10,3,7,0,0.428571428571429
harcempeymedrdiccte,0,19,6,13,0,0.461538461538462
atelognathia,1,12,6,6,0,1
mugnon,0,6,2,4,0,0.5
lycographilomy,0,14,4,10,0,0.4
shininess,1,9,3,6,0,0.5
unemasculatory,1,14,6,8,0,0.75
mam,1,3,1,2,0,0.5
disi,0,4,2,2,0,1
vilificatured,0,13,6,7,0,0.857142857142857
davallaria,0,10,5,5,0,1
nkenkmrhk'qwsmircotcyabpc,0,25,4,21,1,0.19047619047619
fraus,1,5,2,3,0,0.666666666666667
hesperithen,0,11,4,7,0,0.571428571428571
nectars,1,7,2,5,0,0.4
sar,0,3,1,2,0,0.5
sleech,1,6,2,4,0,0.5
goldsmith,1,9,2,7,0,0.285714285714286
rodomontevere,0,13,6,7,0,0.857142857142857
molestationary,0,14,6,8,0,0.75
ctey,0,4,1,3,0,0.333333333333333
subsecretive,0,12,5,7,0,0.714285714285714
justicon,0,8,3,5,0,0.6
dafterativita,0,13,6,7,0,0.857142857142857
vicentric,0,9,3,6,0,0.5
fbavvownbuqhe,0,13,4,9,0,0.444444444444444
thermione,0,9,4,5,0,0.8
hsnihzjzkyadctyayxhsvacj,0,24,4,20,0,0.2
epopees,1,7,4,3,0,1.33333333333333
sulidae,1,7,4,3,0,1.33333333333333
gnomonia,1,8,4,4,0,1
autoirrigations,0,15,8,7,0,1.14285714285714
hetherward,1,10,3,7,0,0.428571428571429
prarenovifomelats,0,17,7,10,0,0.7
lorita,1,6,3,3,0,1
plagioliparite,1,14,7,7,0,1
dnuxjhzqhospa,0,13,3,10,0,0.3
angst,1,5,1,4,0,0.25
malacocotyleal,0,14,6,8,0,0.75
arawak,1,6,3,3,0,1
structs,0,7,1,6,0,0.166666666666667
trigla,1,6,2,4,0,0.5
gleis,1,5,2,3,0,0.666666666666667
thealcum,0,8,3,5,0,0.6
basmati,1,7,3,4,0,0.75
tangible,1,8,3,5,0,0.6
vzqirkarqzk,0,11,2,9,0,0.222222222222222
ormeranshing,0,12,4,8,0,0.5
bestemistalkeraing,0,18,7,11,0,0.636363636363636
caudaite,1,8,5,3,0,1.66666666666667
olufilhugoqzyjwemoxvwctt,0,24,7,17,0,0.411764705882353
bromocyanid,1,11,4,7,0,0.571428571428571
chlamydiaceae,1,13,6,7,0,0.857142857142857
crcan,0,5,1,4,0,0.25
dorsothoracic,1,13,5,8,0,0.625
fzjzkh'rglbzuzneqjrfntcqkcrf,0,28,2,26,1,0.0769230769230769
rupestrine,1,10,4,6,0,0.666666666666667
cooniest,1,8,4,4,0,1
hairebirdsbor,0,13,5,8,0,0.625
drowstophist,0,12,3,9,0,0.333333333333333
unquerulously,1,13,6,7,0,0.857142857142857
pwvnep'xt,0,9,1,8,1,0.125
veyoilgrkevcprmurwp,0,19,5,14,0,0.357142857142857
pauline,1,7,4,3,0,1.33333333333333
camote,1,6,3,3,0,1
photodensitometer,1,17,7,10,0,0.7
lemniscate,1,10,4,6,0,0.666666666666667
chokies,1,7,3,4,0,0.75
unemendable,1,11,5,6,0,0.833333333333333
ultalse,0,7,3,4,0,0.75
nonartific,0,10,4,6,0,0.666666666666667
wination,0,8,4,4,0,1
berlitz,1,7,2,5,0,0.4
iia,1,3,3,0,0,1
sequency,1,8,3,5,0,0.6
counterirritants,1,16,6,10,0,0.6
combonomopliac,0,14,6,8,0,0.75
babish,0,6,2,4,0,0.5
telegrammatic,1,13,5,8,0,0.625
glyted,0,6,1,5,0,0.2
nonswillo,0,9,3,6,0,0.5
leucinores,0,10,5,5,0,1
uncountenanced,1,14,6,8,0,0.75
morrisonville,1,13,5,8,0,0.625
monocystotomy,0,13,4,9,0,0.444444444444444
kqshpdsg,0,8,0,8,0,0
kerful,0,6,2,4,0,0.5
chloramphenicol,1,15,5,10,0,0.5
champarts,1,9,2,7,0,0.285714285714286
vociferative,1,12,6,6,0,1
ebtl'rhrlpmojp,0,14,2,12,1,0.166666666666667
tdcc,1,4,0,4,0,0
phantasus,1,9,3,6,0,0.5
wrightsboro,1,11,3,8,0,0.375
rigidified,1,10,5,5,0,1
nonpararision,0,13,6,7,0,0.857142857142857
irdxylqeapkdkumfy'jdz,0,21,4,17,1,0.235294117647059
simorydhacr,0,11,3,8,0,0.375
dishallucination,1,16,7,9,0,0.777777777777778
ikhmttvocveb,0,12,3,9,0,0.333333333333333
elytron,1,7,2,5,0,0.4
romanchhydnockwards,0,19,4,15,0,0.266666666666667
lucubrated,1,10,4,6,0,0.666666666666667
yammerkleysburg,0,15,4,11,0,0.363636363636364
straint,1,7,2,5,0,0.4
dengue,1,6,3,3,0,1
sampras,1,7,2,5,0,0.4
bfg,0,3,0,3,0,0
sigfocur,0,8,3,5,0,0.6
sculling,1,8,2,6,0,0.333333333333333
spines,1,6,2,4,0,0.5
pointing,1,8,3,5,0,0.6
ekvpreulrv'jnquetrypupraq,0,25,7,18,1,0.388888888888889
novartis,1,8,3,5,0,0.6
xerophthalmus,0,13,4,9,0,0.444444444444444
sabellarmen,0,11,4,7,0,0.571428571428571
afeeaokp,0,8,5,3,0,1.66666666666667
netiomendin,0,11,5,6,0,0.833333333333333
brassfounded,0,12,4,8,0,0.5
symploceus,0,10,3,7,0,0.428571428571429
cathaminarisochairing,0,21,9,12,0,0.75
uniocular,1,9,5,4,0,1.25
didogals,0,8,3,5,0,0.6
wisconsinites,1,13,5,8,0,0.625
strobiliferous,1,14,6,8,0,0.75
abutilon,1,8,4,4,0,1
howder,1,6,2,4,0,0.5
deadpanners,1,11,4,7,0,0.571428571428571
nonsuggestive,1,13,5,8,0,0.625
watersmeet,1,10,4,6,0,0.666666666666667
metrostyle,1,10,3,7,0,0.428571428571429
metries,0,7,3,4,0,0.75
hopedale,1,8,4,4,0,1
woodward,1,8,3,5,0,0.6
quzoxynchatabs,0,14,4,10,0,0.4
mknomdsyphzgovrbrobd,0,20,3,17,0,0.176470588235294
inveterateness,1,14,6,8,0,0.75
allinvelbacenel,0,15,6,9,0,0.666666666666667
ethnocentrics,0,13,4,9,0,0.444444444444444
restipulated,1,12,5,7,0,0.714285714285714
pjrvxmduepbdqrwbflnxzgcczh,0,26,2,24,0,0.0833333333333333
deepon,0,6,3,3,0,1
pediculus,1,9,4,5,0,0.8
couperator,1,10,5,5,0,1
fala,1,4,2,2,0,1
smac,0,4,1,3,0,0.333333333333333
clemated,0,8,3,5,0,0.6
trackmaster,1,11,3,8,0,0.375
kickwheel,1,9,3,6,0,0.5
wristwatches,1,12,3,9,0,0.333333333333333
matricultures,0,13,5,8,0,0.625
janissarians,0,12,5,7,0,0.714285714285714
purreastationists,0,17,7,10,0,0.7
lyle,1,4,1,3,0,0.333333333333333
rxpatimars,0,10,3,7,0,0.428571428571429
w'hsvxlrsupogddaa'uhfbnnx,0,25,5,20,2,0.25
ramequins,1,9,4,5,0,0.8
hobing,0,6,2,4,0,0.5
ndwjcmjtpi,0,10,1,9,0,0.111111111111111
lle,0,3,1,2,0,0.5
blusher,1,7,2,5,0,0.4
zoroastra,1,9,4,5,0,0.8
accid,0,5,2,3,0,0.666666666666667
schantz,1,7,1,6,0,0.166666666666667
fathia,0,6,3,3,0,1
sterplangemishirulatche,0,23,8,15,0,0.533333333333333
kynded,1,6,1,5,0,0.2
spritsails,1,10,3,7,0,0.428571428571429
individed,1,9,4,5,0,0.8
alismoid,1,8,4,4,0,1
jdppuowutxjz'',0,14,3,11,2,0.272727272727273
yoglions,0,8,3,5,0,0.6
baudin,1,6,3,3,0,1
libergraphoticatedness,0,22,8,14,0,0.571428571428571
protosauria,0,11,6,5,0,1.2
jassuspirian,0,12,5,7,0,0.714285714285714
kran,0,4,1,3,0,0.333333333333333
tradura,0,7,3,4,0,0.75
simons,1,6,2,4,0,0.5
nlazhwo,0,7,2,5,0,0.4
esticulational,0,14,7,7,0,1
jebel,1,5,2,3,0,0.666666666666667
cous,0,4,2,2,0,1
tributor,0,8,3,5,0,0.6
belak,1,5,2,3,0,0.666666666666667
erruconisech,0,12,5,7,0,0.714285714285714
lorets,0,6,2,4,0,0.5
extraverting,1,12,4,8,0,0.5
mocarorse,0,9,4,5,0,0.8
cyprio,1,6,2,4,0,0.5
technocratemen,0,14,5,9,0,0.555555555555556
harold,1,6,2,4,0,0.5
cardiotoxicities,1,16,8,8,0,1
bernstein,1,9,3,6,0,0.5
coagulase,1,9,5,4,0,1.25
necrotise,1,9,4,5,0,0.8
reedley,1,7,3,4,0,0.75
pleight,0,7,2,5,0,0.4
baljane,0,7,3,4,0,0.75
sgik'nzrwmgl,0,12,1,11,1,0.0909090909090909
tism,0,4,1,3,0,0.333333333333333
cgbasweznssdnq,0,14,2,12,0,0.166666666666667
dsqjtfxmxzkbnneqfvxuhuijecc,0,27,5,22,0,0.227272727272727
tectness,0,8,2,6,0,0.333333333333333
intrudance,1,10,4,6,0,0.666666666666667
acant,0,5,2,3,0,0.666666666666667
palaeophysis,0,12,5,7,0,0.714285714285714
lestrigonian,1,12,5,7,0,0.714285714285714
ibmanquisinghe,0,14,6,8,0,0.75
justifier,1,9,4,5,0,0.8
ogaticyles,0,10,4,6,0,0.666666666666667
izhvpsedfkpbwiekduex,0,20,6,14,0,0.428571428571429
outissue,1,8,5,3,0,1.66666666666667
finsteafisectarorallioore,0,25,12,13,0,0.923076923076923
scirrhi,1,7,2,5,0,0.4
pxzv,0,4,0,4,0,0
astrionics,1,10,4,6,0,0.666666666666667
ncd,1,3,0,3,0,0
dactylonychoclassical,0,21,6,15,0,0.4
fornof,1,6,2,4,0,0.5
septemdecenary,1,14,5,9,0,0.555555555555556
bengalines,1,10,4,6,0,0.666666666666667
wilhlem,1,7,2,5,0,0.4
gunlock,1,7,2,5,0,0.4
extractive,1,10,4,6,0,0.666666666666667
tamar,1,5,2,3,0,0.666666666666667
tiremen,1,7,3,4,0,0.75
groeneng,0,8,3,5,0,0.6
iostes,0,6,3,3,0,1
intermeddlesomeness,1,19,7,12,0,0.583333333333333
impartations,1,12,5,7,0,0.714285714285714
lations,0,7,3,4,0,0.75
aidmkumjxxwbqpblm,0,17,3,14,0,0.214285714285714
antivaccinationisms,1,19,8,11,0,0.727272727272727
piliner,0,7,3,4,0,0.75
turkman,1,7,2,5,0,0.4
sanopurulent,1,12,5,7,0,0.714285714285714
leucosticte,1,11,5,6,0,0.833333333333333
sondlt,0,6,1,5,0,0.2
naris,1,5,2,3,0,0.666666666666667
silverinesses,1,13,5,8,0,0.625
lialoption,0,10,5,5,0,1
stockado,1,8,3,5,0,0.6
millersburg,1,11,3,8,0,0.375
baileyton,1,9,4,5,0,0.8
neuropsychologies,1,17,7,10,0,0.7
pinz,1,4,1,3,0,0.333333333333333
wisecretiscussiblenesses,0,24,9,15,0,0.6
clangorously,1,12,4,8,0,0.5
prepriced,1,9,3,6,0,0.5
pringuadia,0,10,5,5,0,1
vantenacceophzoptrique,0,22,9,13,0,0.692307692307692
stantised,0,9,3,6,0,0.5
illexiscaqus,0,12,5,7,0,0.714285714285714
mitanise,0,8,4,4,0,1
tipped,1,6,2,4,0,0.5
meery,0,5,2,3,0,0.666666666666667
ishmul,1,6,2,4,0,0.5
bansmolicatimunouls,0,19,8,11,0,0.727272727272727
exogencedenuncturkhous,0,22,9,13,0,0.692307692307692
entracte,1,8,3,5,0,0.6
ijmv'ahh,0,8,2,6,1,0.333333333333333
northerly,1,9,2,7,0,0.285714285714286
qumalepese,0,10,5,5,0,1
rescinders,1,10,3,7,0,0.428571428571429
terron,0,6,2,4,0,0.5
foley,1,5,2,3,0,0.666666666666667
trickiest,1,9,3,6,0,0.5
anasarca,1,8,4,4,0,1
hyperrankness,0,13,3,10,0,0.3
verdicts,1,8,2,6,0,0.333333333333333
alak,0,4,2,2,0,1
rotalinity,0,10,4,6,0,0.666666666666667
scharaga,1,8,3,5,0,0.6
mahratta,1,8,3,5,0,0.6
blokemacants,0,12,4,8,0,0.5
mjjydenbuetlsmrutlotdcli,0,24,6,18,0,0.333333333333333
kanya,1,5,2,3,0,0.666666666666667
forgimmundes,0,12,4,8,0,0.5
isobronts,1,9,3,6,0,0.5
stebbins,1,8,2,6,0,0.333333333333333
increatic,0,9,4,5,0,0.8
postmillers,0,11,3,8,0,0.375
pelota,1,6,3,3,0,1
tetisoftis,0,10,4,6,0,0.666666666666667
unbuttressless,0,14,4,10,0,0.4
equinonest,0,10,5,5,0,1
unharmonist,0,11,4,7,0,0.571428571428571
bussmatorveser,0,14,5,9,0,0.555555555555556
suashromedition,0,15,7,8,0,0.875
triggering,1,10,3,7,0,0.428571428571429
orlewise,1,8,4,4,0,1
prouty,1,6,2,4,0,0.5
mokiestada,0,10,5,5,0,1
adorne,1,6,3,3,0,1
calcazardon,0,11,4,7,0,0.571428571428571
dises,0,5,2,3,0,0.666666666666667
mertibilism,0,11,4,7,0,0.571428571428571
chakut,0,6,2,4,0,0.5
cladogram,1,9,3,6,0,0.5
ostentineae,0,11,6,5,0,1.2
hyperkalemia,1,12,5,7,0,0.714285714285714
ulas,0,4,2,2,0,1
potawatomically,0,15,6,9,0,0.666666666666667
mnisturning,0,11,3,8,0,0.375
trunnion,1,8,3,5,0,0.6
pytlqczzverx,0,12,1,11,0,0.0909090909090909
reitemizing,1,11,5,6,0,0.833333333333333
grouchiness,1,11,4,7,0,0.571428571428571
apostrophied,1,12,5,7,0,0.714285714285714
stalin,1,6,2,4,0,0.5
sequentially,1,12,5,7,0,0.714285714285714
coroplast,1,9,3,6,0,0.5
illywhacker,1,11,3,8,0,0.375
phythernetroter,0,15,4,11,0,0.363636363636364
porphyrogenitus,1,15,5,10,0,0.5
percoil,0,7,3,4,0,0.75
svengeants,0,10,3,7,0,0.428571428571429
smellings,1,9,2,7,0,0.285714285714286
danae,1,5,3,2,0,1.5
jbcjdmc,0,7,0,7,0,0
pythagoreanism,1,14,5,9,0,0.555555555555556
mantineia,1,9,5,4,0,1.25
unparasarikos,0,13,6,7,0,0.857142857142857
wusb'xjlxatvdzl,0,15,2,13,1,0.153846153846154
thaeousnesporliololisagricaratioed,0,34,17,17,0,1
drachexodontialness,0,19,7,12,0,0.583333333333333
lucratively,1,11,4,7,0,0.571428571428571
unhon,0,5,2,3,0,0.666666666666667
jasperation,0,11,5,6,0,0.833333333333333
gephyrophobia,1,13,5,8,0,0.625
selpicarin,0,10,4,6,0,0.666666666666667
obstreperated,1,13,5,8,0,0.625
khartum,1,7,2,5,0,0.4
crisp,1,5,1,4,0,0.25
homotherapies,0,13,6,7,0,0.857142857142857
synderesis,1,10,3,7,0,0.428571428571429
promachus,1,9,3,6,0,0.5
undepravediggering,0,18,7,11,0,0.636363636363636
ephraim,1,7,3,4,0,0.75
fumatory,1,8,3,5,0,0.6
cyter,0,5,1,4,0,0.25
criticist,0,9,3,6,0,0.5
proprecedents,0,13,4,9,0,0.444444444444444
unhospitableness,1,16,6,10,0,0.6
brooddecas,0,10,4,6,0,0.666666666666667
panetela,1,8,4,4,0,1
crimizen,0,8,3,5,0,0.6
mised,0,5,2,3,0,0.666666666666667
cockpit,1,7,2,5,0,0.4
unodoridae,0,10,6,4,0,1.5
chana,1,5,2,3,0,0.666666666666667
trabanes,0,8,3,5,0,0.6
frlein,1,6,2,4,0,0.5
paymaster,1,9,3,6,0,0.5
subordinational,0,15,7,8,0,0.875
commingled,1,10,3,7,0,0.428571428571429
tencelassars,0,12,4,8,0,0.5
walyaqhrewbncjqqlasrirc,0,23,5,18,0,0.277777777777778
succot,1,6,2,4,0,0.5
rct'oaai'agn,0,12,5,7,2,0.714285714285714
hair,1,4,2,2,0,1
clavicornia,1,11,5,6,0,0.833333333333333
saral,0,5,2,3,0,0.666666666666667
wajvpmquaujd,0,12,4,8,0,0.5
cracinae,1,8,4,4,0,1
override,1,8,4,4,0,1
sandbars,1,8,2,6,0,0.333333333333333
malacopod,1,9,4,5,0,0.8
mdenopart,0,9,3,6,0,0.5
adle,0,4,2,2,0,1
actualist,1,9,4,5,0,0.8
wiosssuin,0,9,4,5,0,0.8
quarantinable,1,13,6,7,0,0.857142857142857
ascendance,1,10,4,6,0,0.666666666666667
winghetergomes,0,14,5,9,0,0.555555555555556
naxos,1,5,2,3,0,0.666666666666667
dilantrdgedihon,0,15,5,10,0,0.5
ppbtcvrjdpshj,0,13,0,13,0,0
resophysicodelword,0,18,6,12,0,0.5
bushland,1,8,2,6,0,0.333333333333333
fishnessemianism,0,16,6,10,0,0.6
semitangents,0,12,4,8,0,0.5
plasmodesmata,1,13,5,8,0,0.625
tennant,1,7,2,5,0,0.4
gastrodisc,1,10,3,7,0,0.428571428571429
forfar,1,6,2,4,0,0.5
bemellif,0,8,3,5,0,0.6
cargian,1,7,3,4,0,0.75
shrillness,1,10,2,8,0,0.25
ethmophysal,1,11,3,8,0,0.375
perfumery,1,9,3,6,0,0.5
wagulfres,0,9,3,6,0,0.5
trallian,1,8,3,5,0,0.6
innascibility,1,13,5,8,0,0.625
slavophiles,1,11,4,7,0,0.571428571428571
implasher,0,9,3,6,0,0.5
raunion,1,7,4,3,0,1.33333333333333
'g,0,2,0,2,1,0
admines,0,7,3,4,0,0.75
angellike,1,9,4,5,0,0.8
piazza,1,6,3,3,0,1
bipartisan,1,10,4,6,0,0.666666666666667
seastrand,1,9,3,6,0,0.5
meilichius,1,10,5,5,0,1
cashtown,1,8,2,6,0,0.333333333333333
chowanoc,1,8,3,5,0,0.6
flummer,1,7,2,5,0,0.4
haloperidols,1,12,5,7,0,0.714285714285714
ngusabexoooniatifivelicynstivehootacuaterr,0,42,20,22,0,0.909090909090909
nonwriter,1,9,3,6,0,0.5
vst'tkppybzfe,0,13,1,12,1,0.0833333333333333
unchiner,0,8,3,5,0,0.6
gnatter,1,7,2,5,0,0.4
bolderian,1,9,4,5,0,0.8
tsszbjrlfifo,0,12,2,10,0,0.2
spilogale,1,9,4,5,0,0.8
benedic,1,7,3,4,0,0.75
polydipsic,1,10,3,7,0,0.428571428571429
productuality,0,13,5,8,0,0.625
knessets,1,8,2,6,0,0.333333333333333
haverable,0,9,4,5,0,0.8
peroxyllextrastidifelevin,0,25,9,16,0,0.5625
phicallyimaelicalycantinnist,0,28,10,18,0,0.555555555555556
eptiress,0,8,3,5,0,0.6
dngedaraln,0,10,3,7,0,0.428571428571429
worlock,1,7,2,5,0,0.4
rease,0,5,3,2,0,1.5
pllocthiespiobug,0,16,6,10,0,0.6
joselenogrammatum,0,17,7,10,0,0.7
trainbearers,1,12,5,7,0,0.714285714285714
wund,0,4,1,3,0,0.333333333333333
slowwitted,1,10,3,7,0,0.428571428571429
lucer,0,5,2,3,0,0.666666666666667
sfo,1,3,1,2,0,0.5
clp'dmzayrjqqaxgvq,0,18,2,16,1,0.125
oversaving,1,10,4,6,0,0.666666666666667
auton,0,5,3,2,0,1.5
antanandro,1,10,4,6,0,0.666666666666667
upped,1,5,2,3,0,0.666666666666667
griffis,1,7,2,5,0,0.4
diprotodonata,0,13,6,7,0,0.857142857142857
superrimoon,0,11,5,6,0,0.833333333333333
fratencotomycheaddefignesion,0,28,11,17,0,0.647058823529412
lifschitz,1,9,2,7,0,0.285714285714286
educables,1,9,4,5,0,0.8
unostensible,1,12,5,7,0,0.714285714285714
ronoaleoullancnteyphotis,0,24,10,14,0,0.714285714285714
medon,1,5,2,3,0,0.666666666666667
fyhvzcun,0,8,1,7,0,0.142857142857143
josh,1,4,1,3,0,0.333333333333333
heterologously,1,14,6,8,0,0.75
lyity,0,5,1,4,0,0.25
receivers,1,9,4,5,0,0.8
duodecillios,0,12,6,6,0,1
wncoctroominidsiditee,0,21,9,12,0,0.75
paleron,0,7,3,4,0,0.75
mendous,0,7,3,4,0,0.75
phenolise,1,9,4,5,0,0.8
aniwpmum,0,8,3,5,0,0.6
reanalyser,0,10,4,6,0,0.666666666666667
latium,1,6,3,3,0,1
silit,0,5,2,3,0,0.666666666666667
manhattanizations,1,17,7,10,0,0.7
synch,1,5,0,5,0,0
antiaphthic,1,11,4,7,0,0.571428571428571
ethlephronidae,0,14,6,8,0,0.75
unseparatist,0,12,5,7,0,0.714285714285714
schmoosii,0,9,4,5,0,0.8
unbuckle,1,8,3,5,0,0.6
permeameter,1,11,5,6,0,0.833333333333333
overhappy,1,9,3,6,0,0.5
upsilon,1,7,3,4,0,0.75
domestic,1,8,3,5,0,0.6
infuthenogences,0,15,6,9,0,0.666666666666667
scissures,1,9,3,6,0,0.5
coarefarapoiketaivellika,0,24,13,11,0,1.18181818181818
counelos,0,8,4,4,0,1
optionalism,0,11,5,6,0,0.833333333333333
stangilong,0,10,3,7,0,0.428571428571429
zmzkxeevq,0,9,2,7,0,0.285714285714286
enwindowing,0,11,4,7,0,0.571428571428571
iushsajghqjvtmf,0,15,3,12,0,0.25
streator,1,8,3,5,0,0.6
unvisor,1,7,3,4,0,0.75
mitmentes,0,9,3,6,0,0.5
assortedness,0,12,4,8,0,0.5
cynosurus,1,9,3,6,0,0.5
ruinousness,1,11,5,6,0,0.833333333333333
phephs,0,6,1,5,0,0.2
curveball,1,9,3,6,0,0.5
whrwlsfnmdtubx'bpcaaldqe,0,24,4,20,1,0.2
auburta,1,7,4,3,0,1.33333333333333
scruction,0,9,3,6,0,0.5
dinte,0,5,2,3,0,0.666666666666667
unpatinated,1,11,5,6,0,0.833333333333333
skaneateless,0,12,5,7,0,0.714285714285714
dolma,1,5,2,3,0,0.666666666666667
baretullism,0,11,4,7,0,0.571428571428571
tered,0,5,2,3,0,0.666666666666667
taku,1,4,2,2,0,1
volapukee,0,9,5,4,0,1.25
tinward,0,7,2,5,0,0.4
keyhountermedicaean,0,19,9,10,0,0.9
dsmsuqjlagawkfg,0,15,3,12,0,0.25
aracara,0,7,4,3,0,1.33333333333333
kmhqfefploblh,0,13,2,11,0,0.181818181818182
storthingumbob,0,14,4,10,0,0.4
phid,0,4,1,3,0,0.333333333333333
millioned,1,9,4,5,0,0.8
starboarding,1,12,4,8,0,0.5
quadrisyllabizing,0,17,6,11,0,0.545454545454545
prbicioncontuow,0,15,6,9,0,0.666666666666667
undercurl,1,9,3,6,0,0.5
beladying,1,9,3,6,0,0.5
jovialness,1,10,4,6,0,0.666666666666667
phy,0,3,0,3,0,0
altism,0,6,2,4,0,0.5
uyhzmigskbbbp,0,13,2,11,0,0.181818181818182
dissour,1,7,3,4,0,0.75
weariedness,1,11,5,6,0,0.833333333333333
decern,1,6,2,4,0,0.5
sugarcoated,1,11,5,6,0,0.833333333333333
befouled,1,8,4,4,0,1
owol,0,4,2,2,0,1
bjchtelerere,0,12,4,8,0,0.5
kobs,1,4,1,3,0,0.333333333333333
whitterick,1,10,3,7,0,0.428571428571429
gammockiness,0,12,4,8,0,0.5
bumpositics,0,11,4,7,0,0.571428571428571
tailoress,1,9,4,5,0,0.8
'iyvrkekx'hmqaut'ukqujrvcli,0,27,7,20,3,0.35
semimanufactured,1,16,7,9,0,0.777777777777778
nondevelopable,1,14,6,8,0,0.75
blocksburg,1,10,2,8,0,0.25
juverk,0,6,2,4,0,0.5
cornworm,1,8,2,6,0,0.333333333333333
jewite,0,6,3,3,0,1
jareb,1,5,2,3,0,0.666666666666667
superphysicposing,1,17,5,12,0,0.416666666666667
stitilngy,0,9,2,7,0,0.285714285714286
embring,0,7,2,5,0,0.4
unpleasantnesses,1,16,6,10,0,0.6
salinities,1,10,5,5,0,1
child,1,5,1,4,0,0.25
ettoes,0,6,3,3,0,1
idou,1,4,3,1,0,3
superinquefortunis,0,18,8,10,0,0.8
zolainry,0,8,3,5,0,0.6
freitier,1,8,4,4,0,1
tules,1,5,2,3,0,0.666666666666667
stactometers,1,12,4,8,0,0.5
angiotelectasia,1,15,8,7,0,1.14285714285714
bivinyl,1,7,2,5,0,0.4
jaildom,1,7,3,4,0,0.75
recrush,1,7,2,5,0,0.4
ceratodus,1,9,4,5,0,0.8
yelma,0,5,2,3,0,0.666666666666667
kalate,0,6,3,3,0,1
paywalkingly,0,12,3,9,0,0.333333333333333
atiuripin,0,9,5,4,0,1.25
coreligionism,0,13,6,7,0,0.857142857142857
accreditor,0,10,4,6,0,0.666666666666667
gammoner,1,8,3,5,0,0.6
husewguolj,0,10,4,6,0,0.666666666666667
mersion,1,7,3,4,0,0.75
yarungymnionexivauncephipradelaim,0,33,14,19,0,0.736842105263158
reinfusional,0,12,6,6,0,1
quadrivia,1,9,5,4,0,1.25
dannemora,1,9,4,5,0,0.8
primitive,1,9,4,5,0,0.8
kalamazoo,1,9,5,4,0,1.25
mideast,1,7,3,4,0,0.75
pothanger,1,9,3,6,0,0.5
phyllo,1,6,1,5,0,0.2
gxkrjbfhyglamdgpzfttj',0,22,1,21,1,0.0476190476190476
rewedegerus,0,11,5,6,0,0.833333333333333
alienicolar,0,11,6,5,0,1.2
scania,1,6,3,3,0,1
diory,0,5,2,3,0,0.666666666666667
phiotowilon,0,11,5,6,0,0.833333333333333
oddball,1,7,2,5,0,0.4
runnishly,0,9,2,7,0,0.285714285714286
megasporophyll,1,14,4,10,0,0.4
bathwater,1,9,3,6,0,0.5
bfhxqrtbkzjnqz,0,14,0,14,0,0
autovaccination,1,15,8,7,0,1.14285714285714
propalatable,0,12,5,7,0,0.714285714285714
saigon,1,6,3,3,0,1
hiloten,0,7,3,4,0,0.75
hemigale,1,8,4,4,0,1
ratistradotharthdthetraposposather,0,34,11,23,0,0.478260869565217
okqgk'otec,0,10,3,7,1,0.428571428571429
tiaunlotrickpte,0,15,6,9,0,0.666666666666667
muiptffnefjauahdbysfndh,0,23,6,17,0,0.352941176470588
undichotomous,1,13,6,7,0,0.857142857142857
skibobbed,1,9,3,6,0,0.5
seepage,1,7,4,3,0,1.33333333333333
cnrqxvcracwcc'kuyfhpf'n,0,23,2,21,2,0.0952380952380952
forcipressure,1,13,5,8,0,0.625
hospodar,1,8,3,5,0,0.6
belemnid,1,8,3,5,0,0.6
chagall,1,7,2,5,0,0.4
crustlelike,0,11,4,7,0,0.571428571428571
microswitch,1,11,3,8,0,0.375
squooshier,0,10,5,5,0,1
'zsumkiuxwftqxopmmbf,0,20,4,16,1,0.25
vilinmectistopoguital,0,21,9,12,0,0.75
amabil,1,6,3,3,0,1
unstableness,1,12,4,8,0,0.5
conoptimulative,0,15,7,8,0,0.875
oxgallongorance,0,15,6,9,0,0.666666666666667
acierage,1,8,5,3,0,1.66666666666667
demulsoid,0,9,4,5,0,0.8
alethtemung,0,11,4,7,0,0.571428571428571
hfctgtvsaakca,0,13,3,10,0,0.3
uwbiqrkjusoizwx,0,15,5,10,0,0.5
saugerties,1,10,5,5,0,1
amelsd,0,6,2,4,0,0.5
djenhfunjxsbnqjbs,0,17,2,15,0,0.133333333333333
midandealachilie,0,16,8,8,0,1
veridicalities,1,14,7,7,0,1
emailed,1,7,4,3,0,1.33333333333333
sparked,1,7,2,5,0,0.4
proscutellar,1,12,4,8,0,0.5
jacobin,1,7,3,4,0,0.75
ayrship,0,7,2,5,0,0.4
seepproof,1,9,4,5,0,0.8
derograme,0,9,4,5,0,0.8
pretaster,1,9,3,6,0,0.5
vasiferous,1,10,5,5,0,1
cierienill,0,10,5,5,0,1
unconcurring,1,12,4,8,0,0.5
diaphoret,0,9,4,5,0,0.8
notionate,1,9,5,4,0,1.25
clydebank,1,9,2,7,0,0.285714285714286
neuroethologies,1,15,8,7,0,1.14285714285714
labolt,1,6,2,4,0,0.5
wapperjawed,1,11,4,7,0,0.571428571428571
overrares,0,9,4,5,0,0.8
miscibility,1,11,4,7,0,0.571428571428571
squier,1,6,3,3,0,1
poverish,1,8,3,5,0,0.6
camids,0,6,2,4,0,0.5
anned,0,5,2,3,0,0.666666666666667
sibyllist,1,9,2,7,0,0.285714285714286
imnae,0,5,3,2,0,1.5
nonrecipiency,1,13,5,8,0,0.625
cyclothymia,1,11,3,8,0,0.375
interishinida,0,13,6,7,0,0.857142857142857
dessationkelis,0,14,6,8,0,0.75
axtollitta,0,10,4,6,0,0.666666666666667
lichenins,1,9,3,6,0,0.5
babasarson,0,10,4,6,0,0.666666666666667
determinant,1,11,4,7,0,0.571428571428571
sennet,1,6,2,4,0,0.5
icaleutic,0,9,5,4,0,1.25
lilast,0,6,2,4,0,0.5
antipodals,1,10,4,6,0,0.666666666666667
tribologist,1,11,4,7,0,0.571428571428571
herrle,1,6,2,4,0,0.5
unbrakes,1,8,3,5,0,0.6
thermoelement,1,13,5,8,0,0.625
electroencephalodiscus,0,22,9,13,0,0.692307692307692
myall,1,5,1,4,0,0.25
quadrioxalate,1,13,7,6,0,1.16666666666667
coady,1,5,2,3,0,0.666666666666667
cointresses,0,11,4,7,0,0.571428571428571
botany,1,6,2,4,0,0.5
tumblerful,1,10,3,7,0,0.428571428571429
unburnt,1,7,2,5,0,0.4
controls,1,8,2,6,0,0.333333333333333
outsentries,1,11,5,6,0,0.833333333333333
sologication,0,12,6,6,0,1
chorzuw,1,7,2,5,0,0.4
subpimpish,0,10,3,7,0,0.428571428571429
limnophobia,1,11,5,6,0,0.833333333333333
rety,0,4,1,3,0,0.333333333333333
ys'fiajhuuk,0,11,4,7,1,0.571428571428571
vydfoqxunvotnd'lijsyhkkqlneqnv,0,30,5,25,1,0.2
rosined,1,7,3,4,0,0.75
irremissive,1,11,5,6,0,0.833333333333333
arctangent,1,10,3,7,0,0.428571428571429
nidgett,0,7,2,5,0,0.4
fsufx'ximpxajnfyhgjdv,0,21,3,18,1,0.166666666666667
luted,1,5,2,3,0,0.666666666666667
puistic,0,7,3,4,0,0.75
goombays,1,8,3,5,0,0.6
nade,0,4,2,2,0,1
etle,0,4,2,2,0,1
placently,0,9,2,7,0,0.285714285714286
ninepenny,1,9,3,6,0,0.5
menkt,0,5,1,4,0,0.25
estrangelos,1,11,4,7,0,0.571428571428571
pokey,1,5,2,3,0,0.666666666666667
somer,0,5,2,3,0,0.666666666666667
hypnum,1,6,1,5,0,0.2
credit,1,6,2,4,0,0.5
tranquiallying,0,14,5,9,0,0.555555555555556
mimicry,1,7,2,5,0,0.4
uncantagonidae,0,14,7,7,0,1
acoelous,1,8,5,3,0,1.66666666666667
nonnationals,1,12,5,7,0,0.714285714285714
apophthegmatises,1,16,6,10,0,0.6
angly,0,5,1,4,0,0.25
macromethod,1,11,4,7,0,0.571428571428571
ketti,1,5,2,3,0,0.666666666666667
odedilomatyt,0,12,5,7,0,0.714285714285714
satiety,1,7,3,4,0,0.75
linasssmptrtid,0,14,3,11,0,0.272727272727273
soapboamburl,0,12,5,7,0,0.714285714285714
sraagrkbhubpkefwkacdn,0,21,5,16,0,0.3125
mutescences,0,11,4,7,0,0.571428571428571
ep'epezxmvlvfhna,0,16,4,12,1,0.333333333333333
anche,0,5,2,3,0,0.666666666666667
lisesolosasanida,0,16,8,8,0,1
mycoplasmal,1,11,3,8,0,0.375
d'otbdd'hhexsoc,0,15,3,12,2,0.25
thela,0,5,2,3,0,0.666666666666667
concleilimoloulsis,0,18,8,10,0,0.8
angelologies,1,12,6,6,0,1
leavers,1,7,3,4,0,0.75
heydon,1,6,2,4,0,0.5
desolateness,1,12,5,7,0,0.714285714285714
kitchen,1,7,2,5,0,0.4
ffidooxopi,0,10,5,5,0,1
norlina,1,7,3,4,0,0.75
iey,1,3,2,1,0,2
circuiteer,1,10,5,5,0,1
wildsville,1,10,3,7,0,0.428571428571429
grubberstmorigible,0,18,6,12,0,0.5
ginalondicas,0,12,5,7,0,0.714285714285714
anticonvulsives,1,15,6,9,0,0.666666666666667
equilobate,1,10,6,4,0,1.5
isolability,1,11,5,6,0,0.833333333333333
sudeccerhagen,0,13,5,8,0,0.625
sphaeritidae,0,12,6,6,0,1
machinelike,1,11,5,6,0,0.833333333333333
jolly,1,5,1,4,0,0.25
ftransmmuescite,0,15,5,10,0,0.5
nonmetalaquence,0,15,7,8,0,0.875
absconder,1,9,3,6,0,0.5
vories,1,6,3,3,0,1
commonplace,1,11,4,7,0,0.571428571428571
duedal,0,6,3,3,0,1
pleurobrachiidae,1,16,8,8,0,1
overtraded,1,10,4,6,0,0.666666666666667
ombe,0,4,2,2,0,1
huenerathospial,0,15,7,8,0,0.875
isthmist,0,8,2,6,0,0.333333333333333
cusic,0,5,2,3,0,0.666666666666667
repaginated,1,11,5,6,0,0.833333333333333
bupptlpxgsiolpcradwp,0,20,4,16,0,0.25
por,0,3,1,2,0,0.5
interosseous,1,12,6,6,0,1
rative,0,6,3,3,0,1
arrish,1,6,2,4,0,0.5
preconcafforeweirtz,0,19,7,12,0,0.583333333333333
iuka,1,4,3,1,0,3
annueler,1,8,4,4,0,1
schecker,0,8,2,6,0,0.333333333333333
gyro,1,4,1,3,0,0.333333333333333
copraxean,0,9,4,5,0,0.8
zooerasty,1,9,4,5,0,0.8
encloser,1,8,3,5,0,0.6
erdrozoisognaceae,0,17,9,8,0,1.125
bedye,1,5,2,3,0,0.666666666666667
apocynth,0,8,2,6,0,0.333333333333333
demonsociably,0,13,5,8,0,0.625
absolutions,1,11,5,6,0,0.833333333333333
brawaridisepao,0,14,7,7,0,1
cardialesi,0,10,5,5,0,1
broomweed,1,9,4,5,0,0.8
superator,0,9,4,5,0,0.8
angelfish,1,9,3,6,0,0.5
alexipharmics,1,13,5,8,0,0.625
wvcdxktdzxallsmhkwn,0,19,1,18,0,0.0555555555555556
darkening,1,9,3,6,0,0.5
anglify,1,7,2,5,0,0.4
groundhead,0,10,4,6,0,0.666666666666667
hamper,1,6,2,4,0,0.5
reckoning,1,9,3,6,0,0.5
crewlipongsys,0,13,3,10,0,0.3
peptonasal,0,10,4,6,0,0.666666666666667
unwalkable,1,10,4,6,0,0.666666666666667
gallabiya,1,9,4,5,0,0.8
polytechnics,1,12,3,9,0,0.333333333333333
surnamentoft,0,12,4,8,0,0.5
exicredoro,0,10,5,5,0,1
jardon,1,6,2,4,0,0.5
ectophyte,1,9,3,6,0,0.5
duplexer,1,8,3,5,0,0.6
psylitariable,0,13,5,8,0,0.625
footmarkab,0,10,4,6,0,0.666666666666667
ptiainlscothares,0,16,6,10,0,0.6
gejzcuqxaubvotehykypf,0,21,6,15,0,0.4
urlaveiophacad,0,14,7,7,0,1
zlazc,0,5,1,4,0,0.25
piecruda,0,8,4,4,0,1
unfasten,1,8,3,5,0,0.6
degelds,0,7,2,5,0,0.4
rabanna,1,7,3,4,0,0.75
malae,0,5,3,2,0,1.5
xtvpqjvqlfd,0,11,0,11,0,0
adinvention,1,11,5,6,0,0.833333333333333
halverson,1,9,3,6,0,0.5
angenesvillae,0,13,6,7,0,0.857142857142857
amvxgwxrl,0,9,1,8,0,0.125
ophidiinae,0,10,6,4,0,1.5
rouser,1,6,3,3,0,1
bemixt,1,6,2,4,0,0.5
allenateboming,0,14,6,8,0,0.75
gorefish,1,8,3,5,0,0.6
expulser,1,8,3,5,0,0.6
flini,0,5,2,3,0,0.666666666666667
minotaur,1,8,4,4,0,1
gastrotrichlorphons,0,19,5,14,0,0.357142857142857
leptivenebworton,0,16,6,10,0,0.6
tibourbou,1,9,5,4,0,1.25
physaria,1,8,3,5,0,0.6
baitfishes,1,10,4,6,0,0.666666666666667
fontanelle,1,10,4,6,0,0.666666666666667
egueiite,1,8,6,2,0,3
taramosalatas,1,13,6,7,0,0.857142857142857
tepan,0,5,2,3,0,0.666666666666667
tholing,1,7,2,5,0,0.4
nonbook,1,7,3,4,0,0.75
farler,1,6,2,4,0,0.5
m'xuycy,0,7,1,6,1,0.166666666666667
iatrogeny,1,9,4,5,0,0.8
copic,0,5,2,3,0,0.666666666666667
chackler,1,8,2,6,0,0.333333333333333
peristrephical,1,14,5,9,0,0.555555555555556
dendritically,1,13,4,9,0,0.444444444444444
deplichannua,0,12,5,7,0,0.714285714285714
massachus,0,9,3,6,0,0.5
hulliest,1,8,3,5,0,0.6
hathuns,0,7,2,5,0,0.4
bespangling,1,11,3,8,0,0.375
thion,0,5,2,3,0,0.666666666666667
pithecanthropy,0,14,4,10,0,0.4
xatpoqactbkzmewzquuzhwteex,0,26,8,18,0,0.444444444444444
concupies,1,9,4,5,0,0.8
punitiveness,1,12,5,7,0,0.714285714285714
eviration,1,9,5,4,0,1.25
rejectamenta,1,12,5,7,0,0.714285714285714
b'iymdhpbycgovsbwmnzbr'xsa,0,26,3,23,2,0.130434782608696
rhinry,0,6,1,5,0,0.2
ovectiess,0,9,4,5,0,0.8
paraffin,1,8,3,5,0,0.6
duckweed,1,8,3,5,0,0.6
rainiest,1,8,4,4,0,1
perturbednesses,0,15,5,10,0,0.5
apanage,1,7,4,3,0,1.33333333333333
confestus,0,9,3,6,0,0.5
strained,1,8,3,5,0,0.6
wreatine,0,8,4,4,0,1
tull,1,4,1,3,0,0.333333333333333
hyme,0,4,1,3,0,0.333333333333333
semiable,0,8,4,4,0,1
sketchbook,1,10,3,7,0,0.428571428571429
nonlepidopteral,1,15,6,9,0,0.666666666666667
warses,0,6,2,4,0,0.5
radca,0,5,2,3,0,0.666666666666667
ultimogeniture,1,14,7,7,0,1
klapp,1,5,1,4,0,0.25
os'mabrswpo,0,11,3,8,1,0.375
gharial,1,7,3,4,0,0.75
gunnies,1,7,3,4,0,0.75
diothelete,0,10,5,5,0,1
pipistrels,1,10,3,7,0,0.428571428571429
tidgaticas,0,10,4,6,0,0.666666666666667
poulanganese,0,12,6,6,0,1
skiddooed,1,9,4,5,0,0.8
spinescent,1,10,3,7,0,0.428571428571429
mmiftog,0,7,2,5,0,0.4
quination,0,9,5,4,0,1.25
keyway,1,6,2,4,0,0.5
loewhgtmxyvr'wpoegjfc,0,21,4,17,1,0.235294117647059
quieses,0,7,4,3,0,1.33333333333333
sabellasions,0,12,5,7,0,0.714285714285714
intioing,0,8,4,4,0,1
haemorrhoidectomy,1,17,7,10,0,0.7
syenodiment,0,11,4,7,0,0.571428571428571
reexportant,0,11,4,7,0,0.571428571428571
missayings,1,10,3,7,0,0.428571428571429
unwatching,1,10,3,7,0,0.428571428571429
incrossbreed,1,12,4,8,0,0.5
ezwkzlckscgbkwiqxxbhaupmx,0,25,4,21,0,0.19047619047619
narcostemmate,0,13,5,8,0,0.625
espanola,1,8,4,4,0,1
ebrdppu,0,7,2,5,0,0.4
dilater,1,7,3,4,0,0.75
antevens,0,8,3,5,0,0.6
contracoralliable,0,17,7,10,0,0.7
giefer,1,6,3,3,0,1
roly,0,4,1,3,0,0.333333333333333
recushion,1,9,4,5,0,0.8
dermococcus,1,11,4,7,0,0.571428571428571
ells,1,4,1,3,0,0.333333333333333
ardowarinompee,0,14,7,7,0,1
amabelle,1,8,4,4,0,1
stabilisator,1,12,5,7,0,0.714285714285714
steiger,1,7,3,4,0,0.75
ilatrouctientelogenhsnkller,0,27,10,17,0,0.588235294117647
contilbas,0,9,3,6,0,0.5
ckkils,0,6,1,5,0,0.2
xsjcqdbwvartqqlizdkcbukzfu'rx,0,29,4,25,1,0.16
pseudosolution,1,14,7,7,0,1
stomate,1,7,3,4,0,0.75
preemptory,1,10,3,7,0,0.428571428571429
barranquitas,1,12,5,7,0,0.714285714285714
simplificators,1,14,5,9,0,0.555555555555556
londony,1,7,2,5,0,0.4
encinal,1,7,3,4,0,0.75
nikethamide,1,11,5,6,0,0.833333333333333
muckobowemidphongelisang,0,24,9,15,0,0.6
levistone,0,9,4,5,0,0.8
oppressionist,1,13,5,8,0,0.625
subinflamed,0,11,4,7,0,0.571428571428571
herodiagnosticises,0,18,8,10,0,0.8
superathletes,1,13,5,8,0,0.625
inclewestasms,0,13,4,9,0,0.444444444444444
unkenness,0,9,3,6,0,0.5
waggling,1,8,2,6,0,0.333333333333333
lisaticieninnes,0,15,7,8,0,0.875
galactosaemia,1,13,7,6,0,1.16666666666667
brtinprs,0,8,1,7,0,0.142857142857143
osteoplasm,0,10,4,6,0,0.666666666666667
socinianizer,0,12,6,6,0,1
ddnames,0,7,2,5,0,0.4
hamostombloid,0,13,5,8,0,0.625
ardblessia,0,10,4,6,0,0.666666666666667
entfaoilff,1,10,4,6,0,0.666666666666667
bedsock,1,7,2,5,0,0.4
smastanotaca,0,12,5,7,0,0.714285714285714
jamlin,0,6,2,4,0,0.5
omela,0,5,3,2,0,1.5
loundered,1,9,4,5,0,0.8
alskss,0,6,1,5,0,0.2
ckalus,0,6,2,4,0,0.5
apetian,0,7,4,3,0,1.33333333333333
blorducklletingatanataredictlidridotenblerdaidgidrbbrgexictidssehrotartrvslineroskomaniloiven,0,93,33,60,0,0.55
bipupillate,1,11,5,6,0,0.833333333333333
ygmckn'cy,0,9,0,9,1,0
hamer,1,5,2,3,0,0.666666666666667
rpsah,0,5,1,4,0,0.25
annishegst,0,10,3,7,0,0.428571428571429
daybreak,1,8,3,5,0,0.6
ckilppere,0,9,3,6,0,0.5
predikant,1,9,3,6,0,0.5
choroidal,1,9,4,5,0,0.8
osetioerr,0,9,5,4,0,1.25
rhizopogon,1,10,4,6,0,0.666666666666667
jluubmsegpz,0,11,3,8,0,0.375
vanampramang,0,12,4,8,0,0.5
untingisomicies,0,15,7,8,0,0.875
uppe,0,4,2,2,0,1
spanner,1,7,2,5,0,0.4
pleasurer,1,9,4,5,0,0.8
supercommentary,1,15,5,10,0,0.5
subcolony,1,9,3,6,0,0.5
gasoles,0,7,3,4,0,0.75
slimulacidae,0,12,6,6,0,1
ponties,1,7,3,4,0,0.75
fowlstown,1,9,2,7,0,0.285714285714286
woodcarvings,1,12,4,8,0,0.5
brewed,1,6,2,4,0,0.5
ligandified,0,11,5,6,0,0.833333333333333
spairs,0,6,2,4,0,0.5
rader,0,5,2,3,0,0.666666666666667
unformule,0,9,4,5,0,0.8
oporto,1,6,3,3,0,1
xerographically,1,15,5,10,0,0.5
earthlies,1,9,4,5,0,0.8
coggie,1,6,3,3,0,1
asteartamp,0,10,4,6,0,0.666666666666667
viclvegbttlbxjxg,0,16,2,14,0,0.142857142857143
semiproduct,0,11,4,7,0,0.571428571428571
tholobates,1,10,4,6,0,0.666666666666667
mailrooms,1,9,4,5,0,0.8
coroebuck,0,9,4,5,0,0.8
inell,0,5,2,3,0,0.666666666666667
ballses,1,7,2,5,0,0.4
tollination,0,11,5,6,0,0.833333333333333
owerance,1,8,4,4,0,1
unmellow,1,8,3,5,0,0.6
calboomenaldalowshetonamete,0,27,12,15,0,0.8
peoria,1,6,4,2,0,2
pyospermous,0,11,4,7,0,0.571428571428571
neclowsogriaroal,0,16,7,9,0,0.777777777777778
carinthia,1,9,4,5,0,0.8
nifes,1,5,2,3,0,0.666666666666667
caphor,0,6,2,4,0,0.5
gemmipara,1,9,4,5,0,0.8
sobrieties,1,10,5,5,0,1
roemisties,0,10,5,5,0,1
strigiformes,1,12,4,8,0,0.5
uapreranonesheneyioerabintutesoicoy,0,35,18,17,0,1.05882352941176
jbqkwwshfjoloxiwtozk,0,20,4,16,0,0.25
kalapooia,1,9,6,3,0,2
doctors,1,7,2,5,0,0.4
illoguerrate,0,12,6,6,0,1
platinichloridae,0,16,7,9,0,0.777777777777778
coverorthwateraces,0,18,7,11,0,0.636363636363636
nonchanneled,1,12,4,8,0,0.5
higgs,1,5,1,4,0,0.25
supercerebrally,1,15,5,10,0,0.5
trinitis,0,8,3,5,0,0.6
cutags,0,6,2,4,0,0.5
knockwursts,1,11,2,9,0,0.222222222222222
terrance,1,8,3,5,0,0.6
deserveniest,0,12,5,7,0,0.714285714285714
hydrodictyaceae,1,15,6,9,0,0.666666666666667
phrante,0,7,2,5,0,0.4
aggravates,1,10,4,6,0,0.666666666666667
abnesses,0,8,3,5,0,0.6
diversional,1,11,5,6,0,0.833333333333333
beggarwoman,1,11,4,7,0,0.571428571428571
acrotreta,1,9,4,5,0,0.8
chestes,0,7,2,5,0,0.4
serscepheerrnahi,0,16,6,10,0,0.6
chickening,1,10,3,7,0,0.428571428571429
unabstentious,1,13,6,7,0,0.857142857142857
minaniles,0,9,4,5,0,0.8
taliphthalishiri,0,16,6,10,0,0.6
temvimarid,0,10,4,6,0,0.666666666666667
unsarepre,0,9,4,5,0,0.8
kakiemon,1,8,4,4,0,1
dikers,1,6,2,4,0,0.5
mariande,1,8,4,4,0,1
of'lhrzrnvgigytw'q,0,18,2,16,2,0.125
chocatapers,0,11,4,7,0,0.571428571428571
unnocerastigmatise,0,18,8,10,0,0.8
wephalus,0,8,3,5,0,0.6
kaleb,1,5,2,3,0,0.666666666666667
crotalid,1,8,3,5,0,0.6
nonmutability,1,13,5,8,0,0.625
camokophots,0,11,4,7,0,0.571428571428571
schlater,1,8,2,6,0,0.333333333333333
smnijqiagynu,0,12,4,8,0,0.5
vpfzdanrthuyaagplogugm,0,22,6,16,0,0.375
creadweedbandificary,0,20,8,12,0,0.666666666666667
nonralised,0,10,4,6,0,0.666666666666667
compervos,0,9,3,6,0,0.5
ically,0,6,2,4,0,0.5
subvertively,0,12,4,8,0,0.5
litterbug,1,9,3,6,0,0.5
natricinae,1,10,5,5,0,1
venes,0,5,2,3,0,0.666666666666667
remantle,1,8,3,5,0,0.6
patrico,1,7,3,4,0,0.75
argotin,0,7,3,4,0,0.75
rdngter,0,7,1,6,0,0.166666666666667
impetulancewoods,0,16,7,9,0,0.777777777777778
accsdwjgmhynx'ghrpyus'qeisj,0,27,4,23,2,0.173913043478261
bastian,1,7,3,4,0,0.75
anola,0,5,3,2,0,1.5
stahlhelm,1,9,2,7,0,0.285714285714286
combustions,1,11,4,7,0,0.571428571428571
hypnoidization,1,14,6,8,0,0.75
predeclared,1,11,4,7,0,0.571428571428571
cochise,1,7,3,4,0,0.75
geminaria,0,9,5,4,0,1.25
usa,1,3,2,1,0,2
orfe,1,4,2,2,0,1
somniloquisms,1,13,5,8,0,0.625
unordiableissals,0,16,7,9,0,0.777777777777778
predebates,0,10,4,6,0,0.666666666666667
ropillable,0,10,4,6,0,0.666666666666667
pickadillies,1,12,5,7,0,0.714285714285714
eocndeycwqabjk,0,14,4,10,0,0.4
dotrel,1,6,2,4,0,0.5
befishattineffaragrimus,0,23,9,14,0,0.642857142857143
hyperdeifying,1,13,4,9,0,0.444444444444444
quatite,0,7,4,3,0,1.33333333333333
undecently,1,10,3,7,0,0.428571428571429
distensions,1,11,4,7,0,0.571428571428571
lambrequins,1,11,4,7,0,0.571428571428571
injucundity,1,11,4,7,0,0.571428571428571
hfcdylbrommyqiiuujf,0,19,5,14,0,0.357142857142857
rootwalt,1,8,3,5,0,0.6
benedetto,1,9,4,5,0,0.8
vfeylsskwrbyzhitmvy,0,19,2,17,0,0.117647058823529
shakudo,1,7,3,4,0,0.75
hypernatraemia,1,14,6,8,0,0.75
looping,1,7,3,4,0,0.75
cagancord'indippis,0,18,6,12,1,0.5
terrailer,0,9,4,5,0,0.8
hyrambic,0,8,2,6,0,0.333333333333333
geayost,0,7,3,4,0,0.75
retrodict,1,9,3,6,0,0.5
redistinguishability,0,20,8,12,0,0.666666666666667
amadercharaswongee,0,18,8,10,0,0.8
pandolent,0,9,3,6,0,0.5
ubh,0,3,1,2,0,0.5
megadeationate,0,14,8,6,0,1.33333333333333
gry,1,3,0,3,0,0
postcarotid,1,11,4,7,0,0.571428571428571
shevron,0,7,2,5,0,0.4
guanay,1,6,3,3,0,1
nictating,1,9,3,6,0,0.5
viabilities,1,11,6,5,0,1.2
nimious,1,7,4,3,0,1.33333333333333
cayu,0,4,2,2,0,1
himirdiomimae,0,13,7,6,0,1.16666666666667
wases,1,5,2,3,0,0.666666666666667
teolitier,0,9,5,4,0,1.25
pretiring,1,9,3,6,0,0.5
pregallycetherocheher,0,21,7,14,0,0.5
merri,1,5,2,3,0,0.666666666666667
karl,1,4,1,3,0,0.333333333333333
respiritleatherianises,0,22,10,12,0,0.833333333333333
qvpyamkkzepmozkdrdjejvqhuu,0,26,6,20,0,0.3
cvpddlg'd,0,9,0,9,1,0
lothatustaterresensthys,0,23,7,16,0,0.4375
divinitrical,0,12,5,7,0,0.714285714285714
stration,0,8,3,5,0,0.6
cromerian,1,9,4,5,0,0.8
commandering,0,12,4,8,0,0.5
wisecrack,1,9,3,6,0,0.5
dovevinsonal,0,12,5,7,0,0.714285714285714
eodiscid,1,8,4,4,0,1
smiddied,1,8,3,5,0,0.6
rgisseur,1,8,3,5,0,0.6
iridochoroiditis,1,16,8,8,0,1
nonapprehensible,1,16,6,10,0,0.6
pneumonologic,0,13,6,7,0,0.857142857142857
uryemarindramays,0,16,6,10,0,0.6
batement,1,8,3,5,0,0.6
decendo,0,7,3,4,0,0.75
dolma,1,5,2,3,0,0.666666666666667
dowelltown,1,10,3,7,0,0.428571428571429
deksc,0,5,1,4,0,0.25
stibbles,1,8,2,6,0,0.333333333333333
leopoldville,1,12,5,7,0,0.714285714285714
counmolo,0,8,4,4,0,1
'tgmetshyqscly,0,14,1,13,1,0.0769230769230769
unmilled,1,8,3,5,0,0.6
chispreticism,0,13,4,9,0,0.444444444444444
tobelief,0,8,4,4,0,1
ay,1,2,1,1,0,1
incs,0,4,1,3,0,0.333333333333333
tttid,0,5,1,4,0,0.25
schizogenesis,1,13,5,8,0,0.625
hymisathos,0,10,3,7,0,0.428571428571429
hircinous,1,9,4,5,0,0.8
immutoriacaletably,0,18,8,10,0,0.8
megaloglossia,1,13,6,7,0,0.857142857142857
dreadfeet,0,9,4,5,0,0.8
doxorubicin,1,11,5,6,0,0.833333333333333
milfay,1,6,2,4,0,0.5
misquote,1,8,4,4,0,1
xasclhcwnngdyhe,0,15,2,13,0,0.153846153846154
meinie,1,6,4,2,0,2
schoolbooks,1,11,4,7,0,0.571428571428571
obola,1,5,3,2,0,1.5
incommunicide,0,13,6,7,0,0.857142857142857
hoosing,0,7,3,4,0,0.75
glower,1,6,2,4,0,0.5
asmodeus,1,8,4,4,0,1
marchereberanking,0,17,6,11,0,0.545454545454545
iwifps,0,6,2,4,0,0.5
pviudanrtepzoyqql,0,17,5,12,0,0.416666666666667
'aridragzthlzkdqqiwohxtps,0,25,5,20,1,0.25
synoetic,1,8,3,5,0,0.6
conitridineston,0,15,6,9,0,0.666666666666667
justiciary,1,10,4,6,0,0.666666666666667
nearish,1,7,3,4,0,0.75
bartonia,1,8,4,4,0,1
einthoven,1,9,4,5,0,0.8
analcimite,1,10,5,5,0,1
amp,1,3,1,2,0,0.5
oniscus,1,7,3,4,0,0.75
forbite,1,7,3,4,0,0.75
enjoymentrobenza,0,16,6,10,0,0.6
oversusceptible,1,15,6,9,0,0.666666666666667
aeluroidea,1,10,7,3,0,2.33333333333333
pages,1,5,2,3,0,0.666666666666667
chie,0,4,2,2,0,1
booklear,1,8,4,4,0,1
rangian,0,7,3,4,0,0.75
lamellibranchs,1,14,4,10,0,0.4
pufi,0,4,2,2,0,1
preassement,0,11,4,7,0,0.571428571428571
hayrack,1,7,2,5,0,0.4
cilypconchamensotrlintphed,0,26,7,19,0,0.368421052631579
outmagic,1,8,4,4,0,1
antifascists,1,12,4,8,0,0.5
monocornithecaleorhizations,0,27,12,15,0,0.8
alethiological,1,14,7,7,0,1
pronoma,0,7,3,4,0,0.75
slouchiness,1,11,4,7,0,0.571428571428571
coemployment,1,12,4,8,0,0.5
econansispocaleconiant,0,22,10,12,0,0.833333333333333
ilmtnaxewfgq'u,0,14,4,10,1,0.4
couplickanteaprome,0,18,8,10,0,0.8
oqznsjkt'wqx'p,0,14,1,13,2,0.0769230769230769
clineum,0,7,3,4,0,0.75
driploverners,0,13,4,9,0,0.444444444444444
tnpjsuwuqy,0,10,2,8,0,0.25
mussitation,1,11,5,6,0,0.833333333333333
warpowers,1,9,3,6,0,0.5
exploration,1,11,5,6,0,0.833333333333333
psend,1,5,1,4,0,0.25
vivisector,1,10,4,6,0,0.666666666666667
smri,0,4,1,3,0,0.333333333333333
amphiprions,0,11,4,7,0,0.571428571428571
pigsney,1,7,2,5,0,0.4
quild,0,5,2,3,0,0.666666666666667
epitheliosporangioprecipitally,0,30,13,17,0,0.764705882352941
praly,0,5,1,4,0,0.25
martsen,1,7,2,5,0,0.4
ijgjfwqn'tu,0,11,2,9,1,0.222222222222222
lundquists,0,10,3,7,0,0.428571428571429
nonsubtleties,1,13,5,8,0,0.625
pathacin,0,8,3,5,0,0.6
villard,1,7,2,5,0,0.4
brylloothwiforlfianpimanes,0,26,9,17,0,0.529411764705882
aerographics,1,12,5,7,0,0.714285714285714
suhuaro,1,7,4,3,0,1.33333333333333
gradly,0,6,1,5,0,0.2
plazatteadersequelysese,0,23,10,13,0,0.769230769230769
treadheartesis,0,14,6,8,0,0.75
alves,1,5,2,3,0,0.666666666666667
darkley,0,7,2,5,0,0.4
snr,1,3,0,3,0,0
meanspiritednesses,1,18,7,11,0,0.636363636363636
bead,1,4,2,2,0,1
hnqvhzteqjgigf'rmreq,0,20,3,17,1,0.176470588235294
tom,1,3,1,2,0,0.5
interforce,1,10,4,6,0,0.666666666666667
cosmopolites,1,12,5,7,0,0.714285714285714
ghent,1,5,1,4,0,0.25
idiotisms,1,9,4,5,0,0.8
detally,0,7,2,5,0,0.4
nonmannerlessness,0,17,5,12,0,0.416666666666667
sorediform,1,10,4,6,0,0.666666666666667
ther,0,4,1,3,0,0.333333333333333
diaphancy,0,9,3,6,0,0.5
intrusionist,1,12,5,7,0,0.714285714285714
torchers,1,8,2,6,0,0.333333333333333
boutonniares,1,12,6,6,0,1
eqixpous'xcdjjprivmoqgz,0,23,6,17,1,0.352941176470588
qestxjedvrki,0,12,3,9,0,0.333333333333333
rotographed,1,11,4,7,0,0.571428571428571
retaxingly,0,10,3,7,0,0.428571428571429
gunxs',0,6,1,5,1,0.2
magocisa,0,8,4,4,0,1
archdiocesian,0,13,6,7,0,0.857142857142857
donge,0,5,2,3,0,0.666666666666667
vindicatorily,1,13,5,8,0,0.625
flm,0,3,0,3,0,0
daller,0,6,2,4,0,0.5
rguyvluibpkxmhoneqrztdifh,0,25,6,19,0,0.315789473684211
photyphostudicalisating,0,23,8,15,0,0.533333333333333
adlumines,0,9,4,5,0,0.8
illimicra,0,9,4,5,0,0.8
ymmt'nbdyagy,0,12,1,11,1,0.0909090909090909
albertin,1,8,3,5,0,0.6
rhabdom,1,7,2,5,0,0.4
intented,1,8,3,5,0,0.6
melanconiaceae,1,14,8,6,0,1.33333333333333
aphasic,1,7,3,4,0,0.75
winegrologue,0,12,6,6,0,1
toxodontidae,0,12,6,6,0,1
malodia,0,7,4,3,0,1.33333333333333
thoracobronchophous,0,19,7,12,0,0.583333333333333
unsulphurised,1,13,5,8,0,0.625
'achhjoczzgvuzz,0,15,3,12,1,0.25
priapic,1,7,3,4,0,0.75
syzygetically,1,13,3,10,0,0.3
avechy,0,6,2,4,0,0.5
scammificatasaccouries,0,22,10,12,0,0.833333333333333
phocide,0,7,3,4,0,0.75
marshinesses,1,12,4,8,0,0.5
inconcierge,0,11,5,6,0,0.833333333333333
nonhostily,0,10,3,7,0,0.428571428571429
oblique,1,7,4,3,0,1.33333333333333
housecleaner,1,12,6,6,0,1
gallabia,1,8,4,4,0,1
trvinde,0,7,2,5,0,0.4
pewholder,1,9,3,6,0,0.5
mulleecate,0,10,5,5,0,1
''asdqoknpdirtc,0,15,3,12,2,0.25
comale,0,6,3,3,0,1
reinaugurated,1,13,7,6,0,1.16666666666667
funguish,0,8,3,5,0,0.6
ichy,0,4,1,3,0,0.333333333333333
selachidae,0,10,5,5,0,1
untrantist,0,10,3,7,0,0.428571428571429
bisayabiliter,0,13,6,7,0,0.857142857142857
fzzoawzd,0,8,2,6,0,0.333333333333333
eschin,0,6,2,4,0,0.5
chorded,1,7,2,5,0,0.4
zgwjcyhrfsx,0,11,0,11,0,0
cogo,0,4,2,2,0,1
noncastigating,1,14,5,9,0,0.555555555555556
sclerotizations,1,15,6,9,0,0.666666666666667
tuition,1,7,4,3,0,1.33333333333333
harunobu,1,8,4,4,0,1
goldarnedest,1,12,4,8,0,0.5
umbine,0,6,3,3,0,1
elentimuls,0,10,4,6,0,0.666666666666667
unpagrest,0,9,3,6,0,0.5
djiv,0,4,1,3,0,0.333333333333333
secretor,1,8,3,5,0,0.6
unclaimed,1,9,4,5,0,0.8
apotropaism,1,11,5,6,0,0.833333333333333
contextual,1,10,4,6,0,0.666666666666667
coccolithophragma,0,17,6,11,0,0.545454545454545
aleintind,0,9,4,5,0,0.8
digonous,1,8,4,4,0,1
dians,0,5,2,3,0,0.666666666666667
trucaenesses,0,12,5,7,0,0.714285714285714
cus,0,3,1,2,0,0.5
actinozoa,1,9,5,4,0,1.25
gowmbqtisisaczd,0,15,4,11,0,0.363636363636364
nethermost,1,10,3,7,0,0.428571428571429
outcrafties,1,11,5,6,0,0.833333333333333
ances,0,5,2,3,0,0.666666666666667
distilland,1,10,3,7,0,0.428571428571429
ramversistings,0,14,4,10,0,0.4
qnjxhqpkiocmuulhopovhq,0,22,6,16,0,0.375
sulfamethane,0,12,5,7,0,0.714285714285714
calamostachys,1,13,4,9,0,0.444444444444444
trichoepithelioma,1,17,8,9,0,0.888888888888889
coollybag,0,9,3,6,0,0.5
urerereg,0,8,4,4,0,1
revascularizations,1,18,8,10,0,0.8
scaithless,1,10,3,7,0,0.428571428571429
blesul,0,6,2,4,0,0.5
chaetopodous,1,12,6,6,0,1
coulle,0,6,3,3,0,1
tacles,0,6,2,4,0,0.5
matl,0,4,1,3,0,0.333333333333333
warrennessean,0,13,5,8,0,0.625
liveborn,1,8,3,5,0,0.6
entrainesses,0,12,5,7,0,0.714285714285714
tunhood,0,7,3,4,0,0.75
dattochlorinax,0,14,5,9,0,0.555555555555556
cowskin,1,7,2,5,0,0.4
lamoureux,1,9,5,4,0,1.25
prognosy,0,8,2,6,0,0.333333333333333
devland,1,7,2,5,0,0.4
uredospores,1,11,5,6,0,0.833333333333333
poliorcetics,1,12,5,7,0,0.714285714285714
thiourea,1,8,5,3,0,1.66666666666667
untouchable,1,11,5,6,0,0.833333333333333
remens,1,6,2,4,0,0.5
dusty,1,5,1,4,0,0.25
lupis,1,5,2,3,0,0.666666666666667
bohora,1,6,3,3,0,1
ppeqklfighzyimygroelh,0,21,5,16,0,0.3125
sftngquejklfl',0,14,2,12,1,0.166666666666667
cushier,1,7,3,4,0,0.75
eal,1,3,2,1,0,2
sweepingly,1,10,3,7,0,0.428571428571429
melanotis,1,9,4,5,0,0.8
lodens,1,6,2,4,0,0.5
nonarticulator,0,14,6,8,0,0.75
leukoplasmagala,0,15,7,8,0,0.875
swordfish,1,9,2,7,0,0.285714285714286
nuryton,0,7,2,5,0,0.4
cdmgxckobz,0,10,1,9,0,0.111111111111111
qnsluzpzba,0,10,2,8,0,0.25
prelabour,1,9,4,5,0,0.8
dqfleffjto'agjtfl,0,17,3,14,1,0.214285714285714
trales,0,6,2,4,0,0.5
finney,1,6,2,4,0,0.5
diadems,1,7,3,4,0,0.75
zeytslbaxcng,0,12,2,10,0,0.2
admiraunces,1,11,5,6,0,0.833333333333333
tisbe,1,5,2,3,0,0.666666666666667
psychasthenic,1,13,3,10,0,0.3
reorganisation,1,14,7,7,0,1
fayworloverlusivalroaker,0,24,10,14,0,0.714285714285714
mumbell,0,7,2,5,0,0.4
erinssts,0,8,2,6,0,0.333333333333333
hvn,0,3,0,3,0,0
wheatears,1,9,4,5,0,0.8
entempest,1,9,3,6,0,0.5
pyrophotography,1,15,4,11,0,0.363636363636364
unsoul,1,6,3,3,0,1
lcqplgixs'bllgqoi,0,17,3,14,1,0.214285714285714
gossipmongering,1,15,5,10,0,0.5
isman,1,5,2,3,0,0.666666666666667
intrathorne,0,11,4,7,0,0.571428571428571
pericycle,1,9,3,6,0,0.5
chlorinising,1,12,4,8,0,0.5
tonnishness,1,11,3,8,0,0.375
saeima,1,6,4,2,0,2
timist,1,6,2,4,0,0.5
lakewood,1,8,4,4,0,1
zoophagan,1,9,4,5,0,0.8
pauricidae,0,10,6,4,0,1.5
formwisemicron,0,14,5,9,0,0.555555555555556
minerowalat,0,11,5,6,0,0.833333333333333
neufchetel,1,10,4,6,0,0.666666666666667
harebottled,0,11,4,7,0,0.571428571428571
tappishnesses,0,13,4,9,0,0.444444444444444
fraunded,0,8,3,5,0,0.6
ujn,0,3,1,2,0,0.5
jamms,0,5,1,4,0,0.25
preceremonial,1,13,6,7,0,0.857142857142857
vently,0,6,1,5,0,0.2
bblidd,0,6,1,5,0,0.2
repleteness,1,11,4,7,0,0.571428571428571
neoytterbium,1,12,5,7,0,0.714285714285714
enforte,0,7,3,4,0,0.75
ganaycrodinugarinolesaths,0,25,10,15,0,0.666666666666667
udiararomeffrdsicha,0,19,8,11,0,0.727272727272727
zestfulnesses,1,13,4,9,0,0.444444444444444
loggia,1,6,3,3,0,1
wollop,1,6,2,4,0,0.5
parjhyvjyuuk,0,12,3,9,0,0.333333333333333
sayarbobiserbolutrosoxyllamfoly,0,31,11,20,0,0.55
lumnilogistilise,0,16,7,9,0,0.777777777777778
toyyrepbxmhwxk,0,14,2,12,0,0.166666666666667
metheglins,1,10,3,7,0,0.428571428571429
midedoos,0,8,4,4,0,1
ekxkoicppu,0,10,4,6,0,0.666666666666667
atepun,0,6,3,3,0,1
fuxwiolalertinqutsias,0,21,9,12,0,0.75
hoppergrass,1,11,3,8,0,0.375
nqofbp,0,6,1,5,0,0.2
superb,1,6,2,4,0,0.5
dews,1,4,1,3,0,0.333333333333333
laicity,1,7,3,4,0,0.75
dissimilable,0,12,5,7,0,0.714285714285714
appeaching,1,10,4,6,0,0.666666666666667
exuviating,1,10,5,5,0,1
catte,0,5,2,3,0,0.666666666666667
absconded,1,9,3,6,0,0.5
ristic,0,6,2,4,0,0.5
ophthalmia,1,10,4,6,0,0.666666666666667
luminodynamism,1,14,5,9,0,0.555555555555556
remonstrangula,0,14,5,9,0,0.555555555555556
introspective,1,13,5,8,0,0.625
kingpins,1,8,2,6,0,0.333333333333333
limacologies,1,12,6,6,0,1
balsamy,1,7,2,5,0,0.4
thoracica,1,9,4,5,0,0.8
antichristianism,1,16,6,10,0,0.6
hubbubs,1,7,2,5,0,0.4
coproduct,1,9,3,6,0,0.5
lddyxysoisfztt,0,14,2,12,0,0.166666666666667
enterpriseless,1,14,5,9,0,0.555555555555556
evaristus,1,9,4,5,0,0.8
nonier,0,6,3,3,0,1
patio,1,5,3,2,0,1.5
creilunip,0,9,4,5,0,0.8
alcestis,1,8,3,5,0,0.6
ousel,1,5,3,2,0,1.5
correllow,0,9,3,6,0,0.5
gcohhbrnrub,0,11,2,9,0,0.222222222222222
chaetosomatidae,1,15,8,7,0,1.14285714285714
ruckoponotativelifords,0,22,9,13,0,0.692307692307692
qcakmzsxahgsqrmcf',0,18,2,16,1,0.125
fanya,1,5,2,3,0,0.666666666666667
preoculateness,0,14,6,8,0,0.75
boerne,1,6,3,3,0,1
slyn,0,4,0,4,0,0
overproporting,0,14,5,9,0,0.555555555555556
representationalistic,1,21,9,12,0,0.75
bipaleomachyme,0,14,6,8,0,0.75
wife,1,4,2,2,0,1
sestiad,1,7,3,4,0,0.75
pitarenerecliorenalyamunck,0,26,11,15,0,0.733333333333333
inconium,0,8,4,4,0,1
pricket,1,7,2,5,0,0.4
redliness,0,9,3,6,0,0.5
hopping,1,7,2,5,0,0.4
lactors,0,7,2,5,0,0.4
statutoriness,1,13,5,8,0,0.625
unpacify,0,8,3,5,0,0.6
colonese,0,8,4,4,0,1
glazia,0,6,3,3,0,1
unhasps,1,7,2,5,0,0.4
lity,0,4,1,3,0,0.333333333333333
appertain,1,9,4,5,0,0.8
hypersuadabilities,0,18,8,10,0,0.8
unpursue,0,8,4,4,0,1
notaeal,1,7,4,3,0,1.33333333333333
drewsey,1,7,2,5,0,0.4
gambade,1,7,3,4,0,0.75
lost,1,4,1,3,0,0.333333333333333
lacewing,1,8,3,5,0,0.6
yciryplqikqo,0,12,3,9,0,0.333333333333333
epike,0,5,3,2,0,1.5
mesophaga,0,9,4,5,0,0.8
deutschmarking,0,14,4,10,0,0.4
yixeuiffxzjjetonzxmagksokq,0,26,8,18,0,0.444444444444444
lyardiaphs,0,10,3,7,0,0.428571428571429
chokehold,1,9,3,6,0,0.5
whang,1,5,1,4,0,0.25
regoliths,1,9,3,6,0,0.5
britza,0,6,2,4,0,0.5
fryd,1,4,0,4,0,0
soliotonseiandevacompling,0,25,11,14,0,0.785714285714286
nonresist,0,9,3,6,0,0.5
reinitiating,1,12,6,6,0,1
jargonisingly,0,13,4,9,0,0.444444444444444
unmanacles,1,10,4,6,0,0.666666666666667
ldsnigsm,0,8,1,7,0,0.142857142857143
marbardabling,0,13,4,9,0,0.444444444444444
mtx,1,3,0,3,0,0
copiums,0,7,3,4,0,0.75
j'uhzkigtoiohjwwca,0,18,6,12,1,0.5
lipotrophy,1,10,3,7,0,0.428571428571429
uneregl,0,7,3,4,0,0.75
surfboard,1,9,3,6,0,0.5
sica,0,4,2,2,0,1
antiferous,0,10,5,5,0,1
prestrainedly,0,13,4,9,0,0.444444444444444
erythroxylaceous,1,16,6,10,0,0.6
'zn,0,3,0,3,1,0
ontonagon,1,9,4,5,0,0.8
niaselanesiltsptad,0,18,7,11,0,0.636363636363636
effluencies,0,11,5,6,0,0.833333333333333
neury,0,5,2,3,0,0.666666666666667
daalder,1,7,3,4,0,0.75
larth,0,5,1,4,0,0.25
chongjin,1,8,2,6,0,0.333333333333333
sinope,1,6,3,3,0,1
apocritariness,0,14,6,8,0,0.75
contranspositologist,0,20,7,13,0,0.538461538461538
boaumbrounme,0,12,6,6,0,1
begly,0,5,1,4,0,0.25
weins,0,5,2,3,0,0.666666666666667
arrange,1,7,3,4,0,0.75
frostily,1,8,2,6,0,0.333333333333333
tkckwoiyfsbe,0,12,3,9,0,0.333333333333333
'lfnzmfxsiecki,0,14,3,11,1,0.272727272727273
divnxpdinssgwwqsn,0,17,2,15,0,0.133333333333333
comices,1,7,3,4,0,0.75
aesthesiveness,0,14,6,8,0,0.75
peging,0,6,2,4,0,0.5
supremum,1,8,3,5,0,0.6
isoquinonic,0,11,6,5,0,1.2
kq,0,2,0,2,0,0
aushar,1,6,3,3,0,1
infulness,0,9,3,6,0,0.5
anticonfederationism,1,20,9,11,0,0.818181818181818
restousplancy,0,13,4,9,0,0.444444444444444
buen,0,4,2,2,0,1
gelsmrjbcrmbvymhr''ft,0,21,1,20,2,0.05
pilosity,1,8,3,5,0,0.6
'kj'mbp,0,7,0,7,2,0
theing,0,6,2,4,0,0.5
viagra,1,6,3,3,0,1
cvskftu'latyilzuhrmzkay,0,23,5,18,1,0.277777777777778
saming,0,6,2,4,0,0.5
lementlerymelibrails,0,20,7,13,0,0.538461538461538
graphiacolduckmang,0,18,6,12,0,0.5
retraining,1,10,4,6,0,0.666666666666667
proenforce,0,10,4,6,0,0.666666666666667
taediums,1,8,4,4,0,1
standoffishly,1,13,3,10,0,0.3
aticonophodeopamy,0,17,8,9,0,0.888888888888889
achtenpheul,0,11,4,7,0,0.571428571428571
tentaculite,1,11,5,6,0,0.833333333333333
tenneedilioneturonoceleron,0,26,13,13,0,1
bableness,0,9,3,6,0,0.5
likerish,1,8,3,5,0,0.6
southes,0,7,3,4,0,0.75
barytine,1,8,3,5,0,0.6
ture,0,4,2,2,0,1
fanzine,1,7,3,4,0,0.75
yrent,1,5,1,4,0,0.25
irresolubly,1,11,4,7,0,0.571428571428571
chlorobromides,1,14,5,9,0,0.555555555555556
lhdenjcnahg,0,11,2,9,0,0.222222222222222
billyoh,1,7,2,5,0,0.4
rowanberry,1,10,3,7,0,0.428571428571429
reconstitutional,0,16,7,9,0,0.777777777777778
remittee,1,8,4,4,0,1
protoselachii,1,13,6,7,0,0.857142857142857
acnosis,0,7,3,4,0,0.75
misquott,0,8,3,5,0,0.6
schwinged,0,9,2,7,0,0.285714285714286
drawgate,1,8,3,5,0,0.6
agoginonbouquism,0,16,8,8,0,1
noneventfully,0,13,4,9,0,0.444444444444444
mann,1,4,1,3,0,0.333333333333333
includenny,0,10,3,7,0,0.428571428571429
demoiser,0,8,4,4,0,1
misliking,1,9,3,6,0,0.5
congruency,1,10,3,7,0,0.428571428571429
cricket,1,7,2,5,0,0.4
lxjqoglmwlgkorxetugd,0,20,4,16,0,0.25
lutheraniser,1,12,5,7,0,0.714285714285714
chxdnkmrs'kfzrgtwhkfzamnvfg,0,27,1,26,1,0.0384615384615385
ajfijvrhfkcuvdmcvcyyfvxsk,0,25,3,22,0,0.136363636363636
ungaugenic,0,10,5,5,0,1
saticisendometer,0,16,7,9,0,0.777777777777778
canglings,0,9,2,7,0,0.285714285714286
parakihis,0,9,4,5,0,0.8
woodbinds,1,9,3,6,0,0.5
coryate,1,7,3,4,0,0.75
nonparalytic,1,12,4,8,0,0.5
pahach,0,6,2,4,0,0.5
huvsrsthnvnyf,0,13,1,12,0,0.0833333333333333
cardic,0,6,2,4,0,0.5
pils,1,4,1,3,0,0.333333333333333
bigg,1,4,1,3,0,0.333333333333333
borollarofototionion,0,20,10,10,0,1
unexactment,0,11,4,7,0,0.571428571428571
kllmxalcuya,0,11,3,8,0,0.375
nonelevation,1,12,6,6,0,1
invilliness,0,11,4,7,0,0.571428571428571
patt,1,4,1,3,0,0.333333333333333
odalwoman,1,9,4,5,0,0.8
palingeneses,1,12,5,7,0,0.714285714285714
dazeawnnbid,0,11,4,7,0,0.571428571428571
cheesevat,1,9,4,5,0,0.8
trappic,0,7,2,5,0,0.4
cedens,1,6,2,4,0,0.5
unsheer,1,7,3,4,0,0.75
mpeg,1,4,1,3,0,0.333333333333333
cocciform,1,9,3,6,0,0.5
ecoclimates,1,11,5,6,0,0.833333333333333
toomer,1,6,3,3,0,1
mediopectoral,1,13,6,7,0,0.857142857142857
unnestled,1,9,3,6,0,0.5
sinkhorn,0,8,2,6,0,0.333333333333333
reaccomplishment,1,16,5,11,0,0.454545454545455
mosher,1,6,2,4,0,0.5
anagre,0,6,3,3,0,1
groverras,0,9,3,6,0,0.5
homophone,1,9,4,5,0,0.8
petrarchy,0,9,2,7,0,0.285714285714286
enfranchial,0,11,4,7,0,0.571428571428571
celton,0,6,2,4,0,0.5
lussier,1,7,3,4,0,0.75
pigouts,1,7,3,4,0,0.75
ernani,1,6,3,3,0,1
cophripte,0,9,3,6,0,0.5
nonnasan,0,8,3,5,0,0.6
transomed,1,9,3,6,0,0.5
roccus,1,6,2,4,0,0.5
sames,1,5,2,3,0,0.666666666666667
tynan,1,5,1,4,0,0.25
uninconvenienti,0,15,7,8,0,0.875
lampadaries,1,11,5,6,0,0.833333333333333
linesser,0,8,3,5,0,0.6
embrasured,1,10,4,6,0,0.666666666666667
cypsilies,0,9,3,6,0,0.5
heine,1,5,3,2,0,1.5
reculustilinipefish,0,19,8,11,0,0.727272727272727
fistier,1,7,3,4,0,0.75
tabardieu,0,9,5,4,0,1.25
demagogy,1,8,3,5,0,0.6
pinacoteca,1,10,5,5,0,1
delubra,1,7,3,4,0,0.75
clarinettist,1,12,4,8,0,0.5
m'zeofp'wgubn,0,13,3,10,2,0.3
sfdwatvsplv,0,11,1,10,0,0.1
coaricalidae,0,12,7,5,0,1.4
incandescency,1,13,4,9,0,0.444444444444444
atmjolidable,0,12,5,7,0,0.714285714285714
fertilio,0,8,4,4,0,1
privatdozent,1,12,4,8,0,0.5
kpeidxekubnpw,0,13,4,9,0,0.444444444444444
utuionssapacost,0,15,7,8,0,0.875
dale,1,4,2,2,0,1
hiplett,0,7,2,5,0,0.4
schowd,0,6,1,5,0,0.2
scavengery,1,10,3,7,0,0.428571428571429
cercidelition,0,13,6,7,0,0.857142857142857
plutology,1,9,3,6,0,0.5
venuing,0,7,3,4,0,0.75
mallinctiva,0,11,4,7,0,0.571428571428571
unroundings,0,11,4,7,0,0.571428571428571
urodella,1,8,4,4,0,1
thinocoridae,1,12,6,6,0,1
mantelpiece,1,11,5,6,0,0.833333333333333
caressa,1,7,3,4,0,0.75
debushes,0,8,3,5,0,0.6
miff,1,4,1,3,0,0.333333333333333
shameter,0,8,3,5,0,0.6
infume,1,6,3,3,0,1
mhvrsefvzulv,0,12,2,10,0,0.2
crumblinesses,1,13,4,9,0,0.444444444444444
alakekua,0,8,5,3,0,1.66666666666667
bathyscapes,1,11,3,8,0,0.375
cyphr,0,5,0,5,0,0
caulome,1,7,4,3,0,1.33333333333333
iotorriwsjoynglo,0,16,6,10,0,0.6
gastrocnemial,1,13,5,8,0,0.625
partyless,0,9,2,7,0,0.285714285714286
psammon,1,7,2,5,0,0.4
mwbydhbzqelggkdogswwfpby''manc,0,30,3,27,2,0.111111111111111
drivas,0,6,2,4,0,0.5
mcewensville,1,12,4,8,0,0.5
fingboherpuzin,0,14,5,9,0,0.555555555555556
suemplimansver,0,14,5,9,0,0.555555555555556
txou,0,4,2,2,0,1
zbqyths'cc'uxtbi,0,16,2,14,2,0.142857142857143
hypatie,1,7,3,4,0,0.75
phyleutro,0,9,3,6,0,0.5
penthes,0,7,2,5,0,0.4
molluts,0,7,2,5,0,0.4
lynchburg,1,9,1,8,0,0.125
deconoicomaria,0,14,8,6,0,1.33333333333333
hurrymarkate,0,12,4,8,0,0.5
aframerism,0,10,4,6,0,0.666666666666667
ronstadt,1,8,2,6,0,0.333333333333333
aysnjbdmmpca'yizja,0,18,4,14,1,0.285714285714286
teanguomarrapalls,0,17,7,10,0,0.7
larinae,1,7,4,3,0,1.33333333333333
sheepherdia,0,11,5,6,0,0.833333333333333
grecism,1,7,2,5,0,0.4
mexia,1,5,3,2,0,1.5
catholicos,1,10,4,6,0,0.666666666666667
anness,0,6,2,4,0,0.5
chatoyants,1,10,3,7,0,0.428571428571429
windlass,1,8,2,6,0,0.333333333333333
nonfilmcoats,0,12,4,8,0,0.5
dgs,0,3,0,3,0,0
catlett,1,7,2,5,0,0.4
rebenediktat,0,12,5,7,0,0.714285714285714
striolets,0,9,3,6,0,0.5
sweemutestercies,0,16,7,9,0,0.777777777777778
sclerotizations,1,15,6,9,0,0.666666666666667
fette,0,5,2,3,0,0.666666666666667
nondefinitively,1,15,6,9,0,0.666666666666667
pem,1,3,1,2,0,0.5
azeglio,1,7,4,3,0,1.33333333333333
sivatherioid,1,12,6,6,0,1
noninformation,1,14,6,8,0,0.75
jaggarefalatioecissically,0,25,11,14,0,0.785714285714286
miscopists,0,10,3,7,0,0.428571428571429
forescutic,0,10,4,6,0,0.666666666666667
tteli'xjjzdexfaeloprglf,0,23,6,17,1,0.352941176470588
chusolitickiatahum,0,18,8,10,0,0.8
florellatorship,0,15,5,10,0,0.5
expenses,1,8,3,5,0,0.6
atic,0,4,2,2,0,1
aroure,0,6,4,2,0,2
meshed,1,6,2,4,0,0.5
gling,0,5,1,4,0,0.25
hagablalell,0,11,4,7,0,0.571428571428571
argentarius,1,11,5,6,0,0.833333333333333
zygos,0,5,1,4,0,0.25
postremote,1,10,4,6,0,0.666666666666667
tvqqt,0,5,0,5,0,0
waffly,1,6,1,5,0,0.2
unmetheotabund,0,14,6,8,0,0.75
brigantine,1,10,4,6,0,0.666666666666667
buonarroti,1,10,5,5,0,1
ascertainably,1,13,5,8,0,0.625
palaeotechnological,0,19,9,10,0,0.9
ak'wmaidakciua,0,14,7,7,1,1
na'aumxpzupucsjbmsgrzobhfvt,0,27,6,21,1,0.285714285714286
subcantor,1,9,3,6,0,0.5
shelling,1,8,2,6,0,0.333333333333333
trampageous,0,11,5,6,0,0.833333333333333
unpolishedness,1,14,5,9,0,0.555555555555556
ddancazinincexpitiounteranehengs,0,32,13,19,0,0.684210526315789
procurate,1,9,4,5,0,0.8
photoptus,0,9,3,6,0,0.5
distooksy,0,9,3,6,0,0.5
amalita,1,7,4,3,0,1.33333333333333
ichorous,1,8,4,4,0,1
steils,1,6,2,4,0,0.5
skegness,1,8,2,6,0,0.333333333333333
refundability,1,13,5,8,0,0.625
submetaphoric,1,13,5,8,0,0.625
tachymonds,0,10,2,8,0,0.25
cottaging,1,9,3,6,0,0.5
rakingly,1,8,2,6,0,0.333333333333333
ovelomisheaf,0,12,6,6,0,1
cistrons,1,8,2,6,0,0.333333333333333
triboelectrifies,0,16,7,9,0,0.777777777777778
eelcatcher,1,10,4,6,0,0.666666666666667
sarcenet,1,8,3,5,0,0.6
perapterrom,0,11,4,7,0,0.571428571428571
sextantis,1,9,3,6,0,0.5
resinlike,1,9,4,5,0,0.8
socas,1,5,2,3,0,0.666666666666667
lvjzk'nucwok,0,12,2,10,1,0.2
lzayjfrivksvjtkbmmbasx,0,22,3,19,0,0.157894736842105
bondie,1,6,3,3,0,1
permutationist,1,14,6,8,0,0.75
theorical,1,9,4,5,0,0.8
asclerodize,0,11,5,6,0,0.833333333333333
foamless,1,8,3,5,0,0.6
motivations,1,11,5,6,0,0.833333333333333
mactra,1,6,2,4,0,0.5
sedes,1,5,2,3,0,0.666666666666667
lancasaticophopinhs,0,19,7,12,0,0.583333333333333
pacr,0,4,1,3,0,0.333333333333333
sunmunopitliest,0,15,6,9,0,0.666666666666667
smioper,0,7,3,4,0,0.75
hoit,1,4,2,2,0,1
hyperquisarravian,0,17,7,10,0,0.7
ichthus,1,7,2,5,0,0.4
adxyz'xpohuvldjjswwbfmivqgazdg,0,30,5,25,1,0.2
nijholt,1,7,2,5,0,0.4
smithied,1,8,3,5,0,0.6
phediourorocadiceies,0,20,11,9,0,1.22222222222222
chaise,1,6,3,3,0,1
etesarytichictieplete,0,21,9,12,0,0.75
diacromyminiggly,0,16,5,11,0,0.454545454545455
colchick,0,8,2,6,0,0.333333333333333
vermingly,0,9,2,7,0,0.285714285714286
rebemire,1,8,4,4,0,1
nonans,0,6,2,4,0,0.5
oxyethyl,1,8,2,6,0,0.333333333333333
merchandi,0,9,3,6,0,0.5
carmine,1,7,3,4,0,0.75
hosieries,1,9,5,4,0,1.25
stir,1,4,1,3,0,0.333333333333333
burtis,1,6,2,4,0,0.5
nonimprovement,1,14,5,9,0,0.555555555555556
trammon,1,7,2,5,0,0.4
befrumpier,0,10,4,6,0,0.666666666666667
trimman,0,7,2,5,0,0.4
threats,1,7,2,5,0,0.4
libertinage,1,11,5,6,0,0.833333333333333
mobs,1,4,1,3,0,0.333333333333333
cce,0,3,1,2,0,0.5
senheil,0,7,3,4,0,0.75
avoeradmakins,0,13,6,7,0,0.857142857142857
hematisfilen,0,12,5,7,0,0.714285714285714
tahoka,1,6,3,3,0,1
impoporness,0,11,4,7,0,0.571428571428571
bapopeunforalernt,0,17,7,10,0,0.7
nonbelligerent,1,14,5,9,0,0.555555555555556
ghastnesses,1,11,3,8,0,0.375
aleoros,0,7,4,3,0,1.33333333333333
bonavisboic,0,11,5,6,0,0.833333333333333
macratanichy,0,12,4,8,0,0.5
aydlachian,0,10,4,6,0,0.666666666666667
herseyed,0,8,3,5,0,0.6
welbie,1,6,3,3,0,1
pindins,0,7,2,5,0,0.4
kne,0,3,1,2,0,0.5
parmillaquoities,0,16,8,8,0,1
radioamplifier,1,14,7,7,0,1
perikarya,1,9,4,5,0,0.8
haten,0,5,2,3,0,0.666666666666667
pruencer,0,8,3,5,0,0.6
archos,0,6,2,4,0,0.5
parcloses,1,9,3,6,0,0.5
stalah,0,6,2,4,0,0.5
trippe,1,6,2,4,0,0.5
tectraville,0,11,4,7,0,0.571428571428571
griqualander,1,12,5,7,0,0.714285714285714
composters,1,10,3,7,0,0.428571428571429
earthwomen,1,10,4,6,0,0.666666666666667
supprection,0,11,4,7,0,0.571428571428571
imprenable,1,10,4,6,0,0.666666666666667
carneyed,1,8,3,5,0,0.6
classines,0,9,3,6,0,0.5
verberative,1,11,5,6,0,0.833333333333333
arnelle,1,7,3,4,0,0.75
anknes,0,6,2,4,0,0.5
rrdjwrkkwsgj',0,13,0,13,1,0
buzz,1,4,1,3,0,0.333333333333333
chauntingly,0,11,3,8,0,0.375
meposkizefodopandantore,0,23,10,13,0,0.769230769230769
entepicondylar,1,14,5,9,0,0.555555555555556
uroschesis,1,10,4,6,0,0.666666666666667
hopatepuldintaralaner,0,21,9,12,0,0.75
macaglia,1,8,4,4,0,1
semideaf,1,8,4,4,0,1
znnbvmgrmshuwlpevt,0,18,2,16,0,0.125
dthfysutmicqvd,0,14,2,12,0,0.166666666666667
careys,1,6,2,4,0,0.5
equidistantial,1,14,7,7,0,1
abduced,1,7,3,4,0,0.75
acoromaluilkl,0,13,6,7,0,0.857142857142857
zzkeaclzvtigodhpba,0,18,5,13,0,0.384615384615385
steedman,1,8,3,5,0,0.6
trevets,1,7,2,5,0,0.4
souldan,1,7,3,4,0,0.75
cholecystectomy,1,15,4,11,0,0.363636363636364
spanas,0,6,2,4,0,0.5
omens,1,5,2,3,0,0.666666666666667
fngahc'hsxt,0,11,1,10,1,0.1
branford,1,8,2,6,0,0.333333333333333
uneitrychen,0,11,4,7,0,0.571428571428571
subalternational,0,16,7,9,0,0.777777777777778
emoul,0,5,3,2,0,1.5
best,1,4,1,3,0,0.333333333333333
cosuffers,0,9,3,6,0,0.5
tearooms,1,8,4,4,0,1
tident,0,6,2,4,0,0.5
strander,1,8,2,6,0,0.333333333333333
phyticalinic,0,12,4,8,0,0.5
carayetoachymbindienus,0,22,9,13,0,0.692307692307692
cabbageheadedness,1,17,7,10,0,0.7
achyranthes,1,11,3,8,0,0.375
pangea,1,6,3,3,0,1
'vefhnosdibp'qoxcqvlwmohfm,0,26,5,21,2,0.238095238095238
hylicist,1,8,2,6,0,0.333333333333333
hospitages,1,10,4,6,0,0.666666666666667
inirritant,0,10,4,6,0,0.666666666666667
platidamenorprottradjechd,0,25,8,17,0,0.470588235294118
psjinuxbizwrg,0,13,3,10,0,0.3
vices,1,5,2,3,0,0.666666666666667
straitesimas,0,12,5,7,0,0.714285714285714
rvgfhabveebsvnd,0,15,3,12,0,0.25
thettern,0,8,2,6,0,0.333333333333333
oosover,0,7,4,3,0,1.33333333333333
burgoo,1,6,3,3,0,1
retwine,1,7,3,4,0,0.75
epheliaceous,0,12,7,5,0,1.4
chiffchaff,1,10,2,8,0,0.25
zfqxvyvmzapgpjcmkudinhowltwv,0,28,4,24,0,0.166666666666667
rhabdomeres,1,11,4,7,0,0.571428571428571
sanguillurethreutilization,0,26,12,14,0,0.857142857142857
molis,0,5,2,3,0,0.666666666666667
abernation,0,10,5,5,0,1
entmegrally,0,11,3,8,0,0.375
verras,1,6,2,4,0,0.5
uddohoot,0,8,4,4,0,1
trochoric,0,9,3,6,0,0.5
bror,0,4,1,3,0,0.333333333333333
similacks,0,9,3,6,0,0.5
unshowerer,0,10,4,6,0,0.666666666666667
disement,0,8,3,5,0,0.6
kettering,1,9,3,6,0,0.5
isochron,1,8,3,5,0,0.6
nyxis,1,5,1,4,0,0.25
laddish,1,7,2,5,0,0.4
daxachirbetrokerate,0,19,8,11,0,0.727272727272727
uq'uccuysvsjdhybtwjg'xs'apzsn,0,29,4,25,3,0.16
pizilorascers,0,13,5,8,0,0.625
trustworthier,1,13,4,9,0,0.444444444444444
ufqciobekejnls,0,14,5,9,0,0.555555555555556
zelophobia,1,10,5,5,0,1
unlamenter,0,10,4,6,0,0.666666666666667
anaphy,0,6,2,4,0,0.5
shiploid,0,8,3,5,0,0.6
dandelabration,0,14,6,8,0,0.75
bodewash,1,8,3,5,0,0.6
emplecton,1,9,3,6,0,0.5
overthoud,0,9,4,5,0,0.8
clavashi,0,8,3,5,0,0.6
yaird,1,5,2,3,0,0.666666666666667
chuging,0,7,2,5,0,0.4
odoric,1,6,3,3,0,1
poxidizens,0,10,4,6,0,0.666666666666667
rhagionidae,1,11,6,5,0,1.2
merryville,1,10,3,7,0,0.428571428571429
calandre,1,8,3,5,0,0.6
mauritian,1,9,5,4,0,1.25
stricklings,0,11,2,9,0,0.222222222222222
arjjpidxorupznu,0,15,5,10,0,0.5
endoaorton,0,10,5,5,0,1
middleborough,1,13,5,8,0,0.625
kkjxuxfkeyvhewdu,0,16,4,12,0,0.333333333333333
woodleaf,1,8,4,4,0,1
clfus,0,5,1,4,0,0.25
retiarian,1,9,5,4,0,1.25
briny,1,5,1,4,0,0.25
colopexia,1,9,5,4,0,1.25
tropein,1,7,3,4,0,0.75
staria,0,6,3,3,0,1
isvwyujjvvddgshxc,0,17,2,15,0,0.133333333333333
hyaenodont,1,10,4,6,0,0.666666666666667
benuenessenthery,0,16,6,10,0,0.6
mult,0,4,1,3,0,0.333333333333333
mahalla,1,7,3,4,0,0.75
fairmount,1,9,4,5,0,0.8
zloty,1,5,1,4,0,0.25
reseals,1,7,3,4,0,0.75
myrtie,1,6,2,4,0,0.5
chainlike,1,9,4,5,0,0.8
inexposal,0,9,4,5,0,0.8
polyamide,1,9,4,5,0,0.8
armipotence,1,11,5,6,0,0.833333333333333
clitate,0,7,3,4,0,0.75
scrogs,1,6,1,5,0,0.2
baceachen,0,9,4,5,0,0.8
balanging,0,9,3,6,0,0.5
velma,1,5,2,3,0,0.666666666666667
myall,1,5,1,4,0,0.25
scolytoids,1,10,3,7,0,0.428571428571429
dehwar,1,6,2,4,0,0.5
sausnes,0,7,3,4,0,0.75
qjjpevantlt'piepoeawhvxs,0,24,7,17,1,0.411764705882353
electrogamia,0,12,6,6,0,1
regatively,0,10,4,6,0,0.666666666666667
mrkuareluzhuxvadotprj,0,21,7,14,0,0.5
yscqwdy,0,7,0,7,0,0
cocarpacked,0,11,4,7,0,0.571428571428571
simargandmaking,0,15,5,10,0,0.5
hhdrqdhnl,0,9,0,9,0,0
vqmkkhxrea,0,10,2,8,0,0.25
actentinesotrack,0,16,6,10,0,0.6
overshot,1,8,3,5,0,0.6
ia'ujqixzupzqzizvog'ze,0,22,8,14,2,0.571428571428571
bannerets,1,9,3,6,0,0.5
prmw'lhaebsvqqn,0,15,2,13,1,0.153846153846154
insecticides,1,12,5,7,0,0.714285714285714
ysxxpygpiosjjyxqnmcmipjcyp,0,26,3,23,0,0.130434782608696
declimatize,1,11,5,6,0,0.833333333333333
portifory,1,9,3,6,0,0.5
buzzardsville,0,13,4,9,0,0.444444444444444
ichthyophagi,1,12,4,8,0,0.5
runoff,1,6,2,4,0,0.5
humbug,1,6,2,4,0,0.5
nologiculor,0,11,5,6,0,0.833333333333333
filipinization,1,14,7,7,0,1
wonnie,1,6,3,3,0,1
pagers,1,6,2,4,0,0.5
lmjzimqzx'eucmkpld,0,18,3,15,1,0.2
icnosocher,0,10,4,6,0,0.666666666666667
unbuckram,0,9,3,6,0,0.5
postcolonium,0,12,5,7,0,0.714285714285714
pinomnrutithouspe,0,17,7,10,0,0.7
ropro,0,5,2,3,0,0.666666666666667
serpentarianism,0,15,6,9,0,0.666666666666667
landreeve,1,9,4,5,0,0.8
slumberings,1,11,3,8,0,0.375
disannulation,0,13,6,7,0,0.857142857142857
rockmart,1,8,2,6,0,0.333333333333333
prcotinetapithie,0,16,7,9,0,0.777777777777778
tarkashi,0,8,3,5,0,0.6
freen,0,5,2,3,0,0.666666666666667
schlornegrave,0,13,4,9,0,0.444444444444444
weingly,0,7,2,5,0,0.4
perinduinn,0,10,4,6,0,0.666666666666667
deskman,1,7,2,5,0,0.4
cheezinke,0,9,4,5,0,0.8
unolareens,0,10,5,5,0,1
suncems,0,7,2,5,0,0.4
varietist,1,9,4,5,0,0.8
gonochorismal,1,13,5,8,0,0.625
potorthylipticuseinceriallasterammerminsing,0,43,16,27,0,0.592592592592593
indowed,1,7,3,4,0,0.75
compline,1,8,3,5,0,0.6
borderer,1,8,3,5,0,0.6
beck,1,4,1,3,0,0.333333333333333
entomophobia,1,12,6,6,0,1
centeno,1,7,3,4,0,0.75
sai,1,3,2,1,0,2
moulin,1,6,3,3,0,1
diagenesis,1,10,5,5,0,1
hjordis,1,7,2,5,0,0.4
septmoncel,1,10,3,7,0,0.428571428571429
stenotheriidae,0,14,7,7,0,1
stclair,1,7,2,5,0,0.4
epionychium,1,11,5,6,0,0.833333333333333
gelya,1,5,2,3,0,0.666666666666667
geb,1,3,1,2,0,0.5
wirralee,0,8,4,4,0,1
emendations,1,11,5,6,0,0.833333333333333
sirphegce,0,9,3,6,0,0.5
muddlehead,1,10,4,6,0,0.666666666666667
staminous,0,9,4,5,0,0.8
rackworks,1,9,2,7,0,0.285714285714286
chaldani,0,8,3,5,0,0.6
ymca,1,4,1,3,0,0.333333333333333
hamme,0,5,2,3,0,0.666666666666667
yvcekgrrkwrbdzjpmzixsbpfdd,0,26,2,24,0,0.0833333333333333
gempiyhsffdwqvmadvnnuqg,0,23,4,19,0,0.210526315789474
biops,0,5,2,3,0,0.666666666666667
desmosol,0,8,3,5,0,0.6
aliunde,1,7,4,3,0,1.33333333333333
scarth,1,6,1,5,0,0.2
saddier,0,7,3,4,0,0.75
decoad,0,6,3,3,0,1
sunfield,1,8,3,5,0,0.6
nonlaminated,1,12,5,7,0,0.714285714285714
organograph,0,11,4,7,0,0.571428571428571
promptnesses,1,12,3,9,0,0.333333333333333
usance,1,6,3,3,0,1
iridosmine,1,10,5,5,0,1
wireworm,1,8,3,5,0,0.6
orionholing,0,11,5,6,0,0.833333333333333
overal,0,6,3,3,0,1
cremates,1,8,3,5,0,0.6
camparations,0,12,5,7,0,0.714285714285714
roomthiness,1,11,4,7,0,0.571428571428571
tritidog,0,8,3,5,0,0.6
invills,0,7,2,5,0,0.4
goldskirt,0,9,2,7,0,0.285714285714286
inexpleble,1,10,4,6,0,0.666666666666667
stemona,1,7,3,4,0,0.75
iagmrparoqrru,0,13,5,8,0,0.625
toponym,1,7,2,5,0,0.4
phos,0,4,1,3,0,0.333333333333333
wanecrudi,0,9,4,5,0,0.8
fei,1,3,2,1,0,2
birdwing,1,8,2,6,0,0.333333333333333
fogyism,1,7,2,5,0,0.4
commandress,1,11,3,8,0,0.375
leakiness,1,9,4,5,0,0.8
pllllelys,0,9,1,8,0,0.125
nusistoguatabophydicam,0,22,9,13,0,0.692307692307692
roberson,1,8,3,5,0,0.6
precludes,1,9,3,6,0,0.5
catocathartidae,0,15,7,8,0,0.875
surreptitiousness,1,17,7,10,0,0.7
pratfalling,1,11,3,8,0,0.375
layptinjus,0,10,3,7,0,0.428571428571429
electrobiologist,1,16,7,9,0,0.777777777777778
companionage,1,12,6,6,0,1
uncertitudes,0,12,5,7,0,0.714285714285714
upknell,1,7,2,5,0,0.4
smectic,1,7,2,5,0,0.4
burkundauze,1,11,5,6,0,0.833333333333333
pachyrhizus,1,11,3,8,0,0.375
tiocrph,0,7,2,5,0,0.4
tubicinate,1,10,5,5,0,1
auxotox,1,7,4,3,0,1.33333333333333
spirits,1,7,2,5,0,0.4
nymphotoxemia,0,13,5,8,0,0.625
nevoie,0,6,4,2,0,2
pseudon,0,7,3,4,0,0.75
dysadaptation,1,13,5,8,0,0.625
sibers,0,6,2,4,0,0.5
elands,1,6,2,4,0,0.5
nodiform,1,8,3,5,0,0.6
lolling,1,7,2,5,0,0.4
perigastritis,1,13,5,8,0,0.625
propionitril,1,12,5,7,0,0.714285714285714
clucke,0,6,2,4,0,0.5
rumming,0,7,2,5,0,0.4
lagagobitherovel,0,16,7,9,0,0.777777777777778
wass,0,4,1,3,0,0.333333333333333
spatangoidean,1,13,6,7,0,0.857142857142857
geoatinginolichoverreinutring,0,29,13,16,0,0.8125
kaivalya,1,8,4,4,0,1
padle,1,5,2,3,0,0.666666666666667
satang,1,6,2,4,0,0.5
otorhinolaryngological,1,22,9,13,0,0.692307692307692
helcotic,1,8,3,5,0,0.6
wardmotes,1,9,3,6,0,0.5
unilluminated,1,13,6,7,0,0.857142857142857
prioriferozale,0,14,7,7,0,1
natale,1,6,3,3,0,1
intervisor,0,10,4,6,0,0.666666666666667
biferously,0,10,4,6,0,0.666666666666667
theanthropicality,0,17,6,11,0,0.545454545454545
guraliquenella,0,14,7,7,0,1
tilletiaceous,1,13,7,6,0,1.16666666666667
fliest,1,6,2,4,0,0.5
forecoleneratismounbace,0,23,11,12,0,0.916666666666667
violiv,0,6,3,3,0,1
nocturia,1,8,4,4,0,1
topsiloid,0,9,4,5,0,0.8
twaceodoacouete,0,15,9,6,0,1.5
maitaky,0,7,3,4,0,0.75
rounduplicated,0,14,6,8,0,0.75
ves,0,3,1,2,0,0.5
bracon,1,6,2,4,0,0.5
spachinogasinthaunthovitonchallenubinoly,0,40,15,25,0,0.6
hasetted,0,8,3,5,0,0.6
innumerated,0,11,5,6,0,0.833333333333333
xysuyodgfqdsmoc,0,15,3,12,0,0.25
mesmbes,0,7,2,5,0,0.4
psilophyton,1,11,3,8,0,0.375
unvotegnarigoverseaeidivored,0,28,14,14,0,1
rqddyiyifrqjflw,0,15,2,13,0,0.153846153846154
bovendetemenes,0,14,6,8,0,0.75
km'expgsxardec,0,14,3,11,1,0.272727272727273
hammerman,1,9,3,6,0,0.5
rollerblader,1,12,4,8,0,0.5
boxking,0,7,2,5,0,0.4
seminonconformist,1,17,6,11,0,0.545454545454545
adipescent,1,10,4,6,0,0.666666666666667
nonpliant,1,9,3,6,0,0.5
cogency,1,7,2,5,0,0.4
bush,1,4,1,3,0,0.333333333333333
laconialese,0,11,6,5,0,1.2
zzvyzuaklhrcoe,0,14,4,10,0,0.4
advential,1,9,4,5,0,0.8
sympathect,0,10,2,8,0,0.25
jece,0,4,2,2,0,1
geminates,1,9,4,5,0,0.8
swedes,1,6,2,4,0,0.5
rosensate,0,9,4,5,0,0.8
noncoercible,1,12,5,7,0,0.714285714285714
paramnesia,1,10,5,5,0,1
bissicis,0,8,3,5,0,0.6
scorchings,1,10,2,8,0,0.25
volipresence,1,12,5,7,0,0.714285714285714
ducatoons,1,9,4,5,0,0.8
solifluction,1,12,5,7,0,0.714285714285714
oarsmanship,1,11,4,7,0,0.571428571428571
incliners,1,9,3,6,0,0.5
medalled,1,8,3,5,0,0.6
vixednessing,0,12,4,8,0,0.5
cynege,0,6,2,4,0,0.5
septerium,1,9,4,5,0,0.8
'tlcxnjpwtozcqi,0,15,2,13,1,0.153846153846154
freightscot,0,11,3,8,0,0.375
khomeiney,0,9,4,5,0,0.8
osmunds,1,7,2,5,0,0.4
semihobos,1,9,4,5,0,0.8
doletawescid,0,12,5,7,0,0.714285714285714
demolition,1,10,5,5,0,1
recalibration,1,13,6,7,0,0.857142857142857
invariation,0,11,6,5,0,1.2
capayees,0,8,4,4,0,1
snakier,1,7,3,4,0,0.75
etymic,1,6,2,4,0,0.5
archaeologists,1,14,6,8,0,0.75
weinman,1,7,3,4,0,0.75
nonamenability,1,14,6,8,0,0.75
gjdgebioyeswirundbdxgclcqh,0,26,6,20,0,0.3
igivlwy'qji'jycmluwb,0,20,4,16,2,0.25
troutperches,1,12,4,8,0,0.5
unslapped,1,9,3,6,0,0.5
walworth,1,8,2,6,0,0.333333333333333
villageless,1,11,4,7,0,0.571428571428571
indecigrad,0,10,4,6,0,0.666666666666667
inedibleness,0,12,5,7,0,0.714285714285714
scamparnium,0,11,4,7,0,0.571428571428571
tuberculturally,0,15,5,10,0,0.5
zibet,1,5,2,3,0,0.666666666666667
hepcat,1,6,2,4,0,0.5
lungfish,1,8,2,6,0,0.333333333333333
gephtrin,0,8,2,6,0,0.333333333333333
semicolognese,0,13,6,7,0,0.857142857142857
overdomes,0,9,4,5,0,0.8
toolbox,1,7,3,4,0,0.75
fustian,1,7,3,4,0,0.75
moprs,0,5,1,4,0,0.25
prespontaneously,1,16,6,10,0,0.6
anemochoric,1,11,5,6,0,0.833333333333333
chyagheces,0,10,3,7,0,0.428571428571429
rerdrd,0,6,1,5,0,0.2
pinostor,0,8,3,5,0,0.6
competitor,1,10,4,6,0,0.666666666666667
sacculation,1,11,5,6,0,0.833333333333333
chinstrap,1,9,2,7,0,0.285714285714286
stanze,1,6,2,4,0,0.5
dessipriseintiagryonotcas,0,25,10,15,0,0.666666666666667
immunosuppression,1,17,7,10,0,0.7
pectomycium,0,11,4,7,0,0.571428571428571
arcumble,0,8,3,5,0,0.6
linguals,1,8,3,5,0,0.6
thestius,1,8,3,5,0,0.6
pleatless,1,9,3,6,0,0.5
tkknxcibikzlc,0,13,2,11,0,0.181818181818182
kaba,0,4,2,2,0,1
complacencies,1,13,5,8,0,0.625
moolah,1,6,3,3,0,1
urely,0,5,2,3,0,0.666666666666667
masculate,1,9,4,5,0,0.8
sarpler,1,7,2,5,0,0.4
puaulbotzfsqqtxinwj,0,19,5,14,0,0.357142857142857
shotman,1,7,2,5,0,0.4
representationary,1,17,7,10,0,0.7
omard,0,5,2,3,0,0.666666666666667
fuero,1,5,3,2,0,1.5
previde,1,7,3,4,0,0.75
underbush,1,9,3,6,0,0.5
spist,0,5,1,4,0,0.25
orferd,1,6,2,4,0,0.5
onslowly,0,8,2,6,0,0.333333333333333
cerebrogans,0,11,4,7,0,0.571428571428571
rolikathicia,0,12,6,6,0,1
podargus,1,8,3,5,0,0.6
affidavits,1,10,4,6,0,0.666666666666667
prfpn'nanx'eoodrb'i,0,19,5,14,3,0.357142857142857
amabel,1,6,3,3,0,1
mistiffness,0,11,3,8,0,0.375
nonculpableness,1,15,5,10,0,0.5
nicitapelptelaters,0,18,7,11,0,0.636363636363636
antogregunned,0,13,5,8,0,0.625
fob,1,3,1,2,0,0.5
exceeded,1,8,4,4,0,1
spoffle,1,7,2,5,0,0.4
diesel,1,6,3,3,0,1
hokeiteugalons,0,14,7,7,0,1
scourses,1,8,3,5,0,0.6
start,1,5,1,4,0,0.25
clining,0,7,2,5,0,0.4
lyp'uorrcihgpcirgpmzjpvpqpyz,0,28,4,24,1,0.166666666666667
eusthenopteron,1,14,6,8,0,0.75
wain,1,4,2,2,0,1
sibilancies,1,11,5,6,0,0.833333333333333
favaging,0,8,3,5,0,0.6
oceanid,1,7,4,3,0,1.33333333333333
alorton,1,7,3,4,0,0.75
segaltululinorcrbumitele,0,24,10,14,0,0.714285714285714
orthopteral,1,11,4,7,0,0.571428571428571
unsurest,1,8,3,5,0,0.6
dravideonassively,0,17,7,10,0,0.7
egretta,1,7,3,4,0,0.75
monardella,1,10,4,6,0,0.666666666666667
informers,1,9,3,6,0,0.5
hemorphophoral,0,14,5,9,0,0.555555555555556
xanthatharine,0,13,5,8,0,0.625
choteau,1,7,4,3,0,1.33333333333333
audiometrist,1,12,6,6,0,1
codiscoverer,1,12,5,7,0,0.714285714285714
flushinesses,0,12,4,8,0,0.5
spoonbaitering,0,14,6,8,0,0.75
degrinession,0,12,5,7,0,0.714285714285714
corphoritotestrophalapative,0,27,11,16,0,0.6875
pristodus,1,9,3,6,0,0.5
ransom,1,6,2,4,0,0.5
boningly,0,8,2,6,0,0.333333333333333
dichromatist,0,12,4,8,0,0.5
insidiations,0,12,6,6,0,1
kwic,1,4,1,3,0,0.333333333333333
tagalog,1,7,3,4,0,0.75
fortive,0,7,3,4,0,0.75
style,1,5,1,4,0,0.25
tritic,0,6,2,4,0,0.5
crocheted,1,9,3,6,0,0.5
remissiveness,1,13,5,8,0,0.625
pamacchrang,0,11,3,8,0,0.375
nondivergence,1,13,5,8,0,0.625
metempsychosize,1,15,5,10,0,0.5
accepter,1,8,3,5,0,0.6
bridoons,1,8,3,5,0,0.6
nonthinker,1,10,3,7,0,0.428571428571429
dynon,0,5,1,4,0,0.25
polytelecarrowties,0,18,7,11,0,0.636363636363636
botuline,0,8,4,4,0,1
overine,0,7,4,3,0,1.33333333333333
fonteyn,1,7,2,5,0,0.4
pufferthronalificising,0,22,8,14,0,0.571428571428571
rucks,1,5,1,4,0,0.25
oversoaked,1,10,5,5,0,1
arief,0,5,3,2,0,1.5
snellius,1,8,3,5,0,0.6
rependerslipcoachetics,0,22,8,14,0,0.571428571428571
chasteness,1,10,3,7,0,0.428571428571429
nonexceptioner,0,14,6,8,0,0.75
izgkf,0,5,1,4,0,0.25
psycoron,0,8,2,6,0,0.333333333333333
dahna,1,5,2,3,0,0.666666666666667
bgfwlb,0,6,0,6,0,0
olenus,1,6,3,3,0,1
sloetrees,1,9,4,5,0,0.8
avastinconstopoding,0,19,7,12,0,0.583333333333333
yzhy'inpnhyctzdzkvfsfbtvlekj,0,28,2,26,1,0.0769230769230769
polyphyly,1,9,1,8,0,0.125
upq,0,3,1,2,0,0.5
lichis,1,6,2,4,0,0.5
lumbricales,1,11,4,7,0,0.571428571428571
nons,0,4,1,3,0,0.333333333333333
paniteragevilliscrop,0,20,8,12,0,0.666666666666667
quinaquina,1,10,6,4,0,1.5
gions,0,5,2,3,0,0.666666666666667
antimitotic,1,11,5,6,0,0.833333333333333
crkehoummilemeedrpa,0,19,8,11,0,0.727272727272727
grft,0,4,0,4,0,0
twtdoeia,0,8,4,4,0,1
rhineura,1,8,4,4,0,1
dhotie,1,6,3,3,0,1
vigesimo,1,8,4,4,0,1
stomatotomy,1,11,4,7,0,0.571428571428571
figures,1,7,3,4,0,0.75
cabstand,1,8,2,6,0,0.333333333333333
buford,1,6,2,4,0,0.5
'zyhnmieorjnlhofj,0,17,4,13,1,0.307692307692308
superaction,0,11,5,6,0,0.833333333333333
nonconformitant,1,15,5,10,0,0.5
laius,1,5,3,2,0,1.5
copperworks,1,11,3,8,0,0.375
rabblings,1,9,2,7,0,0.285714285714286
neritina,1,8,4,4,0,1
pressiveness,0,12,4,8,0,0.5
ireland,1,7,3,4,0,0.75
salemiuts,0,9,4,5,0,0.8
cakkseteyzxqh'pbtffzblaymxrsvf,0,30,4,26,1,0.153846153846154
stemes,1,6,2,4,0,0.5
dcwjcb,0,6,0,6,0,0
alhadelerianel,0,14,7,7,0,1
scatback,1,8,2,6,0,0.333333333333333
nonrepellence,1,13,5,8,0,0.625
lepidobrogee,0,12,6,6,0,1
spectator,1,9,3,6,0,0.5
habitude,1,8,4,4,0,1
nonlucratively,1,14,5,9,0,0.555555555555556
purtion,0,7,3,4,0,0.75
koror,1,5,2,3,0,0.666666666666667
apophyge,1,8,3,5,0,0.6
bssqnynry'igrhagfanxuii'y'wk',0,29,6,23,4,0.260869565217391
mwdjelib,0,8,2,6,0,0.333333333333333
briticism,1,9,3,6,0,0.5
stichter,1,8,2,6,0,0.333333333333333
cambrications,0,13,5,8,0,0.625
subornadoraliencolicut,0,22,10,12,0,0.833333333333333
cageyness,1,9,3,6,0,0.5
izuleract,0,9,4,5,0,0.8
pigeon,1,6,3,3,0,1
breadlies,0,9,4,5,0,0.8
philographic,1,12,4,8,0,0.5
yezidis,1,7,3,4,0,0.75
noblenness,0,10,3,7,0,0.428571428571429
fatratent,0,9,3,6,0,0.5
bysacki,1,7,2,5,0,0.4
mhimbxmv'ekidpuwzwcumlgshiqzhd,0,30,6,24,1,0.25
arbusterol,1,10,4,6,0,0.666666666666667
aminologically,0,14,6,8,0,0.75
antesternal,1,11,4,7,0,0.571428571428571
revictualling,1,13,5,8,0,0.625
hailimelstescorobarleaplimitt,0,29,12,17,0,0.705882352941177
rhombolaria,0,11,5,6,0,0.833333333333333
yodelling,1,9,3,6,0,0.5
reflexive,1,9,4,5,0,0.8
haxdqigqffazjmipeoggoxh,0,23,7,16,0,0.4375
frontrunner,1,11,3,8,0,0.375
lanugo,1,6,3,3,0,1
fancified,1,9,4,5,0,0.8
audaean,1,7,5,2,0,2.5
unpurveyed,1,10,4,6,0,0.666666666666667
nonimputable,1,12,5,7,0,0.714285714285714
carniture,0,9,4,5,0,0.8
rocy,0,4,1,3,0,0.333333333333333
foqznt'jgleqhkylmq,0,18,2,16,1,0.125
grandfatherish,1,14,4,10,0,0.4
ctblxh'gloa,0,11,2,9,1,0.222222222222222
epithalline,1,11,5,6,0,0.833333333333333
ob,1,2,1,1,0,1
oveeroununctinanathas,0,21,10,11,0,0.909090909090909
zeuxian,1,7,4,3,0,1.33333333333333
schizophreniac,1,14,5,9,0,0.555555555555556
pfaaolc,0,7,3,4,0,0.75
silesia,1,7,4,3,0,1.33333333333333
heciphoniacs,0,12,5,7,0,0.714285714285714
nunitr,0,6,2,4,0,0.5
ruc,1,3,1,2,0,0.5
ndrindlirets,0,12,3,9,0,0.333333333333333
broophyrispairidiodonic,0,23,10,13,0,0.769230769230769
alabamians,1,10,5,5,0,1
s'fidr,0,6,1,5,1,0.2
pausteragamitaries,0,18,9,9,0,1
pilidretillellemeomm,0,20,8,12,0,0.666666666666667
schists,1,7,1,6,0,0.166666666666667
kamelaukions,1,12,6,6,0,1
abitivation,0,11,6,5,0,1.2
samothrake,1,10,4,6,0,0.666666666666667
candescence,1,11,4,7,0,0.571428571428571
sikas,1,5,2,3,0,0.666666666666667
carolus,1,7,3,4,0,0.75
rjomgdczdif,0,11,2,9,0,0.222222222222222
fcoa'zqrr,0,9,2,7,1,0.285714285714286
buffeting,1,9,3,6,0,0.5
carboxylic,1,10,3,7,0,0.428571428571429
disciplinants,1,13,4,9,0,0.444444444444444
recor,1,5,2,3,0,0.666666666666667
cathouses,1,9,4,5,0,0.8
agrepagroununskile,0,18,8,10,0,0.8
hipparchs,1,9,2,7,0,0.285714285714286
rhodgers,0,8,2,6,0,0.333333333333333
esys,0,4,1,3,0,0.333333333333333
eccreanism,0,10,4,6,0,0.666666666666667
interchanger,1,12,4,8,0,0.5
pomins,0,6,2,4,0,0.5
unconductive,1,12,5,7,0,0.714285714285714
mism,0,4,1,3,0,0.333333333333333
spondenseatinesses,0,18,7,11,0,0.636363636363636
seferis,1,7,3,4,0,0.75
guestments,0,10,3,7,0,0.428571428571429
devalls,1,7,2,5,0,0.4
goqde,0,5,2,3,0,0.666666666666667
transept,1,8,2,6,0,0.333333333333333
hab,0,3,1,2,0,0.5
muales,0,6,3,3,0,1
unsheathed,1,10,4,6,0,0.666666666666667
aton,0,4,2,2,0,1
drxamsiruapk,0,12,4,8,0,0.5
decuneanius,0,11,6,5,0,1.2
frard,0,5,1,4,0,0.25
sclerodermas,1,12,4,8,0,0.5
exercising,1,10,4,6,0,0.666666666666667
nonsynonymous,1,13,4,9,0,0.444444444444444
bucentury,0,9,3,6,0,0.5
gutierrez,1,9,4,5,0,0.8
dhal,1,4,1,3,0,0.333333333333333
swqsixgprb,0,10,1,9,0,0.111111111111111
frascatis,1,9,3,6,0,0.5
unemin,0,6,3,3,0,1
enfacednesses,0,13,5,8,0,0.625
pava,1,4,2,2,0,1
hokeyness,1,9,3,6,0,0.5
duraplasty,1,10,3,7,0,0.428571428571429
visias,0,6,3,3,0,1
fuzeezobvvttmcicnkw,0,19,5,14,0,0.357142857142857
ztuxqbobtfcawhw,0,15,3,12,0,0.25
chandoval,0,9,3,6,0,0.5
laverania,1,9,5,4,0,1.25
knideands,0,9,3,6,0,0.5
martensite,1,10,4,6,0,0.666666666666667
showbreads,1,10,3,7,0,0.428571428571429
uredro,0,6,3,3,0,1
eminuss,0,7,3,4,0,0.75
chlika,0,6,2,4,0,0.5
ahhiyawa,1,8,4,4,0,1
dindrostistreentic,0,18,6,12,0,0.5
uncloud,1,7,3,4,0,0.75
tergiversatile,0,14,6,8,0,0.75
gadean,1,6,3,3,0,1
atnah,1,5,2,3,0,0.666666666666667
dysmenorrhoea,1,13,5,8,0,0.625
pdxibjxabkaphhbsyhdd'dnq,0,24,3,21,1,0.142857142857143
propitiator,1,11,5,6,0,0.833333333333333
compantaribetteer,0,17,7,10,0,0.7
succous,1,7,3,4,0,0.75
ballad,1,6,2,4,0,0.5
bookend,1,7,3,4,0,0.75
hydrogenases,1,12,4,8,0,0.5
cutset,1,6,2,4,0,0.5
scotoscopes,0,11,4,7,0,0.571428571428571
tempositarmina,0,14,6,8,0,0.75
redivivous,1,10,5,5,0,1
omocatroon,0,10,5,5,0,1
qatar,1,5,2,3,0,0.666666666666667
interyx,0,7,2,5,0,0.4
sacchari,0,8,3,5,0,0.6
qktxmiswpysdtyszpsy,0,19,1,18,0,0.0555555555555556
interpolitical,1,14,6,8,0,0.75
geof,1,4,2,2,0,1
icelanders,1,10,4,6,0,0.666666666666667
celeski,1,7,3,4,0,0.75
eagerly,1,7,3,4,0,0.75
yrgconpccpd,0,11,1,10,0,0.1
clapboarding,0,12,4,8,0,0.5
actmenthritiann,0,15,5,10,0,0.5
gasconaded,1,10,4,6,0,0.666666666666667
duoitraerahssceede,0,18,9,9,0,1
stursha,0,7,2,5,0,0.4
fauchioncrafts,0,14,5,9,0,0.555555555555556
hebridean,1,9,4,5,0,0.8
airliner,1,8,4,4,0,1
yzfporzzrulcxavfxa,0,18,4,14,0,0.285714285714286
transmitheticalinoid,0,20,8,12,0,0.666666666666667
kpfsztlhgyixph,0,14,1,13,0,0.0769230769230769
ctatte,0,6,2,4,0,0.5
tagalo,1,6,3,3,0,1
postcondylar,1,12,3,9,0,0.333333333333333
mycetomatous,1,12,5,7,0,0.714285714285714
h',0,2,0,2,1,0
informatica,1,11,5,6,0,0.833333333333333
seradinestic,0,12,5,7,0,0.714285714285714
focaca,0,6,3,3,0,1
balkar,1,6,2,4,0,0.5
dimwittedness,1,13,4,9,0,0.444444444444444
jacaenotopisereliapingynontrrther,0,33,13,20,0,0.65
kraunhia,1,8,4,4,0,1
kellochemistries,0,16,6,10,0,0.6
lithely,1,7,2,5,0,0.4
philymafeystyps,0,15,3,12,0,0.25
christianiser,1,13,5,8,0,0.625
bizis,0,5,2,3,0,0.666666666666667
itticlothiacagaturicerytang,0,27,11,16,0,0.6875
gaspesian,1,9,4,5,0,0.8
competitions,1,12,5,7,0,0.714285714285714
tragelaphs,1,10,3,7,0,0.428571428571429
balsamroot,1,10,4,6,0,0.666666666666667
arerowles,0,9,4,5,0,0.8
tetracyclic,1,11,3,8,0,0.375
uckluphpxktwbf'vvqcukt,0,22,3,19,1,0.157894736842105
hurrageditenasse,0,16,7,9,0,0.777777777777778
esme,1,4,2,2,0,1
retromorphizing,0,15,5,10,0,0.5
moltonise,0,9,4,5,0,0.8
tapeline,1,8,4,4,0,1
superoleadias,0,13,7,6,0,1.16666666666667
quadrisectionalisable,0,21,10,11,0,0.909090909090909
firmacy,0,7,2,5,0,0.4
pulveration,1,11,5,6,0,0.833333333333333
ceriops,1,7,3,4,0,0.75
cumspecules,0,11,4,7,0,0.571428571428571
antifeudalist,1,13,6,7,0,0.857142857142857
unmyopia,0,8,4,4,0,1
traing,0,6,2,4,0,0.5
billatalograckinctomise,0,23,9,14,0,0.642857142857143
vt'nnyx,0,7,0,7,1,0
baburden,0,8,3,5,0,0.6
bridgwater,1,10,3,7,0,0.428571428571429
tornado,1,7,3,4,0,0.75
propraetors,1,11,4,7,0,0.571428571428571
palaeanthropologists,1,20,8,12,0,0.666666666666667
enterestier,0,11,5,6,0,0.833333333333333
tarawa,1,6,3,3,0,1
esthonians,1,10,4,6,0,0.666666666666667
reffing,1,7,2,5,0,0.4
athermaphy,0,10,3,7,0,0.428571428571429
hornstone,1,9,3,6,0,0.5
qtoplibycwmudqaxsyxqaaeoj,0,25,8,17,0,0.470588235294118
stag,1,4,1,3,0,0.333333333333333
lono,0,4,2,2,0,1
disusages,1,9,4,5,0,0.8
bemist,1,6,2,4,0,0.5
schmutterminna,0,14,4,10,0,0.4
invictive,1,9,4,5,0,0.8
evangelists,1,11,4,7,0,0.571428571428571
amuses,1,6,3,3,0,1
ggrtierycetetriawensnd,0,22,7,15,0,0.466666666666667
tamarindo,1,9,4,5,0,0.8
neseradipa,0,10,5,5,0,1
europoort,1,9,5,4,0,1.25
primatement,0,11,4,7,0,0.571428571428571
proletariates,1,13,6,7,0,0.857142857142857
adenoliomyelogenesis,0,20,10,10,0,1
tapajoccos,0,10,4,6,0,0.666666666666667
phonier,0,7,3,4,0,0.75
czyswcgwhdees'tuy,0,17,3,14,1,0.214285714285714
remunerability,1,14,6,8,0,0.75
bmuvaekklizryquwjvjvtqz,0,23,5,18,0,0.277777777777778
campanulaceae,1,13,7,6,0,1.16666666666667
cholindical,0,11,4,7,0,0.571428571428571
computationally,1,15,6,9,0,0.666666666666667
hed,0,3,1,2,0,0.5
icoount,0,7,4,3,0,1.33333333333333
heaved,1,6,3,3,0,1
creswell,1,8,2,6,0,0.333333333333333
wwy'mywi,0,8,1,7,1,0.142857142857143
mariam,1,6,3,3,0,1
calumniator,1,11,5,6,0,0.833333333333333
rcaneald,0,8,3,5,0,0.6
clakuhqbvycqtkrpk,0,17,2,15,0,0.133333333333333
emanatist,1,9,4,5,0,0.8
rjbuxjqizmiahljdya,0,18,5,13,0,0.384615384615385
phyocus,0,7,2,5,0,0.4
diserculacedranguess,0,20,8,12,0,0.666666666666667
disseminates,1,12,5,7,0,0.714285714285714
uprating,1,8,3,5,0,0.6
desirousness,1,12,5,7,0,0.714285714285714
infarct,1,7,2,5,0,0.4
refiled,1,7,3,4,0,0.75
'xzonpoozu,0,10,4,6,1,0.666666666666667
vmefpeci',0,9,3,6,1,0.5
bestiality,1,10,4,6,0,0.666666666666667
autopisms,0,9,4,5,0,0.8
gradients,1,9,3,6,0,0.5
anticipants,1,11,4,7,0,0.571428571428571
cabritius,0,9,4,5,0,0.8
jerbern,0,7,2,5,0,0.4
soga,1,4,2,2,0,1
waiwa,0,5,3,2,0,1.5
misfunctioning,1,14,5,9,0,0.555555555555556
starto,0,6,2,4,0,0.5
ruttishnesses,1,13,4,9,0,0.444444444444444
photosculpturally,0,17,5,12,0,0.416666666666667
chologynopathecian,0,18,7,11,0,0.636363636363636
thoroughwax,1,11,4,7,0,0.571428571428571
bronchiostenosis,1,16,6,10,0,0.6
yetts,1,5,1,4,0,0.25
subintrant,1,10,3,7,0,0.428571428571429
microcracking,1,13,4,9,0,0.444444444444444
forimackdopodowyngs,0,19,6,13,0,0.461538461538462
twinnier,0,8,3,5,0,0.6
'aqskfkxawirtnw,0,15,3,12,1,0.25
expey,0,5,2,3,0,0.666666666666667
cheapeneddick,0,13,5,8,0,0.625
rachitism,1,9,3,6,0,0.5
hackettes,1,9,3,6,0,0.5
melianthaceae,1,13,7,6,0,1.16666666666667
wolpnveotko'zg'pypcvh,0,21,4,17,2,0.235294117647059
ininesna,0,8,4,4,0,1
forheglor,0,9,3,6,0,0.5
drugman,1,7,2,5,0,0.4
incya,0,5,2,3,0,0.666666666666667
zanthocephalocene,0,17,7,10,0,0.7
corydon,1,7,2,5,0,0.4
pown,1,4,1,3,0,0.333333333333333
bochess,0,7,2,5,0,0.4
distrusters,1,11,3,8,0,0.375
phreness,0,8,2,6,0,0.333333333333333
lochmere,1,8,3,5,0,0.6
paragammacism,1,13,5,8,0,0.625
intercrossing,1,13,4,9,0,0.444444444444444
merluccius,1,10,4,6,0,0.666666666666667
harden,1,6,2,4,0,0.5
dustbuster,1,10,3,7,0,0.428571428571429
xaviera,1,7,4,3,0,1.33333333333333
blancestone,0,11,4,7,0,0.571428571428571
algophilist,1,11,4,7,0,0.571428571428571
fahcmuq,0,7,2,5,0,0.4
dbbleivblhgdkderovqhly,0,22,4,18,0,0.222222222222222
nyctitropic,1,11,3,8,0,0.375
meterage,1,8,4,4,0,1
coscob,1,6,2,4,0,0.5
'bhpmopsfbjcxfhbyadarhhariwhg,0,29,5,24,1,0.208333333333333
chik,1,4,1,3,0,0.333333333333333
neuroanatomist,1,14,7,7,0,1
cogredient,1,10,4,6,0,0.666666666666667
deathingy,0,9,3,6,0,0.5
uneaten,1,7,4,3,0,1.33333333333333
reshufflingly,0,13,3,10,0,0.3
governorship,1,12,4,8,0,0.5
serjeanties,1,11,5,6,0,0.833333333333333
jot,1,3,1,2,0,0.5
munchiofuels,0,12,5,7,0,0.714285714285714
evanged,0,7,3,4,0,0.75
bobsledder,1,10,3,7,0,0.428571428571429
peptohydrochloric,1,17,5,12,0,0.416666666666667
prockidengeregrs,0,16,5,11,0,0.454545454545455
mondays,1,7,2,5,0,0.4
indrop,0,6,2,4,0,0.5
neemba,1,6,3,3,0,1
wqtyzfzuvbtlmghqvymddv,0,22,1,21,0,0.0476190476190476
rhombenporphyrs,1,15,3,12,0,0.25
bwe'dvvgqdow'msumqopyuxor'i'q,0,29,7,22,4,0.318181818181818
hiprells,0,8,2,6,0,0.333333333333333
fibilifersioltiparialismatelah,0,30,14,16,0,0.875
comystrally,0,11,2,9,0,0.222222222222222
astaticisms,1,11,4,7,0,0.571428571428571
schwarzkopf,1,11,2,9,0,0.222222222222222
asterinidae,1,11,6,5,0,1.2
catalpa,1,7,3,4,0,0.75
nunc,1,4,1,3,0,0.333333333333333
eamianoxy,0,9,5,4,0,1.25
dovishness,1,10,3,7,0,0.428571428571429
cedar,1,5,2,3,0,0.666666666666667
binecuronchaete,0,15,7,8,0,0.875
nazifications,1,13,6,7,0,0.857142857142857
antitrypsin,1,11,3,8,0,0.375
fabio,1,5,3,2,0,1.5
writhen,1,7,2,5,0,0.4
unneines,0,8,4,4,0,1
zavijava,1,8,4,4,0,1
leurons,0,7,3,4,0,0.75
epispastics,1,11,4,7,0,0.571428571428571
pinal,1,5,2,3,0,0.666666666666667
euszck,0,6,2,4,0,0.5
unreyalteateritheasappaskeuctorudictomoachic,0,44,20,24,0,0.833333333333333
heteronymies,1,12,5,7,0,0.714285714285714
submous,0,7,3,4,0,0.75
ideigry,0,7,3,4,0,0.75
poly,1,4,1,3,0,0.333333333333333
phleas,0,6,2,4,0,0.5
albaniz,1,7,3,4,0,0.75
outspeed,1,8,4,4,0,1
thion,0,5,2,3,0,0.666666666666667
regalvanizing,1,13,5,8,0,0.625
paratry,0,7,2,5,0,0.4
rubato,1,6,3,3,0,1
imperic,0,7,3,4,0,0.75
reproof,1,7,3,4,0,0.75
synesses,0,8,2,6,0,0.333333333333333
kaycee,1,6,3,3,0,1
desaturations,1,13,6,7,0,0.857142857142857
farchechmael,0,12,4,8,0,0.5
pselaphidae,1,11,5,6,0,0.833333333333333
contributed,1,11,4,7,0,0.571428571428571
pae,0,3,2,1,0,2
extraduodecimality,0,18,8,10,0,0.8
f'zzifleybdnyawodpda,0,20,5,15,1,0.333333333333333
unsherods,0,9,3,6,0,0.5
rotties,0,7,3,4,0,0.75
pupeswowis,0,10,4,6,0,0.666666666666667
particle,1,8,3,5,0,0.6
landfall,1,8,2,6,0,0.333333333333333
extradomestic,1,13,5,8,0,0.625
pearlabours,0,11,5,6,0,0.833333333333333
q,1,1,0,1,0,0
probles,0,7,2,5,0,0.4
monkeynuts,1,10,3,7,0,0.428571428571429
epectombamo,0,11,5,6,0,0.833333333333333
incircumscription,1,17,6,11,0,0.545454545454545
godelich,1,8,3,5,0,0.6
potinebor,0,9,4,5,0,0.8
prick,1,5,1,4,0,0.25
alier,0,5,3,2,0,1.5
traik,1,5,2,3,0,0.666666666666667
hxofkvlpdmogpgzkdo,0,18,3,15,0,0.2
penned,1,6,2,4,0,0.5
microtogeny,0,11,4,7,0,0.571428571428571
temecipaenc,0,11,5,6,0,0.833333333333333
energiser,1,9,4,5,0,0.8
contemplant,1,11,3,8,0,0.375
shonery,0,7,2,5,0,0.4
sk'dhp'mus,0,10,1,9,2,0.111111111111111
callituveimold,0,14,6,8,0,0.75
wiffle,1,6,2,4,0,0.5
trecentos,1,9,3,6,0,0.5
urmuvoron'q'xttowwrdzto'kjxl,0,28,6,22,3,0.272727272727273
anticatalysts,1,13,4,9,0,0.444444444444444
pachisis,1,8,3,5,0,0.6
diplasmad,0,9,3,6,0,0.5
swamy,1,5,1,4,0,0.25
crometrologing,0,14,5,9,0,0.555555555555556
flyswat,1,7,1,6,0,0.166666666666667
rothentabononvaickhery,0,22,8,14,0,0.571428571428571
shitwork,1,8,2,6,0,0.333333333333333
foilsons,0,8,3,5,0,0.6
mithgarth,1,9,2,7,0,0.285714285714286
tradised,0,8,3,5,0,0.6
cium,0,4,2,2,0,1
odwmtbszxjbbmqfi'qudbouif,0,25,6,19,1,0.315789473684211
kleptomes,0,9,3,6,0,0.5
zrlsncrhqu,0,10,1,9,0,0.111111111111111
chantherevilloughts,0,19,6,13,0,0.461538461538462
hys,0,3,0,3,0,0
pressureless,1,12,4,8,0,0.5
